year,vcnaics4,firms,estabs,emp,denom,estabs_entry,estabs_entry_rate,estabs_exit,estabs_exit_rate,job_creation,job_creation_births,job_creation_continuers,job_creation_rate_births,job_creation_rate,job_destruction,job_destruction_deaths,job_destruction_continuers,job_destruction_rate_deaths,job_destruction_rate,net_job_creation,net_job_creation_rate,reallocation_rate,firmdeath_firms,firmdeath_estabs,firmdeath_emp
1978,1131,197,206,3898,3722,49,24.873,31,15.736,583,276,307,7.415,15.664,261,81,180,2.176,7.012,322,8.651,14.025,24,24,69
1978,1132,82,98,1679,1725,15,15.544,12,12.435,461,39,422,2.262,26.732,577,27,550,1.566,33.459,-116,-6.727,53.465,7,7,15
1978,1133,12084,12202,98431,93874,2382,19.8,2039,16.949,27115,9707,17408,10.34,28.884,17950,7295,10655,7.771,19.121,9165,9.763,38.243,1520,1523,5348
1978,1141,1526,1562,10660,9683,388,25,368,23.711,4563,1860,2703,19.209,47.124,2620,1243,1377,12.837,27.058,1943,20.066,54.115,272,272,761
1978,1142,121,121,520,518,26,21.224,29,23.673,188,101,87,19.498,36.293,190,92,98,17.761,36.68,-2,-0.386,72.587,23,23,81
1978,1151,4164,4598,53931,53635,695,14.846,862,18.413,18172,6239,11933,11.632,33.881,17875,6934,10941,12.928,33.327,297,0.554,66.654,560,582,4500
1978,1152,1565,1584,9831,9444,312,20.058,255,16.393,2700,997,1703,10.557,28.59,1976,1011,965,10.705,20.923,724,7.666,41.847,210,211,796
1978,1153,597,611,7664,6968,139,23.48,101,17.061,3111,1107,2004,15.887,44.647,1784,670,1114,9.615,25.603,1327,19.044,51.206,75,75,591
1978,2111,5268,7019,120376,117396,914,13.095,835,11.964,29980,10260,19720,8.74,25.537,23910,11893,12017,10.131,20.367,6070,5.171,40.734,393,404,1654
1978,2121,3321,4071,187895,203968,908,22.99,665,16.838,35648,13901,21747,6.815,17.477,67445,15060,52385,7.384,33.067,-31797,-15.589,34.955,435,440,5718
1978,2122,475,655,77625,82128,141,21.844,122,18.9,12040,3784,8256,4.607,14.66,20758,10076,10682,12.269,25.275,-8718,-10.615,29.32,60,61,2686
1978,2123,3677,5172,106621,105099,440,8.445,516,9.904,18622,5315,13307,5.057,17.719,15604,5509,10095,5.242,14.847,3018,2.872,29.694,243,246,1651
1978,2131,6824,7942,216476,202292,1601,20.836,1085,14.12,70106,25063,45043,12.39,34.656,42167,18198,23969,8.996,20.845,27939,13.811,41.689,632,642,5153
1978,2211,1464,5481,489160,475811,322,5.944,195,3.599,61450,16191,45259,3.403,12.915,34974,7190,27784,1.511,7.35,26476,5.564,14.701,15,15,205
1978,2212,482,2229,134162,133264,150,6.79,110,4.98,13895,2190,11705,1.643,10.427,12214,3790,8424,2.844,9.165,1681,1.261,18.331,17,17,89
1978,2213,3801,4107,33649,32854,442,10.999,265,6.595,6271,1437,4834,4.374,19.087,4672,2436,2236,7.415,14.22,1599,4.867,28.441,179,181,1513
1978,2361,102225,102567,583416,525466,28602,29.632,16519,17.114,246651,112251,134400,21.362,46.939,130774,63473,67301,12.079,24.887,115877,22.052,49.774,12845,12851,47972
1978,2362,32535,33096,598019,562312,6205,19.514,3608,11.347,177851,39458,138393,7.017,31.629,106941,24845,82096,4.418,19.018,70910,12.61,38.036,2713,2715,16413
1978,2371,13196,13499,376935,362628,1845,13.91,1374,10.359,101556,16345,85211,4.507,28.006,71961,18327,53634,5.054,19.844,29595,8.161,39.689,1016,1019,9525
1978,2372,7469,7638,69158,63995,2047,27.993,1396,19.091,27848,11860,15988,18.533,43.516,17403,8304,9099,12.976,27.194,10445,16.322,54.389,1022,1027,4542
1978,2373,10635,10975,240696,232119,1256,11.531,1091,10.016,62438,10424,52014,4.491,26.899,45170,9539,35631,4.11,19.46,17268,7.439,38.92,803,805,5516
1978,2379,4096,4135,73251,68271,893,22.159,683,16.948,29306,15456,13850,22.639,42.926,19167,4987,14180,7.305,28.075,10139,14.851,56.15,504,504,2774
1978,2381,65341,65759,527677,484098,13690,21.743,8097,12.86,188130,60746,127384,12.548,38.862,101030,36029,65001,7.443,20.87,87100,17.992,41.739,6263,6263,28281
1978,2382,91086,92798,885304,839976,14937,16.584,9475,10.52,233461,59841,173620,7.124,27.794,142490,48125,94365,5.729,16.964,90971,10.83,33.927,7531,7534,31722
1978,2383,69377,69770,499601,461630,15667,23.37,10206,15.224,179219,61240,117979,13.266,38.823,103177,40165,63012,8.701,22.351,76042,16.473,44.701,7885,7887,30151
1978,2389,31307,31441,237861,218125,6669,22.049,4279,14.147,88221,33007,55214,15.132,40.445,48501,19143,29358,8.776,22.235,39720,18.21,44.471,3265,3266,12857
1978,3111,1509,2180,59184,58773,144,6.563,172,7.84,7551,1729,5822,2.942,12.848,6721,2490,4231,4.237,11.436,830,1.412,22.871,89,93,809
1978,3112,561,907,80733,80115,43,4.71,55,6.024,5800,928,4872,1.158,7.24,4524,1383,3141,1.726,5.647,1276,1.593,11.294,32,32,582
1978,3113,1239,1636,96336,97039,176,10.781,169,10.352,11052,1617,9435,1.666,11.389,12816,4003,8813,4.125,13.207,-1764,-1.818,22.778,104,105,717
1978,3114,1362,1890,193381,190762,110,5.755,153,8.004,24909,3981,20928,2.087,13.058,19647,6876,12771,3.605,10.299,5262,2.758,20.598,81,81,2029
1978,3115,2476,3304,156317,156717,133,3.954,253,7.521,15196,2381,12815,1.519,9.696,16121,5862,10259,3.741,10.287,-925,-0.59,19.393,173,178,3055
1978,3116,4800,5465,333928,330057,365,6.556,569,10.221,40276,9323,30953,2.825,12.203,32662,12300,20362,3.727,9.896,7614,2.307,19.792,379,387,5655
1978,3117,653,785,44947,42310,56,7.107,62,7.868,11143,1598,9545,3.777,26.337,5980,2366,3614,5.592,14.134,5163,12.203,28.268,40,40,828
1978,3118,8220,9846,313932,308112,1178,12.035,1063,10.86,44415,12959,31456,4.206,14.415,32570,13957,18613,4.53,10.571,11845,3.844,21.142,738,755,7363
1978,3119,2112,2496,111501,107841,232,9.351,202,8.142,17916,6030,11886,5.592,16.613,10588,3646,6942,3.381,9.818,7328,6.795,19.636,145,145,1642
1978,3121,2361,2990,184959,182202,165,5.471,217,7.195,23262,4530,18732,2.486,12.767,17586,7155,10431,3.927,9.652,5676,3.115,19.304,133,134,2297
1978,3122,148,217,47770,48377,13,5.752,31,13.717,2964,278,2686,0.575,6.127,4010,1200,2810,2.481,8.289,-1046,-2.162,12.254,12,12,119
1978,3131,501,752,129019,129736,53,7.067,49,6.533,9481,1190,8291,0.917,7.308,10909,4185,6724,3.226,8.409,-1428,-1.101,14.616,33,34,697
1978,3132,1845,2306,369654,375621,156,6.692,206,8.837,23129,3777,19352,1.006,6.158,34734,14025,20709,3.734,9.247,-11605,-3.09,12.315,133,133,4513
1978,3133,1549,1793,135557,135289,163,9.132,147,8.235,14484,2678,11806,1.979,10.706,13706,5252,8454,3.882,10.131,778,0.575,20.262,101,101,2039
1978,3141,4564,4843,142167,134993,682,14.364,492,10.362,27528,8470,19058,6.274,20.392,13215,4786,8429,3.545,9.789,14313,10.603,19.579,385,386,2252
1978,3149,3470,3621,149188,146418,461,13.023,299,8.446,25801,7229,18572,4.937,17.621,20407,8363,12044,5.712,13.937,5394,3.684,27.875,214,214,4184
1978,3151,1460,1605,148915,146980,139,8.612,157,9.727,20463,4242,16221,2.886,13.922,16800,6680,10120,4.545,11.43,3663,2.492,22.86,118,120,2977
1978,3152,13394,15258,991236,980797,2088,13.709,2033,13.348,159170,54209,104961,5.527,16.229,138369,62571,75798,6.38,14.108,20801,2.121,28.216,1541,1552,36413
1978,3159,1755,1876,76742,75486,173,9.239,166,8.865,11672,3161,8511,4.188,15.462,9004,2020,6984,2.676,11.928,2668,3.534,23.856,137,137,1506
1978,3161,436,481,23372,23142,43,9.034,33,6.933,2969,636,2333,2.748,12.829,2515,976,1539,4.217,10.868,454,1.962,21.735,18,18,75
1978,3162,552,830,158494,160251,54,6.49,58,6.971,15353,2805,12548,1.75,9.581,19117,5106,14011,3.186,11.929,-3764,-2.349,19.161,29,32,1055
1978,3169,1419,1487,68993,67194,157,10.484,178,11.886,13313,4519,8794,6.725,19.813,9959,4343,5616,6.463,14.821,3354,4.992,29.643,143,143,2380
1978,3211,5627,6216,168012,164106,735,11.828,731,11.764,27100,8491,18609,5.174,16.514,19206,6822,12384,4.157,11.703,7894,4.81,23.407,533,534,4449
1978,3212,1030,1297,98270,95352,190,15.182,99,7.911,12746,3110,9636,3.262,13.367,6916,3173,3743,3.328,7.253,5830,6.114,14.506,58,60,1354
1978,3219,8342,9138,309530,293039,1114,12.343,889,9.85,63977,14473,49504,4.939,21.832,31269,13232,18037,4.515,10.671,32708,11.162,21.341,641,645,6237
1978,3221,367,753,216458,215966,74,10.144,27,3.701,10270,3313,6957,1.534,4.755,9307,2456,6851,1.137,4.309,963,0.446,8.619,6,6,434
1978,3222,3489,5048,401664,395844,414,8.348,236,4.759,40703,8632,32071,2.181,10.283,28587,10219,18368,2.582,7.222,12116,3.061,14.444,136,137,2367
1978,3231,29640,30982,607261,589551,3623,11.891,2598,8.527,88333,19960,68373,3.386,14.983,53051,22544,30507,3.824,8.999,35282,5.985,17.997,1947,1954,11449
1978,3241,1457,2312,359848,362181,201,8.764,164,7.151,23345,4778,18567,1.319,6.446,28404,2645,25759,0.73,7.842,-5059,-1.397,12.891,67,68,905
1978,3251,999,2086,270067,267016,141,6.774,132,6.342,20312,2557,17755,0.958,7.607,14147,4246,9901,1.59,5.298,6165,2.309,10.596,48,48,1372
1978,3252,427,671,167709,166416,54,8.169,34,5.144,12033,2348,9685,1.411,7.231,9553,4521,5032,2.717,5.74,2480,1.49,11.481,12,12,272
1978,3253,773,1178,56177,55942,102,8.644,106,8.983,6271,1489,4782,2.662,11.21,5831,1670,4161,2.985,10.423,440,0.787,20.847,45,45,385
1978,3254,915,1131,151964,150317,83,7.281,101,8.86,11790,1331,10459,0.885,7.843,8391,2643,5748,1.758,5.582,3399,2.261,11.164,62,62,1167
1978,3255,1614,2072,78935,78047,136,6.562,137,6.61,8581,1567,7014,2.008,10.995,6762,2150,4612,2.755,8.664,1819,2.331,17.328,84,85,692
1978,3256,2059,2311,111237,109206,191,8.259,194,8.389,13879,2199,11680,2.014,12.709,9791,3318,6473,3.038,8.966,4088,3.743,17.931,129,131,990
1978,3259,1718,2204,94316,93109,216,9.879,181,8.278,11605,2522,9083,2.709,12.464,8945,2181,6764,2.342,9.607,2660,2.857,19.214,116,117,968
1978,3261,8158,9501,484156,461676,1153,12.371,792,8.497,86778,17774,69004,3.85,18.796,41624,15703,25921,3.401,9.016,45154,9.78,18.032,553,556,7803
1978,3262,1739,2115,234661,233165,185,8.799,160,7.61,18849,3146,15703,1.349,8.084,16239,3473,12766,1.49,6.965,2610,1.119,13.929,103,103,1178
1978,3271,1336,1649,99765,97580,190,11.621,162,9.908,12715,1859,10856,1.905,13.03,8315,2787,5528,2.856,8.521,4400,4.509,17.042,111,111,1102
1978,3272,1310,1599,185504,180278,201,12.831,136,8.682,18098,2192,15906,1.216,10.039,7776,1291,6485,0.716,4.313,10322,5.726,8.627,95,96,768
1978,3273,7654,9498,191429,185030,758,7.995,723,7.626,36217,8420,27797,4.551,19.574,23470,7265,16205,3.926,12.684,12747,6.889,25.369,479,490,3356
1978,3274,307,403,17302,16624,56,14.213,38,9.645,2123,574,1549,3.453,12.771,739,377,362,2.268,4.445,1384,8.325,8.891,25,25,112
1978,3279,2156,2486,97335,95298,260,10.546,219,8.883,12389,1831,10558,1.921,13,8369,2467,5902,2.589,8.782,4020,4.218,17.564,152,152,1019
1978,3311,256,294,217623,216967,50,16.92,53,17.936,11390,2374,9016,1.094,5.25,10152,2798,7354,1.29,4.679,1238,0.571,9.358,32,32,290
1978,3312,484,652,84207,82161,41,6.381,22,3.424,8365,765,7600,0.931,10.181,4171,694,3477,0.845,5.077,4194,5.105,10.153,11,11,207
1978,3313,405,663,145388,141320,33,5.015,23,3.495,15033,1018,14015,0.72,10.638,7049,2820,4229,1.995,4.988,7984,5.65,9.976,12,12,702
1978,3314,801,992,112929,113559,88,8.911,79,8,9604,1920,7684,1.691,8.457,11077,3077,8000,2.71,9.754,-1473,-1.297,16.915,53,53,537
1978,3315,2815,3148,316963,306830,188,5.968,192,6.095,37406,6441,30965,2.099,12.191,17291,5042,12249,1.643,5.635,20115,6.556,11.271,138,139,2481
1978,3321,2859,3054,160146,154269,246,8.123,195,6.439,22824,5515,17309,3.575,14.795,11205,3911,7294,2.535,7.263,11619,7.532,14.527,132,132,1707
1978,3322,1117,1217,90753,87464,97,8.033,78,6.46,12546,2104,10442,2.406,14.344,5864,2722,3142,3.112,6.704,6682,7.64,13.409,60,60,1292
1978,3323,9272,10072,356243,344251,999,10.056,724,7.288,64211,11879,52332,3.451,18.652,40516,15754,24762,4.576,11.769,23695,6.883,23.539,523,528,8835
1978,3324,1442,1845,175180,174045,115,6.274,91,4.965,16701,3218,13483,1.849,9.596,14795,3388,11407,1.947,8.501,1906,1.095,17.001,48,49,878
1978,3325,872,956,94451,91534,88,9.382,52,5.544,11903,1894,10009,2.069,13.004,6362,1597,4765,1.745,6.95,5541,6.053,13.901,30,30,265
1978,3326,1501,1679,68351,66618,152,9.204,97,5.873,10464,1977,8487,2.968,15.708,6889,3102,3787,4.656,10.341,3575,5.366,20.682,61,61,797
1978,3327,18501,18791,314556,294666,2282,12.779,414,2.318,62023,13430,48593,4.558,21.049,22166,6525,15641,2.214,7.522,39857,13.526,15.045,202,202,2525
1978,3328,5308,5581,123389,116429,470,8.535,321,5.829,23936,4473,19463,3.842,20.558,10130,3127,7003,2.686,8.701,13806,11.858,17.401,250,251,1926
1978,3329,4592,5086,370803,360156,587,11.754,403,8.07,47571,9305,38266,2.584,13.208,25830,6735,19095,1.87,7.172,21741,6.037,14.344,283,284,3892
1978,3331,2862,3278,374953,367946,354,10.916,284,8.757,47359,6444,40915,1.751,12.871,33411,6518,26893,1.771,9.08,13948,3.791,18.161,190,190,2389
1978,3332,3489,3740,190354,183049,276,7.379,277,7.405,28368,8390,19978,4.583,15.497,14076,5341,8735,2.918,7.69,14292,7.808,15.379,175,175,1522
1978,3333,2001,2108,167556,163031,177,8.467,142,6.793,20210,3523,16687,2.161,12.396,11213,3760,7453,2.306,6.878,8997,5.519,13.756,80,80,369
1978,3334,1677,1907,188727,182062,290,15.718,166,8.997,26171,4740,21431,2.604,14.375,12661,4665,7996,2.562,6.954,13510,7.421,13.908,112,112,1182
1978,3335,9403,9794,283135,272217,851,8.828,543,5.633,41763,6562,35201,2.411,15.342,19930,7945,11985,2.919,7.321,21833,8.02,14.643,418,418,2724
1978,3336,675,808,192585,189099,40,4.935,45,5.552,15698,1004,14694,0.531,8.301,8444,874,7570,0.462,4.465,7254,3.836,8.931,28,28,209
1978,3339,5384,5855,349631,336505,495,8.556,356,6.153,52528,13048,39480,3.878,15.61,26341,7470,18871,2.22,7.828,26187,7.782,15.656,238,240,2785
1978,3341,779,908,212010,200821,183,21.329,83,9.674,39806,8570,31236,4.267,19.822,17668,3580,14088,1.783,8.798,22138,11.024,17.596,44,45,1914
1978,3342,1554,1702,243170,236258,206,12.118,202,11.882,33384,3777,29607,1.599,14.13,19522,6003,13519,2.541,8.263,13862,5.867,16.526,141,141,2030
1978,3343,529,560,69350,68328,83,14.982,71,12.816,9950,1500,8450,2.195,14.562,8104,1288,6816,1.885,11.86,1846,2.702,23.721,49,49,416
1978,3344,3203,3579,387493,374057,508,14.508,353,10.081,62811,11547,51264,3.087,16.792,36273,10620,25653,2.839,9.697,26538,7.095,19.394,260,261,3142
1978,3345,3299,3744,501190,482903,370,9.97,304,8.192,63256,9116,54140,1.888,13.099,26866,8507,18359,1.762,5.563,36390,7.536,11.127,199,199,3023
1978,3346,600,625,26509,24858,114,18.476,98,15.883,6287,874,5413,3.516,25.292,3010,945,2065,3.802,12.109,3277,13.183,24.218,62,62,269
1978,3351,1213,1328,90970,88038,128,9.679,117,8.847,12659,1685,10974,1.914,14.379,6647,2588,4059,2.94,7.55,6012,6.829,15.1,81,81,747
1978,3352,364,477,156063,150913,43,9.168,27,5.757,18773,1707,17066,1.131,12.44,8581,1195,7386,0.792,5.686,10192,6.754,11.372,13,14,137
1978,3353,1859,2317,295674,285901,224,9.874,127,5.598,35729,6688,29041,2.339,12.497,15923,4532,11391,1.585,5.569,19806,6.928,11.139,79,79,871
1978,3359,1538,1856,188151,182694,183,9.94,153,8.311,26261,5432,20829,2.973,14.374,15153,5419,9734,2.966,8.294,11108,6.08,16.588,90,90,1679
1978,3361,155,214,321339,313119,29,13.488,31,14.419,41264,13164,28100,4.204,13.178,23814,15752,8062,5.031,7.605,17450,5.573,15.211,23,23,155
1978,3362,2008,2235,144043,140727,273,12.245,262,11.752,23389,5255,18134,3.734,16.62,16927,4977,11950,3.537,12.028,6462,4.592,24.057,191,191,1852
1978,3363,3704,4420,761148,749634,489,10.014,1415,28.978,67473,9509,57964,1.268,9.001,44469,13344,31125,1.78,5.932,23004,3.069,11.864,1129,1129,7837
1978,3364,998,1189,565645,553746,96,8.064,99,8.316,52188,3143,49045,0.568,9.425,27723,4573,23150,0.826,5.006,24465,4.418,10.013,67,67,1881
1978,3365,161,227,66975,61819,13,5.752,11,4.867,16917,9615,7302,15.553,27.365,6687,262,6425,0.424,10.817,10230,16.548,21.634,9,9,238
1978,3366,1063,1165,204221,204138,153,13.345,116,10.118,23105,3349,19756,1.641,11.318,23506,2563,20943,1.256,11.515,-401,-0.196,22.637,89,89,1664
1978,3369,436,450,34440,32299,65,14.525,60,13.408,6649,605,6044,1.873,20.586,2445,1415,1030,4.381,7.57,4204,13.016,15.14,47,47,558
1978,3371,11701,12260,399068,378999,1838,15.272,1388,11.533,72448,17537,54911,4.627,19.116,32468,14954,17514,3.946,8.567,39980,10.549,17.134,1070,1073,8667
1978,3372,2131,2235,110589,107001,245,11.086,195,8.824,17034,3746,13288,3.501,15.919,9724,3388,6336,3.166,9.088,7310,6.832,18.176,144,145,1650
1978,3379,1102,1241,39989,38591,89,7.157,94,7.559,6313,824,5489,2.135,16.359,3425,1396,2029,3.617,8.875,2888,7.484,17.75,67,67,831
1978,3391,8407,8959,212820,206371,1348,15.495,829,9.529,35044,9389,25655,4.55,16.981,21836,7614,14222,3.689,10.581,13208,6.4,21.162,612,614,3805
1978,3399,14942,15648,478470,464615,1887,12.154,1643,10.582,80814,16778,64036,3.611,17.394,53442,18940,34502,4.076,11.502,27372,5.891,23.005,1273,1275,9978
1978,4231,22177,27897,319177,309497,3171,11.483,2607,9.441,62151,19844,42307,6.412,20.081,42694,18773,23921,6.066,13.795,19457,6.287,27.589,1649,1709,8578
1978,4232,6606,7775,90016,85268,1156,15.205,812,10.68,21960,6469,15491,7.587,25.754,12369,5763,6606,6.759,14.506,9591,11.248,29.012,537,542,1991
1978,4233,6755,8501,109033,102984,1220,14.705,811,9.775,26389,7995,18394,7.763,25.624,14240,6437,7803,6.25,13.827,12149,11.797,27.655,527,531,2484
1978,4234,15170,21207,367776,346951,3379,16.567,1757,8.614,81923,32369,49554,9.33,23.612,41200,18791,22409,5.416,11.875,40723,11.737,23.75,1036,1064,5850
1978,4235,5449,7959,127175,123137,930,11.883,665,8.497,23995,7157,16838,5.812,19.486,15980,6823,9157,5.541,12.977,8015,6.509,25.955,365,374,2168
1978,4236,11748,16964,209466,200598,2327,14.005,1630,9.81,46933,15854,31079,7.903,23.397,29077,14037,15040,6.998,14.495,17856,8.901,28.99,942,958,3847
1978,4237,9658,12481,136975,132219,1466,11.98,979,8,26543,8384,18159,6.341,20.075,17021,7279,9742,5.505,12.873,9522,7.202,25.747,616,637,3293
1978,4238,41449,54000,605035,582831,6179,11.671,4066,7.68,121156,41307,79849,7.087,20.788,76630,31711,44919,5.441,13.148,44526,7.64,26.296,2517,2562,13276
1978,4239,17887,19541,202063,197448,3036,15.837,2294,11.967,46221,13946,32275,7.063,23.409,36947,15946,21001,8.076,18.712,9274,4.697,37.425,1633,1651,7032
1978,4241,6030,8515,120867,118594,931,11.129,632,7.555,21360,5612,15748,4.732,18.011,16641,7358,9283,6.204,14.032,4719,3.979,28.064,383,390,2828
1978,4242,2365,3096,85644,83330,416,13.454,408,13.195,17507,6212,11295,7.455,21.009,12908,7318,5590,8.782,15.49,4599,5.519,30.981,229,244,2806
1978,4243,9460,10401,109627,107584,1667,16.345,1263,12.384,27725,9292,18433,8.637,25.771,23652,11463,12189,10.655,21.985,4073,3.786,43.969,894,899,4757
1978,4244,25624,31491,529326,514542,3691,11.791,3318,10.599,104538,31383,73155,6.099,20.317,74361,34118,40243,6.631,14.452,30177,5.865,28.904,2252,2286,15809
1978,4245,8757,11901,109163,107501,818,6.848,907,7.593,22097,5490,16607,5.107,20.555,18937,7782,11155,7.239,17.616,3160,2.94,35.231,566,585,4072
1978,4246,5142,7753,93950,92024,1092,14.469,680,9.01,19150,6645,12505,7.221,20.81,15490,5945,9545,6.46,16.833,3660,3.977,33.665,355,357,1690
1978,4247,11994,16201,151010,148262,1546,9.527,1598,9.848,32208,9301,22907,6.273,21.724,26584,11161,15423,7.528,17.93,5624,3.793,35.861,879,897,4601
1978,4248,4867,5995,119973,116559,427,7.077,505,8.369,20262,5474,14788,4.696,17.383,13354,6137,7217,5.265,11.457,6908,5.927,22.914,337,342,2640
1978,4249,17530,21658,228233,224268,2780,12.967,2343,10.928,47907,17544,30363,7.823,21.362,39806,17367,22439,7.744,17.749,8101,3.612,35.499,1560,1579,7530
1978,4251,24252,26840,266824,256546,3488,13.3,2260,8.617,57158,19607,37551,7.643,22.28,36690,14124,22566,5.505,14.302,20468,7.978,28.603,1446,1450,7182
1978,4411,41120,42244,866663,835675,4159,9.89,3778,8.984,132365,39237,93128,4.695,15.839,70240,27330,42910,3.27,8.405,62125,7.434,16.81,3068,3087,20613
1978,4412,12607,13038,81472,77930,1980,15.454,1528,11.926,20682,7726,12956,9.914,26.539,13530,5716,7814,7.335,17.362,7152,9.177,34.723,1211,1216,4357
1978,4413,38962,55214,356017,339455,6653,12.338,4071,7.55,77836,29792,48044,8.776,22.93,44691,18298,26393,5.39,13.166,33145,9.764,26.331,2580,2695,10628
1978,4421,23182,26753,212072,204188,3495,13.243,2773,10.507,47047,18962,28085,9.287,23.041,31342,14636,16706,7.168,15.35,15705,7.691,30.699,1907,1949,7854
1978,4422,17607,19851,108767,101888,3915,20.446,2509,13.103,31558,13759,17799,13.504,30.973,17876,8953,8923,8.787,17.545,13682,13.429,35.09,1798,1849,5677
1978,4431,25553,32253,185037,176654,5321,16.76,4312,13.582,48355,21965,26390,12.434,27.373,31737,16664,15073,9.433,17.966,16618,9.407,35.931,2808,2883,10073
1978,4441,53690,67107,612839,584230,7380,11.19,5075,7.695,127978,46065,81913,7.885,21.905,70593,28044,42549,4.8,12.083,57385,9.822,24.166,3480,3512,14998
1978,4442,13475,16350,111390,107283,2047,12.762,1426,8.891,24589,8245,16344,7.685,22.92,16421,5825,10596,5.43,15.306,8168,7.614,30.613,977,999,3668
1978,4451,64738,103037,1568029,1526813,13162,12.829,12284,11.973,308065,129941,178124,8.511,20.177,225761,101386,124375,6.64,14.786,82304,5.391,29.573,7753,7899,40955
1978,4452,24103,29850,175376,167540,4953,16.725,4482,15.134,50908,23568,27340,14.067,30.386,35371,18384,16987,10.973,21.112,15537,9.274,42.224,3240,3289,12345
1978,4453,28804,34007,171961,157911,3986,11.753,3799,11.202,52476,19452,33024,12.318,33.231,24738,11316,13422,7.166,15.666,27738,17.566,31.332,2702,2740,7719
1978,4461,37777,52301,491265,481941,5583,10.864,3763,7.322,89168,34764,54404,7.213,18.502,71137,30785,40352,6.388,14.761,18031,3.741,29.521,2151,2219,11934
1978,4471,122618,154238,873470,841900,21112,13.469,26126,16.668,247546,97406,150140,11.57,29.403,184161,94476,89685,11.222,21.874,63385,7.529,43.749,18233,18516,61222
1978,4481,59601,90392,754135,735406,13626,15.291,11068,12.42,184822,77712,107110,10.567,25.132,146926,70312,76614,9.561,19.979,37896,5.153,39.958,6534,6822,31231
1978,4482,11364,29761,159261,151576,3606,12.253,2945,10.007,39608,16547,23061,10.917,26.131,24509,11381,13128,7.508,16.169,15099,9.961,32.339,1138,1231,4431
1978,4483,16120,22047,127674,122189,3213,14.94,2130,9.904,31822,14097,17725,11.537,26.043,20971,8770,12201,7.177,17.163,10851,8.881,34.326,1231,1307,4684
1978,4511,30094,37311,217400,208868,6889,18.857,5334,14.6,60418,27724,32694,13.273,28.926,43252,21506,21746,10.296,20.708,17166,8.219,41.416,3634,3689,13026
1978,4512,7240,9651,59885,55213,1820,19.476,1208,12.927,19511,8190,11321,14.834,35.338,10199,4525,5674,8.196,18.472,9312,16.866,36.945,829,843,2938
1978,4522,525,6033,1124106,1092466,496,8.358,299,5.038,159840,55398,104442,5.071,14.631,98020,25777,72243,2.36,8.972,61820,5.659,17.945,37,43,3619
1978,4523,15429,31222,805555,799029,2931,9.305,3486,11.067,125039,45685,79354,5.718,15.649,112982,41929,71053,5.247,14.14,12057,1.509,28.28,1944,2000,8735
1978,4531,18487,19592,97542,92044,2947,15.362,2131,11.108,27449,8786,18663,9.545,29.822,16498,8651,7847,9.399,17.924,10951,11.898,35.848,1619,1659,4845
1978,4532,20073,23485,132347,123944,4686,20.662,3075,13.558,38865,16974,21891,13.695,31.357,22083,10979,11104,8.858,17.817,16782,13.54,35.634,2240,2267,6601
1978,4533,7526,8968,42926,40461,1553,17.611,1254,14.22,13230,5114,8116,12.639,32.699,8324,3659,4665,9.043,20.573,4906,12.125,41.146,880,885,2130
1978,4539,24611,29165,128213,122038,5448,19.03,4374,15.279,40130,18188,21942,14.904,32.883,27614,14221,13393,11.653,22.627,12516,10.256,45.255,2993,3052,9196
1978,4541,4714,6417,88959,88977,1062,16.978,738,11.799,20950,8512,12438,9.567,23.546,20633,11783,8850,13.243,23.189,317,0.356,46.379,427,432,3088
1978,4542,4331,5430,74254,72221,636,11.772,581,10.754,13494,4215,9279,5.836,18.684,9563,4094,5469,5.669,13.241,3931,5.443,26.483,372,375,2016
1978,4543,17221,22729,189886,191346,2225,9.757,2376,10.419,35485,10745,24740,5.615,18.545,38191,14433,23758,7.543,19.959,-2706,-1.414,37.09,1614,1630,6769
1978,4811,967,2280,260369,253289,274,12.047,263,11.563,35237,3109,32128,1.227,13.912,21129,2624,18505,1.036,8.342,14108,5.57,16.684,101,101,982
1978,4812,319,444,4947,4734,98,22.738,72,16.705,1626,490,1136,10.351,34.347,1257,855,402,18.061,26.553,369,7.795,53.105,41,41,107
1978,4831,500,764,38803,38565,100,13.098,99,12.967,8609,2598,6011,6.737,22.324,7959,4517,3442,11.713,20.638,650,1.685,41.276,49,54,1295
1978,4832,396,464,14434,14097,57,12.115,70,14.878,3417,2021,1396,14.337,24.24,2724,1364,1360,9.676,19.324,693,4.916,38.648,42,49,1041
1978,4841,19668,24295,491226,473253,4687,19.608,3903,16.328,114927,33951,80976,7.174,24.284,78530,34852,43678,7.364,16.594,36397,7.691,33.187,2801,2801,11530
1978,4842,40153,43844,561009,535618,7640,17.713,6217,14.414,139350,46492,92858,8.68,26.017,88289,32750,55539,6.114,16.484,51061,9.533,32.967,4729,4736,17632
1978,4851,394,423,19730,19321,35,8.018,62,14.204,2674,401,2273,2.075,13.84,1828,942,886,4.876,9.461,846,4.379,18.922,40,40,555
1978,4852,301,652,28807,28975,129,21.411,30,4.979,4990,2404,2586,8.297,17.222,5303,908,4395,3.134,18.302,-313,-1.08,34.444,19,19,231
1978,4853,6304,6364,78974,80448,1097,17.285,1062,16.734,18108,6669,11439,8.29,22.509,20829,9533,11296,11.85,25.891,-2721,-3.382,45.018,900,904,7192
1978,4854,3792,3939,86641,83510,379,9.613,386,9.791,16401,3608,12793,4.32,19.64,10128,4736,5392,5.671,12.128,6273,7.512,24.256,311,311,2277
1978,4855,349,375,6557,7625,95,26.685,57,16.011,1726,582,1144,7.633,22.638,3978,3430,548,44.987,52.174,-2252,-29.536,45.275,41,41,3124
1978,4859,808,857,18935,18715,145,17.079,129,15.194,4214,1266,2948,6.765,22.517,3819,2292,1527,12.247,20.407,395,2.111,40.813,102,103,1796
1978,4861,77,290,11733,10618,49,17.594,26,9.336,4162,2356,1806,22.189,39.198,1827,654,1173,6.159,17.207,2335,21.991,34.413,4,4,78
1978,4862,204,925,50296,47692,114,12.773,49,5.49,8616,4069,4547,8.532,18.066,3481,1733,1748,3.634,7.299,5135,10.767,14.598,10,10,36
1978,4869,61,257,6805,6720,34,13.36,29,11.395,1262,448,814,6.667,18.781,1151,817,334,12.159,17.129,111,1.652,34.259,3,3,28
1978,4871,136,140,1878,1767,33,25,17,12.879,427,151,276,8.548,24.172,228,78,150,4.416,12.907,199,11.265,25.814,9,9,30
1978,4872,668,679,9006,8276,118,17.481,110,16.296,2832,668,2164,8.072,34.221,1417,384,1033,4.64,17.123,1415,17.099,34.246,81,81,295
1978,4879,32,38,1151,1049,7,18.182,8,20.779,246,39,207,3.72,23.462,41,29,12,2.766,3.91,205,19.552,7.821,5,5,19
1978,4881,1867,2295,47098,46842,345,15.242,282,12.459,10389,2920,7469,6.234,22.179,9575,5786,3789,12.352,20.441,814,1.738,40.882,190,190,724
1978,4882,272,331,17006,17121,47,14.484,34,10.478,2115,384,1731,2.243,12.353,2360,476,1884,2.78,13.784,-245,-1.431,24.707,28,28,273
1978,4883,1833,2277,119958,107478,322,14.346,257,11.45,49643,21557,28086,20.057,46.189,25208,7106,18102,6.612,23.454,24435,22.735,46.908,160,160,1794
1978,4884,1758,2366,41456,40679,443,19.244,315,13.684,8521,2695,5826,6.625,20.947,6918,3754,3164,9.228,17.006,1603,3.941,34.013,203,208,2385
1978,4885,3395,5028,70012,67122,806,16.608,456,9.396,15565,4737,10828,7.057,23.189,9670,3570,6100,5.319,14.407,5895,8.783,28.813,239,247,1035
1978,4889,304,314,5268,4962,56,18.211,43,13.984,1580,477,1103,9.614,31.845,990,314,676,6.329,19.954,590,11.892,39.907,31,31,206
1978,4921,1017,1409,62011,56779,310,22.391,261,18.852,15369,2100,13269,3.699,27.068,4868,1923,2945,3.387,8.574,10501,18.495,17.147,182,182,786
1978,4922,983,984,6236,5824,238,23.437,301,29.641,2212,777,1435,13.342,37.984,1404,792,612,13.6,24.109,808,13.875,48.218,266,266,643
1978,4931,5547,8676,375374,365792,850,9.923,630,7.355,69506,17028,52478,4.655,19.002,50438,11716,38722,3.203,13.789,19068,5.213,27.577,247,248,1571
1978,5111,12861,14254,561671,548869,1657,11.778,1287,9.148,65447,13524,51923,2.464,11.924,40118,15785,24333,2.876,7.309,25329,4.615,14.618,975,980,7688
1978,5112,2534,3128,53617,49738,992,34.546,479,16.681,19638,8854,10784,17.801,39.483,12005,7085,4920,14.245,24.137,7633,15.347,48.273,238,240,1402
1978,5121,7976,13398,180775,181258,2112,15.7,2221,16.51,51342,19277,32065,10.635,28.325,51845,27429,24416,15.133,28.603,-503,-0.278,56.651,1109,1194,9848
1978,5122,960,968,7864,7244,257,28.731,110,12.297,2652,1477,1175,20.391,36.612,1468,448,1020,6.185,20.266,1184,16.346,40.533,80,80,337
1978,5151,5170,6059,171093,163956,563,9.433,382,6.4,28972,9020,19952,5.501,17.671,14728,5445,9283,3.321,8.983,14244,8.688,17.966,276,281,3337
1978,5152,3,3,18,13,(D),(D),(D),(D),15,(D),(D),(D),120,4,(D),(D),(D),32,11,88,64,(D),(D),(D)
1978,5173,1882,14352,918820,896500,579,4.031,603,4.198,142186,10564,131622,1.178,15.86,96614,4964,91650,0.554,10.777,45572,5.083,21.554,100,101,1089
1978,5174,452,781,23249,21160,118,15.797,50,6.693,6421,2250,4171,10.633,30.345,2289,1155,1134,5.458,10.818,4132,19.527,21.635,36,36,264
1978,5179,828,1833,52374,50466,227,12.803,107,6.035,11603,1317,10286,2.61,22.992,7740,864,6876,1.712,15.337,3863,7.655,30.674,67,68,286
1978,5182,4501,5957,165548,157989,1133,19.645,754,13.073,42410,16388,26022,10.373,26.844,27333,13586,13747,8.599,17.301,15077,9.543,34.601,398,408,4451
1978,5191,1970,2348,26272,26102,271,11.896,131,5.751,4973,1243,3730,4.762,19.053,4783,2924,1859,11.202,18.325,190,0.728,36.649,89,89,2329
1978,5211,21,54,23524,23824,(D),(D),0,0,1112,(D),1077,(D),4.668,1697,0,1697,0,7.123,-585,-2.456,9.335,0,0,0
1978,5221,20784,57545,1549929,1503141,3634,6.449,1252,2.222,219139,46313,172826,3.081,14.579,125243,21369,103874,1.422,8.332,93896,6.247,16.664,325,328,5621
1978,5222,23552,43051,322337,310201,3927,9.215,3058,7.176,70259,25788,44471,8.313,22.65,45990,18764,27226,6.049,14.826,24269,7.824,29.652,1186,1201,4598
1978,5223,2386,2634,25567,24354,587,23.66,281,11.326,6069,2439,3630,10.015,24.92,3643,2353,1290,9.662,14.959,2426,9.961,29.917,189,190,910
1978,5231,3778,7203,152974,156574,1052,14.783,879,12.352,29979,7587,22392,4.846,19.147,36828,14375,22453,9.181,23.521,-6849,-4.374,38.294,379,442,5073
1978,5232,88,99,3922,3887,23,24.084,16,16.754,441,148,293,3.808,11.346,370,58,312,1.492,9.519,71,1.827,19.038,12,12,49
1978,5239,8291,8586,65813,64055,1731,20.683,1297,15.498,17773,7289,10484,11.379,27.747,14036,5617,8419,8.769,21.913,3737,5.834,43.825,1036,1037,3332
1978,5241,5906,27039,1141177,1113102,2190,8.09,2251,8.316,178712,40778,137934,3.663,16.055,121175,47363,73812,4.255,10.886,57537,5.169,21.772,264,270,2774
1978,5242,82286,86072,807540,772105,11847,14.17,6910,8.265,155465,39033,116432,5.055,20.135,84888,28622,56266,3.707,10.994,70577,9.141,21.989,5166,5175,18760
1978,5259,564,771,6771,6756,52,6.603,85,10.794,1248,241,1007,3.567,18.474,1189,427,762,6.321,17.6,59,0.873,35.201,49,49,253
1978,5311,104625,106450,490401,475647,15146,14.25,14827,13.95,128286,55068,73218,11.578,26.971,98136,52468,45668,11.031,20.632,30150,6.339,41.264,12180,12188,35418
1978,5312,29213,30184,164631,152264,6509,22.733,3406,11.896,54021,22188,31833,14.572,35.479,29031,12650,16381,8.308,19.066,24990,16.412,38.133,2571,2574,8582
1978,5313,18280,18781,157276,148077,4084,22.879,2223,12.453,46549,17351,29198,11.718,31.436,27937,11618,16319,7.846,18.867,18612,12.569,37.733,1625,1629,6485
1978,5321,5227,7856,76225,75126,1760,23.473,1044,13.924,24374,12367,12007,16.462,32.444,21904,7921,13983,10.544,29.156,2470,3.288,58.313,617,627,2429
1978,5322,7333,8510,70268,67241,1881,23.002,1216,14.87,20757,8285,12472,12.321,30.87,14710,7517,7193,11.179,21.877,6047,8.993,43.753,840,853,4305
1978,5323,1692,1824,13260,12204,354,20.229,206,11.771,4450,1557,2893,12.758,36.463,2307,1086,1221,8.899,18.904,2143,17.56,37.807,130,131,556
1978,5324,3229,3560,37931,35649,690,20.282,374,10.994,10562,4205,6357,11.796,29.628,6122,3130,2992,8.78,17.173,4440,12.455,34.346,247,248,1980
1978,5331,831,956,11697,12036,192,20.87,120,13.043,3682,1443,2239,11.989,30.592,4460,1802,2658,14.972,37.056,-778,-6.464,61.183,77,77,270
1978,5411,95658,98350,472980,457381,13383,13.955,8488,8.851,109079,41553,67526,9.085,23.849,78554,47579,30975,10.402,17.175,30525,6.674,34.349,6131,6178,40177
1978,5412,37984,40648,281006,263812,7736,19.978,3885,10.033,71374,29825,41549,11.305,27.055,36924,18161,18763,6.884,13.996,34450,13.059,27.993,2713,2737,11143
1978,5413,35274,38678,483768,457406,7180,19.406,3822,10.33,121811,40718,81093,8.902,26.631,69089,26905,42184,5.882,15.105,52722,11.526,30.209,2506,2526,12139
1978,5414,8740,8960,63018,59091,2060,24.251,1129,13.291,19527,8574,10953,14.51,33.046,11769,5705,6064,9.655,19.917,7758,13.129,39.834,885,887,3709
1978,5415,1669,2055,21670,18443,1209,74.861,329,20.372,10392,6560,3832,35.57,56.348,4047,2771,1276,15.025,21.944,6345,34.404,43.888,213,216,1496
1978,5416,13680,14301,143865,135421,3284,23.758,2328,16.841,48873,17183,31690,12.689,36.09,31747,16139,15608,11.918,23.443,17126,12.646,46.886,1679,1688,10427
1978,5417,4425,5472,352789,341973,761,14.114,601,11.146,55487,19650,35837,5.746,16.226,33888,6867,27021,2.008,9.91,21599,6.316,19.819,355,357,1861
1978,5418,16753,18388,218643,211128,3080,17.182,2156,12.027,53218,18442,34776,8.735,25.207,38311,15012,23299,7.11,18.146,14907,7.061,36.292,1603,1607,8338
1978,5419,20575,22098,164991,155084,3476,16.25,2061,9.635,41514,13041,28473,8.409,26.769,21665,8464,13201,5.458,13.97,19849,12.799,27.94,1419,1564,5973
1978,5511,18969,36093,2434778,2368434,3915,10.958,3184,8.912,524823,137318,387505,5.798,22.159,391336,97684,293652,4.124,16.523,133487,5.636,33.046,402,433,4303
1978,5611,5160,5367,60953,59062,947,17.637,952,17.73,19003,6069,12934,10.276,32.175,15300,8168,7132,13.83,25.905,3703,6.27,51.81,656,659,3978
1978,5612,284,347,16111,16168,41,11.218,78,21.341,5080,842,4238,5.208,31.42,5260,3218,2042,19.904,32.533,-180,-1.113,62.84,30,35,566
1978,5613,8050,10435,453542,414641,2259,22.723,1272,12.795,174180,52926,121254,12.764,42.007,97381,25207,72174,6.079,23.486,76799,18.522,46.971,830,844,10206
1978,5614,14144,16049,167704,160846,3062,19.865,1792,11.626,40773,15727,25046,9.778,25.349,27057,11261,15796,7.001,16.822,13716,8.527,33.643,1323,1339,7538
1978,5615,12729,15095,110551,103137,2807,19.722,1082,7.602,28827,11115,17712,10.777,27.95,13895,5022,8873,4.869,13.472,14932,14.478,26.945,690,709,2965
1978,5616,8057,9809,301520,286680,2384,25.827,1227,13.293,85828,34069,51759,11.884,29.939,56048,22253,33795,7.762,19.551,29780,10.388,39.101,903,914,11747
1978,5617,42994,45363,586606,546223,10966,25.199,7274,16.715,192386,60751,131635,11.122,35.221,112203,44404,67799,8.129,20.542,80183,14.68,41.083,5681,5691,26359
1978,5619,8406,9024,112854,106532,2231,26.468,1041,12.35,35769,13249,22520,12.437,33.576,22471,7170,15301,6.73,21.093,13298,12.483,42.187,765,767,4656
1978,5621,4541,4685,86358,81628,716,15.414,636,13.692,20402,6944,13458,8.507,24.994,11166,5951,5215,7.29,13.679,9236,11.315,27.358,515,515,4381
1978,5622,1546,1871,32071,30583,269,14.776,168,9.228,6752,1761,4991,5.758,22.078,3816,1619,2197,5.294,12.478,2936,9.6,24.955,102,102,552
1978,5629,4047,4247,37225,35373,695,16.681,534,12.817,10754,3248,7506,9.182,30.402,7114,2752,4362,7.78,20.111,3640,10.29,40.223,400,400,1679
1978,6111,13051,13451,363210,351417,834,6.226,723,5.397,49896,7976,41920,2.27,14.199,26381,6221,20160,1.77,7.507,23515,6.691,15.014,564,565,3910
1978,6112,327,373,27142,26185,34,9.444,8,2.222,5313,313,5000,1.195,20.29,3308,954,2354,3.643,12.633,2005,7.657,25.266,4,4,773
1978,6113,1929,2162,731005,668092,114,5.284,105,4.867,167646,5163,162483,0.773,25.093,44199,13570,30629,2.031,6.616,123447,18.478,13.231,31,33,9814
1978,6114,1540,1725,24564,23920,314,18.685,225,13.389,6811,2383,4428,9.962,28.474,5575,3395,2180,14.193,23.307,1236,5.167,46.614,165,170,2580
1978,6115,3409,3778,38620,39211,628,16.996,462,12.503,9576,3620,5956,9.232,24.422,10990,6228,4762,15.883,28.028,-1414,-3.606,48.843,333,333,5206
1978,6116,8686,9151,78526,81555,2226,25.462,1409,16.117,28092,11588,16504,14.209,34.446,33696,26105,7591,32.009,41.317,-5604,-6.871,68.891,1073,1090,23867
1978,6117,753,767,11369,10732,169,22.838,115,15.541,2886,733,2153,6.83,26.893,1562,731,831,6.812,14.555,1324,12.338,29.111,84,86,379
1978,6211,139095,142970,749943,716953,15646,11.227,8422,6.043,157734,59602,98132,8.313,22.001,92083,28586,63497,3.987,12.844,65651,9.157,25.687,6542,6575,20397
1978,6212,80894,82027,319192,298095,6745,8.399,3299,4.108,72212,20821,51391,6.985,24.224,29685,9873,19812,3.312,9.958,42527,14.266,19.916,2452,2470,7352
1978,6213,26458,27306,80211,74046,4435,17.054,1835,7.056,24729,11029,13700,14.895,33.397,11854,6300,5554,8.508,16.009,12875,17.388,32.018,1303,1310,5141
1978,6214,3816,4769,75476,71102,891,19.492,495,10.829,20006,7778,12228,10.939,28.137,11130,4793,6337,6.741,15.654,8876,12.484,31.307,265,279,1764
1978,6215,3533,4437,56533,54812,624,14.342,452,10.388,11082,3690,7392,6.732,20.218,7758,3564,4194,6.502,14.154,3324,6.064,28.308,310,314,2286
1978,6216,1983,2554,70969,66115,521,21.542,250,10.337,20627,8208,12419,12.415,31.199,11023,5238,5785,7.923,16.672,9604,14.526,33.345,135,139,3062
1978,6219,2040,2316,46466,43179,444,19.982,256,11.521,15704,6353,9351,14.713,36.37,8881,3610,5271,8.361,20.568,6823,15.802,41.136,157,157,2299
1978,6221,3996,4829,2330623,2254302,171,3.556,130,2.704,225432,25831,199601,1.146,10,72094,25978,46116,1.152,3.198,153338,6.802,6.396,74,77,11712
1978,6222,273,340,36543,34763,37,11.298,12,3.664,5877,1617,4260,4.651,16.906,2284,742,1542,2.134,6.57,3593,10.336,13.14,7,7,429
1978,6223,147,182,38294,36709,24,13.754,9,5.158,5133,1156,3977,3.149,13.983,2096,759,1337,2.068,5.71,3037,8.273,11.42,3,3,80
1978,6231,8400,10942,784269,749871,1024,9.452,807,7.449,152455,54812,97643,7.31,20.331,83923,46503,37420,6.201,11.192,68532,9.139,22.383,519,539,28113
1978,6232,2663,3189,72548,66683,718,24.597,178,6.098,18122,7944,10178,11.913,27.177,6353,2137,4216,3.205,9.527,11769,17.649,19.054,90,92,1550
1978,6233,5911,6607,189365,182783,1061,16.493,713,11.083,40390,14242,26148,7.792,22.097,26963,16812,10151,9.198,14.751,13427,7.346,29.503,450,464,7552
1978,6239,2190,2563,65080,63020,419,17.207,163,6.694,13021,4640,8381,7.363,20.662,8747,2691,6056,4.27,13.88,4274,6.782,27.759,97,99,1488
1978,6241,9550,13053,213032,194451,2325,18.722,1056,8.503,65689,18191,47498,9.355,33.782,28634,8399,20235,4.319,14.726,37055,19.056,29.451,413,418,3297
1978,6242,2770,3227,35146,33414,520,16.799,257,8.302,10511,4035,6476,12.076,31.457,6862,3578,3284,10.708,20.536,3649,10.921,41.073,119,122,2447
1978,6243,2888,4157,200053,175516,847,21.424,440,11.129,78435,20734,57701,11.813,44.688,29092,10044,19048,5.723,16.575,49343,28.113,33.15,143,150,1866
1978,6244,21696,25177,208511,192185,4449,18.386,2491,10.294,63344,25169,38175,13.096,32.96,31008,12720,18288,6.619,16.134,32336,16.825,32.269,1647,1659,6539
1978,7111,4776,4816,55782,53762,1037,21.935,860,18.191,18593,7182,11411,13.359,34.584,14483,5125,9358,9.533,26.939,4110,7.645,53.878,629,630,3065
1978,7112,2114,2210,56799,55926,458,20.889,423,19.293,14559,3712,10847,6.637,26.033,12798,5939,6859,10.619,22.884,1761,3.149,45.768,299,300,2860
1978,7113,2016,2055,25912,24645,457,23.122,300,15.178,8782,3432,5350,13.926,35.635,6180,2629,3551,10.668,25.077,2602,10.558,50.153,209,212,1478
1978,7114,837,856,10155,8685,234,29.379,115,14.438,4406,2642,1764,30.42,50.731,1544,590,954,6.793,17.778,2862,32.953,35.556,87,88,435
1978,7115,2583,2614,17560,15996,974,41.983,386,16.638,7480,3860,3620,24.132,46.763,4255,2513,1742,15.711,26.601,3225,20.162,53.202,260,261,1754
1978,7121,1641,1753,28475,27325,137,7.874,111,6.379,5122,809,4313,2.961,18.745,2756,453,2303,1.658,10.086,2366,8.659,20.172,63,64,221
1978,7131,1411,1498,50169,45275,273,18.597,213,14.51,12829,5055,7774,11.165,28.336,3179,1093,2086,2.414,7.022,9650,21.314,14.043,173,173,706
1978,7132,596,607,16983,16018,140,24.014,92,15.78,4546,1777,2769,11.094,28.381,2615,1052,1563,6.568,16.325,1931,12.055,32.651,72,72,972
1978,7139,27634,29104,401304,379096,4105,14.424,2815,9.891,95434,32902,62532,8.679,25.174,51130,17744,33386,4.681,13.487,44304,11.687,26.975,2138,2145,12352
1978,7211,29006,32739,943716,901579,4883,14.979,4601,14.114,237810,99696,138114,11.058,26.377,153566,82844,70722,9.189,17.033,84244,9.344,34.066,3357,3395,50308
1978,7212,3262,3478,17486,16086,748,22.348,486,14.52,6138,2841,3297,17.661,38.157,3413,1440,1973,8.952,21.217,2725,16.94,42.434,322,323,945
1978,7213,5825,5883,29912,29604,393,6.555,617,10.292,5815,1096,4719,3.702,19.643,5082,2568,2514,8.675,17.167,733,2.476,34.334,454,454,1675
1978,7223,15698,24135,440285,424974,4393,18.444,3758,15.778,123940,59998,63942,14.118,29.164,92925,45219,47706,10.64,21.866,31015,7.298,43.732,2102,2121,16647
1978,7224,65088,65820,348662,337950,10338,15.54,11749,17.661,107908,51722,56186,15.305,31.93,86660,43977,42683,13.013,25.643,21248,6.287,51.286,9217,9225,34643
1978,7225,169639,210446,3442364,3230933,40883,19.84,32128,15.591,1038675,560826,477849,17.358,32.148,613739,309865,303874,9.591,18.996,424936,13.152,37.991,22862,23317,197115
1978,8111,81483,84670,406196,381684,15767,19.149,11100,13.481,118227,53880,64347,14.116,30.975,68912,33852,35060,8.869,18.055,49315,12.92,36.109,8504,8543,25594
1978,8112,10782,11803,63612,61427,1700,14.373,1749,14.788,13800,4983,8817,8.112,22.466,9440,4843,4597,7.884,15.368,4360,7.098,30.736,1398,1404,3445
1978,8113,15421,16396,123567,117820,2561,15.966,1850,11.533,30900,10065,20835,8.543,26.226,19323,8909,10414,7.562,16.4,11577,9.826,32.801,1413,1415,4411
1978,8114,21877,23464,138681,132432,4165,18.048,3392,14.698,33109,13036,20073,9.844,25.001,20511,10102,10409,7.628,15.488,12598,9.513,30.976,2560,2569,6394
1978,8121,82383,89403,403218,390470,13708,15.459,12244,13.808,103406,46008,57398,11.783,26.482,77483,38267,39216,9.8,19.844,25923,6.639,39.687,9528,9627,28489
1978,8122,17114,19355,107772,106390,1644,8.609,1128,5.907,17741,5716,12025,5.373,16.676,15073,4032,11041,3.79,14.168,2668,2.508,28.336,716,733,2275
1978,8123,33744,39154,332033,329660,4223,10.682,4981,12.6,60955,19485,41470,5.911,18.49,56242,24651,31591,7.478,17.061,4713,1.43,34.121,3638,3735,17934
1978,8129,10885,16448,159342,157995,3554,22.302,2529,15.87,46776,20464,26312,12.952,29.606,42955,18396,24559,11.643,27.188,3821,2.418,54.375,1199,1234,7441
1978,8131,67431,67594,587221,546369,5083,7.69,2101,3.178,125366,17558,107808,3.214,22.945,43808,7864,35944,1.439,8.018,81558,14.927,16.036,1130,1130,3147
1978,8132,6491,7210,106883,100012,1070,15.399,547,7.872,33806,10145,23661,10.144,33.802,19904,5569,14335,5.568,19.902,13902,13.9,39.803,305,311,2638
1978,8133,5994,6903,100601,93266,1196,18.024,661,9.962,32280,8675,23605,9.301,34.611,17561,4942,12619,5.299,18.829,14719,15.782,37.658,328,339,2176
1978,8134,26587,27693,231032,217517,2194,8.027,1471,5.382,52041,9560,42481,4.395,23.925,24902,5324,19578,2.448,11.448,27139,12.477,22.897,946,946,3115
1978,8139,52338,54285,407182,387801,5456,10.254,3308,6.217,95253,20949,74304,5.402,24.562,56994,13501,43493,3.481,14.697,38259,9.866,29.393,2102,2112,7998
1979,1131,208,216,4201,4080,36,16.822,32,14.953,701,173,528,4.241,17.183,433,204,229,5.001,10.614,268,6.569,21.228,26,26,143
1979,1132,84,99,1564,1630,14,13.861,18,17.822,386,47,339,2.883,23.681,515,186,329,11.411,31.595,-129,-7.914,47.362,15,15,182
1979,1133,11701,11826,101672,100907,2122,17.95,2113,17.874,24320,9266,15054,9.183,24.101,22794,9409,13385,9.324,22.589,1526,1.512,45.178,1541,1542,6566
1979,1141,1483,1525,10944,10547,299,19.472,320,20.84,4437,1450,2987,13.748,42.069,3623,1280,2343,12.136,34.351,814,7.718,68.702,229,229,875
1979,1142,136,136,593,541,30,22.989,19,14.559,207,88,119,16.281,38.298,99,44,55,8.141,18.316,108,19.981,36.633,14,14,33
1979,1151,4067,4437,49090,51461,639,14.167,786,17.426,14445,5900,8545,11.465,28.07,19307,7690,11617,14.944,37.518,-4862,-9.448,56.14,512,555,4737
1979,1152,1649,1669,10064,9942,284,17.212,246,14.909,2506,853,1653,8.58,25.207,2270,918,1352,9.234,22.834,236,2.374,45.667,188,188,641
1979,1153,674,689,9384,8595,176,26.911,106,16.208,3535,1720,1815,20.013,41.131,2017,707,1310,8.226,23.468,1518,17.662,46.937,81,81,556
1979,2111,5641,7429,128900,124563,1045,14.455,646,8.936,24605,6760,17845,5.427,19.753,16103,5668,10435,4.55,12.928,8502,6.825,25.855,352,356,2161
1979,2121,3107,3874,245376,216054,823,21.277,811,20.967,88883,15310,73573,7.086,41.139,30355,14386,15969,6.659,14.05,58528,27.09,28.099,557,559,6155
1979,2122,459,640,79850,78751,95,14.66,111,17.13,11413,2214,9199,2.811,14.493,9177,2974,6203,3.776,11.653,2236,2.839,23.306,66,66,346
1979,2123,3671,5170,116899,111945,496,9.615,473,9.169,22339,5976,16363,5.338,19.955,12459,4519,7940,4.037,11.13,9880,8.826,22.259,238,243,1725
1979,2131,7422,8610,247172,233415,1723,20.792,1077,12.996,71120,22355,48765,9.577,30.469,42904,18272,24632,7.828,18.381,28216,12.088,36.762,666,671,8740
1979,2211,1511,5518,515601,504941,254,4.614,227,4.124,48217,16852,31365,3.337,9.549,27080,3777,23303,0.748,5.363,21137,4.186,10.726,32,32,387
1979,2212,525,2286,132995,132034,111,4.896,73,3.22,9171,3440,5731,2.605,6.946,7377,1883,5494,1.426,5.587,1794,1.359,11.174,22,22,83
1979,2213,3988,4296,34442,33926,430,10.231,244,5.805,5025,1613,3412,4.754,14.812,3989,1477,2512,4.354,11.758,1036,3.054,23.516,159,159,487
1979,2361,107952,108295,636043,607041,26776,25.513,20090,19.142,241470,107532,133938,17.714,39.778,183948,80014,103934,13.181,30.302,57522,9.476,60.605,15735,15735,62219
1979,2362,35943,36532,720531,678145,6242,17.573,4217,11.872,211879,40786,171093,6.014,31.244,127115,28722,98393,4.235,18.745,84764,12.499,37.489,3197,3197,21436
1979,2371,13867,14229,407496,402388,1678,11.904,1413,10.024,92765,14622,78143,3.634,23.054,82495,14951,67544,3.716,20.501,10270,2.552,41.003,1073,1074,7936
1979,2372,7017,7171,66717,62353,2086,30.571,1391,20.385,25974,12980,12994,20.817,41.656,17329,8126,9203,13.032,27.792,8645,13.865,55.584,1013,1015,4377
1979,2373,10963,11282,241497,232423,1119,9.975,992,8.843,60755,9389,51366,4.04,26.14,42700,10419,32281,4.483,18.372,18055,7.768,36.743,728,730,7017
1979,2379,4432,4477,84687,77658,899,20.688,636,14.636,29651,7436,22215,9.575,38.182,15340,4268,11072,5.496,19.753,14311,18.428,39.507,474,474,2347
1979,2381,68718,69118,592784,560423,12394,18.346,9270,13.722,191579,56118,135461,10.014,34.185,126873,44021,82852,7.855,22.639,64706,11.546,45.278,7247,7248,34805
1979,2382,95590,97289,997253,945569,13772,14.441,9924,10.406,252094,57336,194758,6.064,26.661,148879,46277,102602,4.894,15.745,103215,10.916,31.49,7772,7783,33309
1979,2383,72033,72428,553586,528157,13649,19.134,11464,16.071,179436,54823,124613,10.38,33.974,128161,49250,78911,9.325,24.266,51275,9.708,48.531,9037,9041,37489
1979,2389,32740,32881,274770,255750,6169,19.292,4362,13.641,93946,27653,66293,10.813,36.734,55652,19897,35755,7.78,21.76,38294,14.973,43.521,3328,3329,13632
1979,3111,1454,2136,61851,60829,107,4.974,137,6.369,8531,1950,6581,3.206,14.025,6427,1577,4850,2.593,10.566,2104,3.459,21.132,78,80,613
1979,3112,517,878,81547,81036,45,5.111,50,5.679,6243,1055,5188,1.302,7.704,5103,990,4113,1.222,6.297,1140,1.407,12.594,29,29,396
1979,3113,1160,1547,93282,95601,159,10.16,195,12.46,8450,1779,6671,1.861,8.839,12863,3294,9569,3.446,13.455,-4413,-4.616,17.678,108,112,882
1979,3114,1285,1823,197188,195119,92,4.969,149,8.048,24343,3178,21165,1.629,12.476,20095,3806,16289,1.951,10.299,4248,2.177,20.598,83,83,1367
1979,3115,2104,2933,153559,154422,127,4.228,268,8.923,14636,3293,11343,2.132,9.478,16255,4684,11571,3.033,10.526,-1619,-1.048,18.956,174,176,2304
1979,3116,4485,5124,333337,332154,344,6.592,533,10.214,37213,6372,30841,1.918,11.204,35048,12304,22744,3.704,10.552,2165,0.652,21.103,356,358,4879
1979,3117,751,884,50596,49538,54,6.088,60,6.764,9478,2450,7028,4.946,19.133,7363,1548,5815,3.125,14.863,2115,4.269,29.727,35,35,850
1979,3118,7974,9592,315848,313237,1151,12.04,1086,11.36,44353,15727,28626,5.021,14.16,39064,17026,22038,5.436,12.471,5289,1.688,24.942,745,764,7548
1979,3119,1958,2336,114401,113853,164,6.894,250,10.509,14676,2855,11821,2.508,12.89,13749,4681,9068,4.111,12.076,927,0.814,24.152,162,162,1588
1979,3121,2237,2843,190294,188353,175,6.07,255,8.845,22877,4709,18168,2.5,12.146,18739,7024,11715,3.729,9.949,4138,2.197,19.898,151,151,2142
1979,3122,130,196,47894,47872,11,5.486,20,9.975,2980,345,2635,0.721,6.225,2913,525,2388,1.097,6.085,67,0.14,12.17,10,10,92
1979,3131,466,722,126977,129766,42,5.718,67,9.122,9655,3036,6619,2.34,7.44,15063,6415,8648,4.944,11.608,-5408,-4.168,14.881,34,34,1509
1979,3132,1789,2242,369903,370431,153,6.739,210,9.249,26576,5084,21492,1.372,7.174,27345,7013,20332,1.893,7.382,-769,-0.208,14.349,131,133,3024
1979,3133,1593,1828,134079,134653,163,8.966,143,7.866,12661,3178,9483,2.36,9.403,13716,3911,9805,2.905,10.186,-1055,-0.783,18.805,80,81,1519
1979,3141,4477,4784,139442,139813,568,11.878,564,11.794,17768,5009,12759,3.583,12.708,18635,5028,13607,3.596,13.329,-867,-0.62,25.417,427,427,3558
1979,3149,3525,3675,148670,148542,470,12.974,365,10.076,23912,7713,16199,5.192,16.098,23429,8461,14968,5.696,15.773,483,0.325,31.545,257,257,3959
1979,3151,1410,1549,140474,139638,146,9.407,152,9.794,18711,5294,13417,3.791,13.4,17106,4999,12107,3.58,12.25,1605,1.149,24.5,116,116,3029
1979,3152,13265,15129,986750,995774,1960,12.93,2020,13.325,136511,47937,88574,4.814,13.709,154965,59586,95379,5.984,15.562,-18454,-1.853,27.418,1470,1481,31471
1979,3159,1690,1821,80755,79792,179,9.835,177,9.725,11494,2310,9184,2.895,14.405,9704,2910,6794,3.647,12.162,1790,2.243,24.323,125,125,1322
1979,3161,381,428,22866,23579,26,5.869,56,12.641,1993,373,1620,1.582,8.452,3434,555,2879,2.354,14.564,-1441,-6.111,16.905,40,40,343
1979,3162,525,788,153763,155669,49,6.14,69,8.647,14651,2228,12423,1.431,9.412,18618,5793,12825,3.721,11.96,-3967,-2.548,18.823,38,38,1746
1979,3169,1372,1436,69325,69637,141,9.748,162,11.199,9732,2191,7541,3.146,13.975,10336,2473,7863,3.551,14.843,-604,-0.867,27.951,108,108,1427
1979,3211,5699,6286,172218,169540,811,13.02,697,11.19,27658,8183,19475,4.827,16.314,22052,7930,14122,4.677,13.007,5606,3.307,26.014,473,483,4328
1979,3212,1036,1315,99474,97833,157,12.11,120,9.256,12007,4030,7977,4.119,12.273,8761,2929,5832,2.994,8.955,3246,3.318,17.91,75,75,895
1979,3219,8333,9139,318176,316592,1126,12.406,1000,11.018,49195,13570,35625,4.286,15.539,45837,14291,31546,4.514,14.478,3358,1.061,28.957,692,692,7940
1979,3221,376,758,216689,217474,31,4.026,55,7.143,10141,2647,7494,1.217,4.663,11675,2184,9491,1.004,5.368,-1534,-0.705,9.326,33,33,215
1979,3222,3480,5073,411378,408940,297,5.844,316,6.217,40228,7663,32565,1.874,9.837,34957,10898,24059,2.665,8.548,5271,1.289,17.096,179,180,4002
1979,3231,29798,31149,635074,621055,3307,10.657,3073,9.903,90615,21771,68844,3.505,14.591,62374,26065,36309,4.197,10.043,28241,4.547,20.086,2176,2192,13399
1979,3241,1474,2403,582597,579779,206,8.639,169,7.087,35950,4015,31935,0.693,6.201,30452,2320,28132,0.4,5.252,5498,0.948,10.505,76,76,893
1979,3251,1010,2073,270440,268489,155,7.501,142,6.872,18688,3601,15087,1.341,6.96,14701,3854,10847,1.435,5.475,3987,1.485,10.951,39,42,473
1979,3252,384,614,164754,164159,40,6.478,47,7.611,9498,2418,7080,1.473,5.786,8286,1683,6603,1.025,5.048,1212,0.738,10.095,24,24,129
1979,3253,757,1145,55405,56431,82,7.078,109,9.409,5239,794,4445,1.407,9.284,7466,1526,5940,2.704,13.23,-2227,-3.946,18.568,43,43,320
1979,3254,866,1089,158129,155363,103,9.45,105,9.633,16180,4512,11668,2.904,10.414,10518,3365,7153,2.166,6.77,5662,3.644,13.54,57,57,1033
1979,3255,1657,2115,82240,80645,146,6.933,128,6.078,9763,1789,7974,2.218,12.106,6568,1673,4895,2.075,8.144,3195,3.962,16.289,68,68,304
1979,3256,2021,2280,116551,113870,201,8.798,210,9.192,15633,3148,12485,2.765,13.729,10252,2419,7833,2.124,9.003,5381,4.726,18.006,130,130,861
1979,3259,1517,1999,123369,122362,169,8.379,205,10.164,12450,2604,9846,2.128,10.175,10479,4308,6171,3.521,8.564,1971,1.611,17.128,113,113,844
1979,3261,9139,10581,549936,533801,1212,11.673,816,7.859,91909,19812,72097,3.711,17.218,59132,17543,41589,3.286,11.078,32777,6.14,22.155,517,524,7709
1979,3262,1714,2099,239329,235819,201,9.689,152,7.327,22445,3796,18649,1.61,9.518,15734,4307,11427,1.826,6.672,6711,2.846,13.344,90,90,1243
1979,3271,1264,1574,100074,99649,190,11.987,212,13.375,11384,2819,8565,2.829,11.424,10661,2978,7683,2.989,10.699,723,0.726,21.397,157,158,1410
1979,3272,1342,1620,181792,183415,200,12.5,160,10,13773,2420,11353,1.319,7.509,16812,4526,12286,2.468,9.166,-3039,-1.657,15.018,113,115,1364
1979,3273,7483,9352,203579,196518,710,7.562,784,8.35,39668,8147,31521,4.146,20.185,25411,8851,16560,4.504,12.931,14257,7.255,25.861,469,513,4046
1979,3274,277,375,18114,17669,36,9.499,44,11.609,1930,595,1335,3.367,10.923,1051,446,605,2.524,5.948,879,4.975,11.897,32,32,86
1979,3279,1938,2261,100557,98193,198,8.661,248,10.849,13447,2668,10779,2.717,13.695,8792,3095,5697,3.152,8.954,4655,4.741,17.908,156,158,1143
1979,3311,187,199,13827,13892,36,17.778,43,21.235,2992,1089,1903,7.839,21.538,3256,2605,651,18.752,23.438,-264,-1.9,43.075,29,29,346
1979,3312,524,696,84166,82537,49,7.143,29,4.227,7984,864,7120,1.047,9.673,4743,1382,3361,1.674,5.747,3241,3.927,11.493,14,14,391
1979,3313,445,762,174363,169411,47,6.233,31,4.111,23842,9014,14828,5.321,14.073,14966,9743,5223,5.751,8.834,8876,5.239,17.668,7,7,59
1979,3314,677,846,107981,104011,81,9.463,101,11.799,14917,2876,12041,2.765,14.342,6945,3048,3897,2.93,6.677,7972,7.665,13.354,50,50,431
1979,3315,2821,3173,341794,329836,176,5.542,181,5.7,41279,7645,33634,2.318,12.515,17168,4906,12262,1.487,5.205,24111,7.31,10.41,109,109,1860
1979,3321,2799,2994,165972,162101,195,6.511,197,6.578,20054,2435,17619,1.502,12.371,12200,4749,7451,2.93,7.526,7854,4.845,15.052,119,119,2169
1979,3322,1110,1216,95519,94404,91,7.505,84,6.928,9971,2123,7848,2.249,10.562,7676,1917,5759,2.031,8.131,2295,2.431,16.262,43,45,887
1979,3323,9278,10111,382222,370292,915,9.096,811,8.062,64386,13832,50554,3.735,17.388,40234,11395,28839,3.077,10.865,24152,6.522,21.731,527,528,5289
1979,3324,1383,1785,173725,172948,106,5.91,123,6.858,17801,3740,14061,2.162,10.293,16408,5639,10769,3.261,9.487,1393,0.805,18.974,63,63,1301
1979,3325,844,927,95934,94375,70,7.523,77,8.275,8963,1191,7772,1.262,9.497,5920,1244,4676,1.318,6.273,3043,3.224,12.546,42,42,414
1979,3326,1539,1728,76755,73371,149,8.729,107,6.268,11782,2430,9352,3.312,16.058,5054,1368,3686,1.865,6.888,6728,9.17,13.777,62,62,452
1979,3327,18605,18918,349714,329469,2401,12.978,1565,8.459,70170,14504,55666,4.402,21.298,29667,13207,16460,4.009,9.004,40503,12.293,18.009,1072,1075,6679
1979,3328,5199,5480,129590,125436,439,8.007,445,8.116,22060,3755,18305,2.994,17.587,13919,5045,8874,4.022,11.096,8141,6.49,22.193,305,306,2955
1979,3329,4295,4805,396399,384102,514,10.745,471,9.846,50970,7945,43026,2.068,13.27,26292,10144,16148,2.641,6.845,24678,6.425,13.69,276,277,2655
1979,3331,2821,3254,411785,392839,359,11.096,322,9.952,64363,10786,53577,2.746,16.384,26733,11430,15303,2.91,6.805,37630,9.579,13.61,182,182,2256
1979,3332,3366,3619,194613,189980,239,6.554,294,8.063,23484,3033,20451,1.596,12.361,14276,4437,9839,2.336,7.514,9208,4.847,15.029,178,178,1798
1979,3333,2024,2135,167930,161028,178,8.422,135,6.388,23281,5554,17727,3.449,14.458,9535,2795,6740,1.736,5.921,13746,8.536,11.843,86,86,918
1979,3334,1646,1885,198305,193004,234,12.503,207,11.061,26225,4313,21912,2.235,13.588,15731,4251,11480,2.203,8.151,10494,5.437,16.301,140,140,1234
1979,3335,9557,9979,307835,295813,858,8.702,620,6.288,41818,6516,35302,2.203,14.137,17762,5936,11826,2.007,6.004,24056,8.132,12.009,395,396,3202
1979,3336,652,787,199512,195574,56,7.143,50,6.378,25311,6508,18803,3.328,12.942,16690,10795,5895,5.52,8.534,8621,4.408,17.068,23,23,206
1979,3339,5677,6190,386698,373592,468,7.593,415,6.733,51709,8563,43146,2.292,13.841,25791,7573,18218,2.027,6.904,25918,6.938,13.807,248,248,2970
1979,3341,881,1030,273496,254655,194,19.705,103,10.462,55545,11525,44020,4.526,21.812,17604,7135,10469,2.802,6.913,37941,14.899,13.826,62,62,2030
1979,3342,1531,1694,278616,268956,174,10.293,167,9.879,36881,6676,30205,2.482,13.713,18018,4796,13222,1.783,6.699,18863,7.013,13.398,91,91,1713
1979,3343,471,499,63301,64900,74,14.726,81,16.119,6177,947,5230,1.459,9.518,9245,3203,6042,4.935,14.245,-3068,-4.727,19.035,61,61,298
1979,3344,3215,3621,421229,396252,521,14.747,345,9.765,74012,17143,56869,4.326,18.678,24225,9142,15083,2.307,6.114,49787,12.564,12.227,209,211,4601
1979,3345,3364,3840,546387,530534,387,10.147,335,8.783,68709,13696,55013,2.582,12.951,36651,12471,24180,2.351,6.908,32058,6.043,13.817,187,187,4252
1979,3346,592,619,24895,25717,98,15.845,97,15.683,4009,959,3050,3.729,15.589,5661,2116,3545,8.228,22.013,-1652,-6.424,31.178,71,71,1069
1979,3351,1183,1302,95904,94006,128,9.775,143,10.92,13620,2999,10621,3.19,14.489,9839,4194,5645,4.461,10.466,3781,4.022,20.933,93,93,1450
1979,3352,342,451,145722,150629,36,8.018,32,7.127,9881,2087,7794,1.386,6.56,19859,735,19124,0.488,13.184,-9978,-6.624,13.12,15,15,114
1979,3353,1848,2311,303807,298266,191,8.288,178,7.724,32692,6683,26009,2.241,10.961,21393,5182,16211,1.737,7.172,11299,3.788,14.345,94,94,892
1979,3359,1497,1792,188719,181519,164,9.116,178,9.894,31894,9282,22612,5.114,17.571,17514,9317,8197,5.133,9.649,14380,7.922,19.297,87,87,2338
1979,3361,163,222,342717,333248,35,16.355,19,8.879,32082,359,31723,0.108,9.627,12583,156,12427,0.047,3.776,19499,5.851,7.552,13,13,53
1979,3362,1909,2151,153267,149002,241,11.155,260,12.034,27673,4704,22969,3.157,18.572,18808,5402,13406,3.625,12.623,8865,5.95,25.245,190,190,2411
1979,3363,3316,4063,809522,783150,396,9.653,475,11.578,87711,16602,71109,2.12,11.2,35024,10700,24324,1.366,4.472,52687,6.728,8.944,317,318,3054
1979,3364,1003,1195,609154,572316,98,8.184,103,8.601,83727,3283,80444,0.574,14.63,9471,3920,5551,0.685,1.655,74256,12.975,3.31,47,47,881
1979,3365,151,204,77349,71281,10,4.831,16,7.729,14286,282,14004,0.396,20.042,2142,560,1582,0.786,3.005,12144,17.037,6.01,5,5,77
1979,3366,1084,1189,205957,204934,169,14.5,122,10.468,26900,3733,23167,1.822,13.126,25183,3243,21940,1.582,12.288,1717,0.838,24.577,87,87,1465
1979,3369,408,424,34235,34318,58,13.536,67,15.636,3615,633,2982,1.845,10.534,3791,941,2850,2.742,11.047,-176,-0.513,21.068,48,48,408
1979,3371,11779,12362,400521,398120,1611,13.113,1458,11.868,53219,13665,39554,3.432,13.368,48402,17048,31354,4.282,12.158,4817,1.21,24.315,1097,1099,9957
1979,3372,2153,2269,120517,115023,241,10.74,191,8.512,19677,2935,16742,2.552,17.107,8856,2616,6240,2.274,7.699,10821,9.408,15.399,122,122,1444
1979,3379,1079,1220,40645,40409,105,8.685,83,6.865,5914,1521,4393,3.764,14.636,5179,2706,2473,6.697,12.817,735,1.819,25.633,53,54,2063
1979,3391,8529,9075,212227,207504,1171,13.056,959,10.692,35088,9171,25917,4.42,16.91,25621,9944,15677,4.792,12.347,9467,4.562,24.694,689,692,4464
1979,3399,14020,14682,475933,472906,1702,11.533,1854,12.563,71064,16350,54714,3.457,15.027,64723,20665,44058,4.37,13.686,6341,1.341,27.372,1334,1336,10052
1979,4231,23104,28878,343705,333976,2856,9.952,2498,8.704,59124,16564,42560,4.96,17.703,39787,16830,22957,5.039,11.913,19337,5.79,23.826,1627,1657,8754
1979,4232,7034,8243,97284,94583,1056,13.055,748,9.247,19394,6800,12594,7.189,20.505,14145,4300,9845,4.546,14.955,5249,5.55,29.91,514,519,2263
1979,4233,7250,9096,118118,114128,1197,13.469,779,8.766,22956,7082,15874,6.205,20.114,14893,4813,10080,4.217,13.049,8063,7.065,26.099,530,538,3024
1979,4234,16410,22600,396832,384011,3088,13.981,2061,9.331,75261,28501,46760,7.422,19.599,49864,21000,28864,5.469,12.985,25397,6.614,25.97,1196,1224,6029
1979,4235,5774,8306,138723,133722,882,10.767,653,7.972,23604,6018,17586,4.5,17.652,13535,5279,8256,3.948,10.122,10069,7.53,20.244,320,322,1934
1979,4236,12374,17833,223996,217301,2317,13.243,1644,9.396,44381,15022,29359,6.913,20.424,31140,13342,17798,6.14,14.33,13241,6.093,28.661,921,950,4925
1979,4237,10118,13092,150412,145453,1292,10.041,843,6.551,25160,6912,18248,4.752,17.298,15383,5163,10220,3.55,10.576,9777,6.722,21.152,526,543,2778
1979,4238,43535,56698,668022,640519,5733,10.273,3951,7.08,125197,37416,87781,5.842,19.546,70172,26704,43468,4.169,10.955,55025,8.591,21.911,2420,2466,12540
1979,4239,19027,20696,218487,212503,2906,14.259,2274,11.158,48003,14185,33818,6.675,22.589,36268,12121,24147,5.704,17.067,11735,5.522,34.134,1655,1659,7762
1979,4241,6374,8825,126374,124265,893,10.226,708,8.108,19923,5269,14654,4.24,16.033,15602,7433,8169,5.982,12.555,4321,3.477,25.111,353,365,1773
1979,4242,2489,3212,90039,88181,405,12.716,351,11.02,13826,4260,9566,4.831,15.679,9829,4047,5782,4.589,11.146,3997,4.533,22.293,218,221,1685
1979,4243,9951,10945,116522,114463,1580,14.677,1220,11.333,27125,9636,17489,8.418,23.698,22808,7171,15637,6.265,19.926,4317,3.772,39.852,868,877,4034
1979,4244,26293,32189,543980,539099,3332,10.368,3228,10.044,93443,29178,64265,5.412,17.333,83519,33382,50137,6.192,15.492,9924,1.841,30.985,2240,2268,14735
1979,4245,8929,12101,111982,111558,785,6.482,803,6.631,19054,5271,13783,4.725,17.08,18120,5070,13050,4.545,16.243,934,0.837,32.485,482,496,3129
1979,4246,5466,8175,101304,97754,1021,12.763,670,8.376,20838,6376,14462,6.522,21.317,13798,5556,8242,5.684,14.115,7040,7.202,28.23,351,363,1968
1979,4247,12118,16072,153211,153599,1176,7.236,1535,9.445,29006,7925,21081,5.16,18.884,29636,11101,18535,7.227,19.294,-630,-0.41,37.769,803,824,3513
1979,4248,4822,5941,125322,123571,342,5.695,470,7.827,17139,3481,13658,2.817,13.87,13655,5219,8436,4.223,11.05,3484,2.819,22.101,331,339,2982
1979,4249,18254,22272,240083,235880,2534,11.434,2315,10.446,43794,12459,31335,5.282,18.566,35205,14301,20904,6.063,14.925,8589,3.641,29.85,1544,1564,7013
1979,4251,25628,28322,288584,279980,3268,11.75,2251,8.093,54805,16880,37925,6.029,19.575,37523,13020,24503,4.65,13.402,17282,6.173,26.804,1438,1443,7332
1979,4411,41327,42432,921621,900699,3939,9.3,3786,8.939,127594,35971,91623,3.994,14.166,85790,31665,54125,3.516,9.525,41804,4.641,19.05,3093,3113,24661
1979,4412,12612,13035,87409,84736,1539,11.78,1599,12.239,20378,6252,14126,7.378,24.049,15074,6534,8540,7.711,17.789,5304,6.259,35.579,1305,1318,5255
1979,4413,40466,57041,392036,376099,5697,10.144,3933,7.003,77738,26940,50798,7.163,20.67,45797,16181,29616,4.302,12.177,31941,8.493,24.354,2527,2590,10035
1979,4421,24181,27981,225124,220082,3191,11.56,2438,8.832,41504,14542,26962,6.608,18.858,31383,11409,19974,5.184,14.26,10121,4.599,28.519,1842,1881,7931
1979,4422,18671,21137,119627,114864,3550,17.275,2377,11.567,30253,13742,16511,11.964,26.338,20781,8654,12127,7.534,18.092,9472,8.246,36.184,1785,1811,6317
1979,4431,24976,31872,189759,186354,4304,13.574,3974,12.534,41185,17830,23355,9.568,22.1,34311,15695,18616,8.422,18.412,6874,3.689,36.823,2687,2764,9623
1979,4441,54834,68598,656668,635986,6579,9.714,4842,7.149,116385,38628,77757,6.074,18.3,75308,25282,50026,3.975,11.841,41077,6.459,23.682,3374,3408,14757
1979,4442,13727,16569,119406,115733,1689,10.266,1457,8.856,24572,7287,17285,6.296,21.232,17139,5848,11291,5.053,14.809,7433,6.423,29.618,995,1016,3909
1979,4451,65709,104750,1667871,1621199,12101,11.606,11134,10.678,296855,126272,170583,7.789,18.311,202110,88694,113416,5.471,12.467,94745,5.844,24.933,7160,7284,37264
1979,4452,23442,28975,181075,176761,4268,14.671,4500,15.469,47880,21000,26880,11.88,27.087,38812,18463,20349,10.445,21.957,9068,5.13,43.915,3029,3133,12244
1979,4453,28996,34279,179086,175909,3649,10.68,3426,10.027,39001,12151,26850,6.908,22.171,32860,11052,21808,6.283,18.68,6141,3.491,37.36,2604,2628,8062
1979,4461,39677,55409,527492,510304,6136,11.365,3296,6.105,92386,35150,57236,6.888,18.104,56926,18440,38486,3.614,11.155,35460,6.949,22.311,2191,2218,10580
1979,4471,118419,149303,863254,869977,17885,11.772,23132,15.226,197066,80202,116864,9.219,22.652,210401,91411,118990,10.507,24.185,-13335,-1.533,45.304,16039,16267,59497
1979,4481,61145,94343,782403,769510,12645,13.675,8899,9.624,160108,71756,88352,9.325,20.807,134517,42339,92178,5.502,17.481,25591,3.326,34.962,5931,6127,23622
1979,4482,11951,31198,175444,167761,3683,12.069,2317,7.593,40892,16281,24611,9.705,24.375,26097,9200,16897,5.484,15.556,14795,8.819,31.112,998,1045,3972
1979,4483,16815,23443,137659,133351,2985,13.032,1910,8.339,28997,11623,17374,8.716,21.745,20194,7582,12612,5.686,15.144,8803,6.601,30.287,1304,1339,5156
1979,4511,31736,39153,234412,227179,6237,16.195,4953,12.861,56811,23991,32820,10.56,25.007,42436,17630,24806,7.76,18.68,14375,6.328,37.359,3524,3728,11417
1979,4512,7295,9989,64780,62092,1693,17.486,1079,11.144,15873,6993,8880,11.262,25.564,10498,3937,6561,6.341,16.907,5375,8.657,33.815,816,831,2764
1979,4522,542,6444,1139828,1132323,623,9.97,232,3.713,125240,58093,67147,5.13,11.06,106997,14624,92373,1.292,9.449,18243,1.611,18.899,17,25,810
1979,4523,15686,31111,822249,815215,2828,9.036,3197,10.216,105211,46879,58332,5.751,12.906,91297,29514,61783,3.62,11.199,13914,1.707,22.398,1685,1747,7399
1979,4531,19538,20684,100846,99330,3046,15.13,1943,9.651,21446,8286,13160,8.342,21.591,18475,6085,12390,6.126,18.6,2971,2.991,37.199,1467,1484,4571
1979,4532,21504,25251,147985,140986,4571,18.71,2931,11.997,38926,18231,20695,12.931,27.61,24658,10031,14627,7.115,17.49,14268,10.12,34.979,2211,2235,6920
1979,4533,8263,9752,45431,44481,1602,16.871,1089,11.469,10413,4664,5749,10.485,23.41,8535,3271,5264,7.354,19.188,1878,4.222,38.376,866,866,2198
1979,4539,25162,29788,136415,132050,4957,16.92,3974,13.565,37389,15810,21579,11.973,28.314,28699,12628,16071,9.563,21.734,8690,6.581,43.467,2878,2936,8726
1979,4541,5215,6980,98859,94342,1034,15.201,678,9.968,21535,8945,12590,9.482,22.827,12065,4258,7807,4.513,12.789,9470,10.038,25.577,477,479,2224
1979,4542,4434,5589,81652,78124,621,11.177,555,9.989,15613,4628,10985,5.924,19.985,8647,3392,5255,4.342,11.068,6966,8.917,22.137,386,391,1380
1979,4543,17420,22955,198941,194976,2109,9.183,2130,9.275,36198,10716,25482,5.496,18.565,28509,10903,17606,5.592,14.622,7689,3.944,29.244,1534,1562,6910
1979,4811,1018,2387,287922,273998,274,11.76,160,6.867,33723,3743,29980,1.366,12.308,6206,1066,5140,0.389,2.265,27517,10.043,4.53,88,88,453
1979,4812,371,513,6051,5565,110,22.587,58,11.91,1945,778,1167,13.981,34.954,955,346,609,6.218,17.162,990,17.791,34.325,45,45,264
1979,4831,474,722,37618,37471,87,11.975,96,13.214,9681,3761,5920,10.037,25.836,9328,2974,6354,7.937,24.894,353,0.942,49.788,36,36,324
1979,4832,395,468,15154,14615,49,10.526,44,9.452,3397,1261,2136,8.628,23.243,2335,837,1498,5.727,15.977,1062,7.267,31.953,25,25,162
1979,4841,20248,25082,538588,515360,4839,19.76,3653,14.917,108242,32232,76010,6.254,21.003,61625,23204,38421,4.502,11.958,46617,9.046,23.915,2761,2765,12188
1979,4842,41255,44978,596797,575984,7825,17.743,6073,13.77,126955,37824,89131,6.567,22.041,86060,30669,55391,5.325,14.941,40895,7.1,29.883,4695,4703,20814
1979,4851,409,443,20653,19744,44,9.989,39,8.854,2775,631,2144,3.196,14.055,944,244,700,1.236,4.781,1831,9.274,9.563,32,32,195
1979,4852,300,643,30206,29539,26,4.012,36,5.556,2860,330,2530,1.117,9.682,1479,319,1160,1.08,5.007,1381,4.675,10.014,20,20,153
1979,4853,6392,6458,75726,77455,1104,17.198,1027,15.998,15635,5558,10077,7.176,20.186,18925,7116,11809,9.187,24.434,-3290,-4.248,40.372,881,885,6096
1979,4854,3759,3923,92425,89801,354,8.96,410,10.377,16783,4319,12464,4.81,18.689,11827,3511,8316,3.91,13.17,4956,5.519,26.341,354,354,3038
1979,4855,433,459,7901,7434,63,14.253,29,6.561,1743,389,1354,5.233,23.448,813,249,564,3.35,10.937,930,12.511,21.874,20,20,116
1979,4859,846,898,19012,18576,152,17.195,124,14.027,3472,1225,2247,6.595,18.691,2595,1210,1385,6.514,13.97,877,4.721,27.94,100,100,726
1979,4861,87,297,11108,11603,13,4.377,13,4.377,1092,134,958,1.155,9.412,2119,480,1639,4.137,18.263,-1027,-8.852,18.824,(D),(D),(D)
1979,4862,225,1014,54035,52414,104,10.667,26,2.667,5579,3181,2398,6.069,10.644,2518,395,2123,0.754,4.804,3061,5.84,9.608,12,12,199
1979,4869,61,262,7292,7039,21,8.108,15,5.792,1102,214,888,3.04,15.656,603,265,338,3.765,8.567,499,7.089,17.133,3,3,15
1979,4871,145,149,1964,1882,23,15.917,14,9.689,419,173,246,9.195,22.269,237,89,148,4.73,12.596,182,9.673,25.193,13,13,48
1979,4872,660,673,8192,8049,139,21.173,106,16.146,2063,766,1297,9.517,25.631,1734,644,1090,8.001,21.543,329,4.087,43.086,81,81,382
1979,4879,35,43,1182,1166,11,27.5,5,12.5,113,33,80,2.83,9.691,73,20,53,1.715,6.261,40,3.431,12.521,5,5,20
1979,4881,2050,2508,50754,48152,411,16.934,249,10.26,12431,5101,7330,10.594,25.816,7152,2618,4534,5.437,14.853,5279,10.963,29.706,182,182,829
1979,4882,300,381,15233,16544,65,17.906,29,7.989,3609,1094,2515,6.613,21.815,6205,455,5750,2.75,37.506,-2596,-15.691,43.629,19,19,207
1979,4883,2045,2467,129328,126383,345,14.198,271,11.152,35068,9052,26016,7.162,27.748,28237,5722,22515,4.528,22.342,6831,5.405,44.685,163,163,1293
1979,4884,1887,2471,42099,41806,447,18.437,354,14.601,7009,2562,4447,6.128,16.766,6493,2276,4217,5.444,15.531,516,1.234,31.063,244,244,1219
1979,4885,3759,5429,75400,73350,848,16.128,506,9.623,14909,4405,10504,6.005,20.326,10846,3717,7129,5.068,14.787,4063,5.539,29.573,300,315,2502
1979,4889,342,354,5831,5920,56,16.374,32,9.357,1504,661,843,11.166,25.405,1614,163,1451,2.753,27.264,-110,-1.858,50.811,25,25,120
1979,4921,1010,1458,68657,65347,354,25.295,237,16.935,11990,3822,8168,5.849,18.348,5384,2894,2490,4.429,8.239,6606,10.109,16.478,190,190,879
1979,4922,770,771,4848,4915,307,39.562,317,40.851,1719,932,787,18.962,34.975,1836,1094,742,22.258,37.355,-117,-2.38,69.949,281,281,996
1979,4931,6137,9377,397233,387659,898,9.744,576,6.25,71457,24217,47240,6.247,18.433,52064,11331,40733,2.923,13.43,19393,5.003,26.861,217,217,1675
1979,5111,12843,14393,590587,578646,1771,12.422,1500,10.521,68720,18236,50484,3.151,11.876,44748,14279,30469,2.468,7.733,23972,4.143,15.466,1114,1115,8875
1979,5112,3281,4070,69792,63212,1299,35.844,407,11.231,24257,11312,12945,17.895,38.374,11045,5047,5998,7.984,17.473,13212,20.901,34.946,236,239,1540
1979,5121,8404,13793,194742,189087,1951,14.247,1754,12.808,55743,16614,39129,8.786,29.48,43750,14715,29035,7.782,23.138,11993,6.343,46.275,881,900,5990
1979,5122,1181,1186,8788,8336,350,32.452,135,12.517,3002,1822,1180,21.857,36.012,2027,654,1373,7.845,24.316,975,11.696,48.632,104,104,374
1979,5151,5361,6285,179109,175330,621,10.038,424,6.854,26694,9750,16944,5.561,15.225,19131,6082,13049,3.469,10.911,7563,4.314,21.823,301,302,3696
1979,5152,6,6,23,21,3,66.667,0,0,7,5,2,24.39,34.146,0,0,0,0,0,7,34.146,0,0,0,0
1979,5173,2006,13771,955046,937970,389,2.764,990,7.035,174032,4198,169834,0.448,18.554,140050,24013,116037,2.56,14.931,33982,3.623,29.862,171,171,1037
1979,5174,521,875,23160,23177,135,16.197,52,6.239,4499,1465,3034,6.321,19.411,4615,1267,3348,5.467,19.912,-116,-0.5,38.823,23,23,171
1979,5179,923,1910,50992,52160,215,11.442,153,8.143,10813,1512,9301,2.899,20.73,13316,2071,11245,3.97,25.529,-2503,-4.799,41.461,81,81,302
1979,5182,4831,6286,180358,172637,1053,17.15,761,12.394,41846,16441,25405,9.523,24.239,26671,13639,13032,7.9,15.449,15175,8.79,30.898,376,378,2827
1979,5191,2057,2443,27525,27299,254,10.641,142,5.949,4060,1179,2881,4.319,14.873,3760,750,3010,2.747,13.774,300,1.099,27.547,100,100,601
1979,5211,20,52,23542,23508,0,0,0,0,651,0,651,0,2.769,630,0,630,0,2.68,21,0.089,5.36,0,0,0
1979,5221,21117,60238,1651890,1605679,3497,5.933,905,1.535,181697,48761,132936,3.037,11.316,89651,13551,76100,0.844,5.583,92046,5.733,11.167,458,459,4933
1979,5222,23801,44354,344687,333818,3751,8.565,2634,6.014,61181,21685,39496,6.496,18.328,39165,14390,24775,4.311,11.732,22016,6.595,23.465,1172,1184,5145
1979,5223,2622,2886,28802,27247,627,22.652,391,14.126,7178,2732,4446,10.027,26.345,4060,2197,1863,8.063,14.901,3118,11.444,29.802,296,298,1351
1979,5231,4177,7889,169742,161849,1339,17.686,703,9.285,35388,11094,24294,6.855,21.865,19674,9478,10196,5.856,12.156,15714,9.709,24.312,413,413,2187
1979,5232,92,104,4490,4204,13,12.808,8,7.882,625,59,566,1.404,14.869,56,35,21,0.833,1.332,569,13.536,2.664,6,6,32
1979,5239,9081,9395,79001,74947,1821,19.959,1278,14.008,22998,9203,13795,12.279,30.686,14991,5950,9041,7.939,20.002,8007,10.684,40.004,965,965,3068
1979,5241,6284,29699,1200218,1173831,4332,15.274,1657,5.842,164409,57870,106539,4.93,14.006,113671,26676,86995,2.273,9.684,50738,4.322,19.368,341,361,4803
1979,5242,86050,90244,938697,867899,11050,12.514,7162,8.111,249838,42582,207256,4.906,28.787,106747,29716,77031,3.424,12.299,143091,16.487,24.599,5237,5248,15688
1979,5259,593,798,6937,6918,69,8.636,71,8.886,1520,277,1243,4.004,21.972,1413,429,984,6.201,20.425,107,1.547,40.85,28,28,75
1979,5311,107926,109712,516461,505664,16041,14.751,14103,12.969,126751,57093,69658,11.291,25.066,105008,50397,54611,9.967,20.766,21743,4.3,41.533,11528,11549,36473
1979,5312,32451,33504,178228,172423,6678,20.779,3945,12.275,49115,19832,29283,11.502,28.485,37423,13563,23860,7.866,21.704,11692,6.781,43.408,3095,3095,9455
1979,5313,20165,20707,177553,167293,4147,20.827,2557,12.842,49686,17889,31797,10.693,29.7,29109,11457,17652,6.848,17.4,20577,12.3,34.8,1983,1985,8226
1979,5321,5585,9206,100034,88670,2129,24.756,917,10.663,34577,13001,21576,14.662,38.995,12420,5864,6556,6.613,14.007,22157,24.988,28.014,563,571,2923
1979,5322,7614,8877,78679,74031,1728,20.123,1148,13.369,22537,7764,14773,10.488,30.443,13199,6071,7128,8.201,17.829,9338,12.614,35.658,799,800,3769
1979,5323,1912,2070,16208,14809,390,19.893,171,8.722,5123,1688,3435,11.399,34.595,2416,777,1639,5.247,16.315,2707,18.28,32.63,120,120,534
1979,5324,3509,3890,42570,40784,686,18.386,368,9.863,12298,3922,8376,9.617,30.154,8874,2606,6268,6.39,21.759,3424,8.396,43.518,268,269,1255
1979,5331,863,922,10026,10800,143,15.148,187,19.809,2644,921,1723,8.528,24.483,4346,3142,1204,29.094,40.243,-1702,-15.76,48.965,93,95,341
1979,5411,100320,103110,518158,497097,13799,13.691,9158,9.086,106692,39796,66896,8.006,21.463,64438,26597,37841,5.35,12.963,42254,8.5,25.926,6644,6684,19325
1979,5412,41967,44753,321365,301119,8033,18.704,4423,10.299,77924,36126,41798,11.997,25.878,37605,19061,18544,6.33,12.488,40319,13.39,24.977,3163,3244,13496
1979,5413,38920,42461,555865,521084,7398,18.167,3920,9.626,135482,45655,89827,8.762,26,66074,22511,43563,4.32,12.68,69408,13.32,25.36,2771,2791,13016
1979,5414,9776,9985,72571,67806,2313,24.533,1199,12.717,21035,9067,11968,13.372,31.023,11787,4457,7330,6.573,17.384,9248,13.639,34.767,927,931,3165
1979,5415,2560,3066,29382,25944,1610,62.258,650,25.135,12846,7226,5620,27.853,49.515,5851,3726,2125,14.362,22.553,6995,26.962,45.106,547,547,2203
1979,5416,14905,15486,155685,148951,3839,25.796,2631,17.679,46059,17140,28919,11.507,30.922,32518,14930,17588,10.023,21.831,13541,9.091,43.663,2040,2048,9797
1979,5417,4423,5483,363073,358579,705,12.909,662,12.121,44149,9506,34643,2.651,12.312,34435,11737,22698,3.273,9.603,9714,2.709,19.206,401,407,2794
1979,5418,17654,19368,236582,228059,3215,17.053,2186,11.595,52740,17029,35711,7.467,23.126,35552,13560,21992,5.946,15.589,17188,7.537,31.178,1631,1641,8655
1979,5419,21978,23573,180727,173225,3499,15.315,2048,8.964,38255,15044,23211,8.685,22.084,23007,8649,14358,4.993,13.282,15248,8.802,26.563,1529,1547,6113
1979,5511,20050,37783,2578026,2506857,4334,11.702,2841,7.671,463198,144551,318647,5.766,18.477,319000,77808,241192,3.104,12.725,144198,5.752,25.45,421,426,4282
1979,5611,4842,5051,63336,62030,754,14.672,930,18.097,16402,5080,11322,8.19,26.442,13923,6816,7107,10.988,22.446,2479,3.996,44.891,708,710,4299
1979,5612,227,276,14519,14730,47,16.235,74,25.561,3418,934,2484,6.341,23.205,3868,2401,1467,16.301,26.26,-450,-3.055,46.41,40,42,545
1979,5613,8834,11639,537526,498040,2489,22.558,1279,11.591,182735,55131,127604,11.07,36.691,102161,22186,79975,4.455,20.513,80574,16.178,41.025,856,869,10545
1979,5614,15425,17403,187535,178794,3108,18.555,1803,10.764,44336,16246,28090,9.086,24.797,26782,9686,17096,5.417,14.979,17554,9.818,29.958,1368,1378,5429
1979,5615,14337,16801,129767,120851,2860,17.866,1274,7.959,32986,13430,19556,11.113,27.295,15164,6480,8684,5.362,12.548,17822,14.747,25.095,841,862,3562
1979,5616,9128,11037,334794,318839,2453,23.502,1254,12.014,86388,29389,56999,9.218,27.095,55460,18174,37286,5.7,17.394,30928,9.7,34.789,916,919,10189
1979,5617,46609,49061,634819,610212,11821,25.104,7877,16.728,180578,63880,116698,10.468,29.593,131504,49766,81738,8.156,21.551,49074,8.042,43.101,6220,6240,33743
1979,5619,9669,10346,138526,126703,2547,26.523,1061,11.049,43885,15459,28426,12.201,34.636,20419,6702,13717,5.29,16.116,23466,18.521,32.231,810,813,4478
1979,5621,4681,4818,97535,92247,735,15.515,574,12.116,19412,4474,14938,4.85,21.044,8961,3539,5422,3.836,9.714,10451,11.329,19.428,476,476,2650
1979,5622,1798,2155,35416,34361,293,13.989,172,8.212,6872,2405,4467,6.999,19.999,4717,1502,3215,4.371,13.728,2155,6.272,27.456,117,118,633
1979,5629,4278,4485,42833,40524,667,15.123,518,11.745,11614,3092,8522,7.63,28.66,6926,2731,4195,6.739,17.091,4688,11.568,34.182,404,404,1901
1979,6111,12676,13028,330859,322888,618,4.707,821,6.253,42474,7454,35020,2.309,13.154,26688,8175,18513,2.532,8.265,15786,4.889,16.531,598,606,5138
1979,6112,455,529,30594,30250,42,8.14,16,3.101,3901,710,3191,2.347,12.896,3210,176,3034,0.582,10.612,691,2.284,21.223,12,12,136
1979,6113,1933,2172,777873,741789,119,5.503,100,4.624,112120,4871,107249,0.657,15.115,38992,2347,36645,0.316,5.256,73128,9.858,10.513,62,62,1287
1979,6114,1605,1777,23990,23493,321,18.55,228,13.175,5343,1531,3812,6.517,22.743,4300,1741,2559,7.411,18.304,1043,4.44,36.607,164,165,890
1979,6115,3478,3904,41993,39806,610,15.981,436,11.423,10869,3757,7112,9.438,27.305,6517,2594,3923,6.517,16.372,4352,10.933,32.744,313,323,1800
1979,6116,9404,9864,87985,84760,2160,22.686,1475,15.491,24904,9968,14936,11.76,29.382,18391,7577,10814,8.939,21.698,6513,7.684,43.396,1170,1181,5432
1979,6117,763,777,18261,18047,151,19.61,137,17.792,2479,804,1675,4.455,13.736,2088,463,1625,2.566,11.57,391,2.167,23.14,107,107,333
1979,6211,145968,150090,826622,795704,15301,10.43,8530,5.814,151687,56025,95662,7.041,19.063,90411,29054,61357,3.651,11.362,61276,7.701,22.725,6449,6474,21700
1979,6212,83723,84967,346872,332864,6508,7.795,3560,4.264,65398,19895,45503,5.977,19.647,37481,11463,26018,3.444,11.26,27917,8.387,22.52,2708,2717,8798
1979,6213,28954,29917,90718,85490,4557,15.861,2185,7.605,24105,10800,13305,12.633,28.196,13375,6209,7166,7.263,15.645,10730,12.551,31.29,1605,1616,4818
1979,6214,4021,4998,73772,70271,808,16.743,464,9.615,16943,5734,11209,8.16,24.111,9863,3708,6155,5.277,14.036,7080,10.075,28.072,273,277,2031
1979,6215,3619,4559,57834,56250,643,14.319,506,11.268,13340,5672,7668,10.084,23.716,10141,4042,6099,7.186,18.029,3199,5.687,36.057,310,318,1905
1979,6216,2138,2719,79236,74489,527,20.498,231,8.985,21947,7413,14534,9.952,29.463,12477,3461,9016,4.646,16.75,9470,12.713,33.5,142,143,1676
1979,6219,2246,2534,47608,45938,487,20.266,225,9.363,11855,4292,7563,9.343,25.807,8640,2720,5920,5.921,18.808,3215,6.999,37.616,156,157,1058
1979,6221,4128,5000,2432904,2377793,154,3.066,201,4.001,196043,25768,170275,1.084,8.245,86288,36684,49604,1.543,3.629,109755,4.616,7.258,125,128,21624
1979,6222,319,382,43677,41668,38,10.16,22,5.882,6387,1138,5249,2.731,15.328,2316,1075,1241,2.58,5.558,4071,9.77,11.116,12,12,528
1979,6223,166,195,39862,38817,16,8.399,7,3.675,3337,440,2897,1.134,8.597,1260,287,973,0.739,3.246,2077,5.351,6.492,5,5,188
1979,6231,8366,11027,827145,808778,756,6.865,728,6.61,120003,41287,78716,5.105,14.838,83024,34156,48868,4.223,10.265,36979,4.572,20.531,505,546,23295
1979,6232,2913,3571,78683,74844,591,17.472,214,6.327,15698,6206,9492,8.292,20.974,8128,2886,5242,3.856,10.86,7570,10.114,21.72,162,163,2164
1979,6233,6177,6957,200690,196566,908,13.345,602,8.848,33179,11784,21395,5.995,16.879,24807,13694,11113,6.967,12.62,8372,4.259,25.24,427,443,11076
1979,6239,2341,2765,69204,67280,339,12.697,149,5.581,10138,2763,7375,4.107,15.068,6194,2235,3959,3.322,9.206,3944,5.862,18.413,97,97,1070
1979,6241,10384,14252,226814,217346,1908,13.927,804,5.869,50771,14173,36598,6.521,23.36,31843,6034,25809,2.776,14.651,18928,8.709,29.302,505,511,2883
1979,6242,2988,3524,37278,36283,466,13.779,182,5.381,7527,2853,4674,7.863,20.745,5523,1054,4469,2.905,15.222,2004,5.523,30.444,105,105,502
1979,6243,3090,4526,216138,206956,713,16.387,363,8.343,49466,20490,28976,9.901,23.902,31595,6154,25441,2.974,15.267,17871,8.635,30.533,180,181,2223
1979,6244,23308,27062,233588,222005,4164,15.942,2278,8.722,56433,21085,35348,9.498,25.42,33320,11757,21563,5.296,15.009,23113,10.411,30.017,1689,1712,8172
1979,7111,4864,4901,58072,57197,971,20.095,833,17.239,18767,6686,12081,11.689,32.811,17283,6154,11129,10.759,30.217,1484,2.595,60.433,621,622,3856
1979,7112,2074,2168,55437,55507,400,18.523,383,17.736,13618,3583,10035,6.455,24.534,13659,2716,10943,4.893,24.608,-41,-0.074,49.068,283,283,2235
1979,7113,2067,2104,44132,35084,420,20.183,374,17.972,26611,2664,23947,7.593,75.85,7773,3169,4604,9.033,22.156,18838,53.695,44.311,263,263,2128
1979,7114,896,911,9641,9703,215,24.713,133,15.287,3108,1410,1698,14.532,32.033,3223,1745,1478,17.985,33.218,-115,-1.185,64.066,105,105,1492
1979,7115,3723,3753,23258,20586,1494,46.068,474,14.616,10172,5195,4977,25.236,49.412,4917,1841,3076,8.943,23.885,5255,25.527,47.77,306,307,966
1979,7121,1716,1804,30270,29488,126,7.004,116,6.448,4513,615,3898,2.086,15.305,3067,443,2624,1.502,10.401,1446,4.904,20.802,61,61,263
1979,7131,1414,1503,50194,50023,217,14.309,244,16.09,7197,2331,4866,4.66,14.387,7010,1413,5597,2.825,14.014,187,0.374,28.027,205,208,1017
1979,7132,561,572,18828,18169,75,13.043,81,14.087,3902,567,3335,3.121,21.477,2643,1372,1271,7.552,14.547,1259,6.93,29.094,64,64,1249
1979,7139,28547,30063,425094,413762,3903,13.181,2998,10.125,86470,29386,57084,7.102,20.899,63858,20278,43580,4.901,15.434,22612,5.465,30.867,2248,2263,14821
1979,7211,29717,33455,997509,974874,4746,14.266,4370,13.136,213121,86567,126554,8.88,21.861,168547,72513,96034,7.438,17.289,44574,4.572,34.578,3194,3236,45564
1979,7212,3374,3585,18352,18142,522,14.605,500,13.99,5083,1715,3368,9.453,28.019,4654,1889,2765,10.413,25.654,429,2.365,51.308,325,326,1063
1979,7213,5746,5818,35061,35123,410,6.956,562,9.535,5366,1399,3967,3.983,15.278,5483,2264,3219,6.446,15.611,-117,-0.333,30.555,435,435,1888
1979,7223,15891,24651,469675,455592,3990,16.369,3440,14.112,120022,55395,64627,12.159,26.344,93474,38478,54996,8.446,20.517,26548,5.827,41.034,2060,2084,17033
1979,7224,66402,67141,358537,356410,10142,15.016,10942,16.201,101535,48816,52719,13.697,28.488,97519,44826,52693,12.577,27.362,4016,1.127,54.723,8447,8469,34477
1979,7225,173781,217742,3671774,3561943,39024,18.281,30470,14.274,949992,519279,430713,14.579,26.671,732588,297934,434654,8.364,20.567,217404,6.104,41.134,21849,22226,193839
1979,8111,86818,90110,445758,427193,16286,18.585,11328,12.927,120335,53330,67005,12.484,28.169,82867,37970,44897,8.888,19.398,37468,8.771,38.796,8730,8783,28967
1979,8112,10361,11388,63665,62794,1490,13.04,1566,13.706,12361,4547,7814,7.241,19.685,10625,4260,6365,6.784,16.921,1736,2.765,33.841,1222,1223,3106
1979,8113,16188,17194,136370,130317,2626,15.624,1854,11.03,31985,10123,21862,7.768,24.544,19891,7719,12172,5.923,15.264,12094,9.28,30.527,1414,1418,5400
1979,8114,22288,23878,147851,142729,3860,16.375,3249,13.783,33967,14075,19892,9.861,23.798,23670,9993,13677,7.001,16.584,10297,7.214,33.168,2509,2521,7382
1979,8121,83535,91087,416993,410328,13343,14.792,11579,12.836,97762,46940,50822,11.44,23.825,85211,36224,48987,8.828,20.767,12551,3.059,41.533,9042,9120,27186
1979,8122,17565,19880,110165,109233,1537,7.804,1166,5.92,16731,4926,11805,4.51,15.317,14843,3804,11039,3.482,13.588,1888,1.728,27.177,776,794,2603
1979,8123,33887,39351,343723,341260,4067,10.288,4427,11.199,54319,18176,36143,5.326,15.917,49313,19932,29381,5.841,14.45,5006,1.467,28.901,3405,3492,14816
1979,8129,11966,17778,176858,169083,3591,20.997,2240,13.098,42769,19613,23156,11.6,25.295,27637,10638,16999,6.292,16.345,15132,8.949,32.691,1266,1310,5153
1979,8131,69213,69294,639606,615917,3867,5.65,2158,3.153,104677,15549,89128,2.525,16.995,57036,8717,48319,1.415,9.26,47641,7.735,18.521,1047,1047,3503
1979,8132,6733,7504,114574,110355,789,10.691,541,7.331,26796,8396,18400,7.608,24.282,18189,4504,13685,4.081,16.482,8607,7.799,32.965,365,369,2701
1979,8133,6281,7235,97145,96588,979,13.836,661,9.341,21046,5768,15278,5.972,21.79,19962,5221,14741,5.405,20.667,1084,1.122,41.335,398,400,3200
1979,8134,27802,29007,233305,230237,2777,9.792,1482,5.226,37270,7526,29744,3.269,16.188,31407,5508,25899,2.392,13.641,5863,2.547,27.282,1020,1021,3543
1979,8139,53834,55840,413845,410004,4868,8.823,3533,6.404,82359,18971,63388,4.627,20.087,74495,14216,60279,3.467,18.169,7864,1.918,36.339,2440,2446,9264
1980,1131,199,207,4316,4214,31,14.904,33,15.865,871,101,770,2.397,20.672,625,96,529,2.278,14.833,246,5.838,29.667,25,25,80
1980,1132,90,106,1364,1416,14,13.27,13,12.322,431,90,341,6.358,30.449,522,129,393,9.113,36.877,-91,-6.429,60.897,7,7,106
1980,1133,11474,11597,98912,100379,1881,16.084,2076,17.752,21001,7595,13406,7.566,20.922,24088,8282,15806,8.251,23.997,-3087,-3.075,41.843,1594,1594,6127
1980,1141,1497,1528,11115,11141,305,19.974,303,19.843,3637,1387,2250,12.45,32.647,3700,1238,2462,11.113,33.212,-63,-0.566,65.293,214,214,766
1980,1142,150,151,625,599,33,23.077,17,11.888,212,94,118,15.693,35.392,157,62,95,10.351,26.21,55,9.182,52.421,15,15,60
1980,1151,4232,4607,54168,52657,606,13.246,542,11.847,15052,4819,10233,9.152,28.585,12079,3171,8908,6.022,22.939,2973,5.646,45.878,401,401,2114
1980,1152,1591,1613,9967,9976,245,14.944,298,18.176,2036,720,1316,7.218,20.41,2034,956,1078,9.583,20.39,2,0.02,40.78,242,242,735
1980,1153,719,734,9110,9277,161,22.644,115,16.174,2675,1221,1454,13.162,28.835,3039,1047,1992,11.286,32.758,-364,-3.924,57.67,92,92,903
1980,2111,6054,7849,137421,132765,1101,14.443,649,8.514,27196,8512,18684,6.411,20.484,17802,4908,12894,3.697,13.409,9394,7.076,26.817,373,378,1585
1980,2121,2919,3688,231836,239393,615,16.283,793,20.995,34780,14049,20731,5.869,14.528,50051,14500,35551,6.057,20.908,-15271,-6.379,29.057,610,616,8201
1980,2122,529,709,85058,82484,169,25.056,100,14.826,11580,3330,8250,4.037,14.039,6300,2326,3974,2.82,7.638,5280,6.401,15.276,50,51,261
1980,2123,3698,5161,115669,116827,443,8.569,461,8.917,15857,4348,11509,3.722,13.573,18423,4071,14352,3.485,15.769,-2566,-2.196,27.146,263,281,2282
1980,2131,8338,9630,284347,266543,2012,22.001,1042,11.394,82424,25879,56545,9.709,30.923,46848,18231,28617,6.84,17.576,35576,13.347,35.152,720,731,9899
1980,2211,1539,5624,529789,522751,188,3.369,101,1.81,29030,5964,23066,1.141,5.553,14880,3696,11184,0.707,2.846,14150,2.707,5.693,30,30,264
1980,2212,524,2298,133690,132808,97,4.227,91,3.965,8593,2532,6061,1.907,6.47,6924,1531,5393,1.153,5.214,1669,1.257,10.427,36,39,239
1980,2213,3977,4283,34920,34919,300,7.012,291,6.801,4921,2077,2844,5.948,14.093,4933,2407,2526,6.893,14.127,-12,-0.034,28.186,212,212,749
1980,2361,103915,104242,589224,614297,21729,20.418,26085,24.511,188679,86535,102144,14.087,30.715,238917,97635,141282,15.894,38.893,-50238,-8.178,61.429,20248,20251,75146
1980,2362,34062,34598,662029,668619,4937,14.123,5655,16.177,152504,30032,122472,4.492,22.809,165288,35475,129813,5.306,24.721,-12784,-1.912,45.618,4308,4309,25475
1980,2371,13895,14259,394366,398591,1594,11.156,1652,11.562,75154,14570,60584,3.655,18.855,84016,14785,69231,3.709,21.078,-8862,-2.223,37.71,1187,1189,8374
1980,2372,7739,7887,69143,68238,2189,28.926,1550,20.482,23375,11317,12058,16.585,34.255,21717,8154,13563,11.949,31.825,1658,2.43,63.651,1162,1162,5503
1980,2373,10928,11204,238514,241347,1004,8.885,1196,10.584,49102,8839,40263,3.662,20.345,54834,10554,44280,4.373,22.72,-5732,-2.375,40.69,850,854,6816
1980,2379,4488,4529,83319,82486,814,18.049,776,17.206,23239,4191,19048,5.081,28.173,21726,5236,16490,6.348,26.339,1513,1.834,52.678,565,565,2475
1980,2381,66397,66795,568720,580784,9790,14.405,12121,17.835,151281,45220,106061,7.786,26.048,175774,51195,124579,8.815,30.265,-24493,-4.217,52.095,9216,9217,39451
1980,2382,96515,98193,1009862,1005682,12353,12.63,11581,11.841,214541,53625,160916,5.332,21.333,205473,53392,152081,5.309,20.431,9068,0.902,40.862,9059,9064,38581
1980,2383,69506,69899,531306,542729,11367,15.988,13764,19.359,141259,45172,96087,8.323,26.028,164272,52858,111414,9.739,30.268,-23013,-4.24,52.055,10709,10709,40630
1980,2389,33373,33508,276523,277266,5565,16.704,5181,15.551,76149,24009,52140,8.659,27.464,77759,21097,56662,7.609,28.045,-1610,-0.581,54.928,3918,3919,16130
1980,3111,1427,2098,60720,61258,114,5.384,153,7.226,7165,2179,4986,3.557,11.697,8397,2682,5715,4.378,13.708,-1232,-2.011,23.393,88,90,1127
1980,3112,519,881,80390,81003,47,5.335,47,5.335,5340,1680,3660,2.074,6.592,6551,1251,5300,1.544,8.087,-1211,-1.495,13.185,24,24,313
1980,3113,1178,1569,94252,93612,157,10.064,139,8.91,10228,2151,8077,2.298,10.926,8731,1435,7296,1.533,9.327,1497,1.599,18.654,79,81,416
1980,3114,1261,1786,190965,193687,108,5.998,137,7.609,20311,5394,14917,2.785,10.487,25870,5873,19997,3.032,13.357,-5559,-2.87,20.973,78,78,1154
1980,3115,1981,2781,147154,150279,113,3.969,245,8.606,11086,1795,9291,1.194,7.377,17304,4870,12434,3.241,11.515,-6218,-4.138,14.754,164,164,2151
1980,3116,4421,5046,335487,333288,381,7.505,442,8.707,38110,8604,29506,2.582,11.435,33477,12948,20529,3.885,10.044,4633,1.39,20.089,312,315,4867
1980,3117,733,856,47049,48280,64,7.378,87,10.029,5924,1422,4502,2.945,12.27,8353,1943,6410,4.024,17.301,-2429,-5.031,24.54,60,61,733
1980,3118,8052,9683,306780,311096,1175,12.203,1066,11.071,32816,10714,22102,3.444,10.549,41355,15664,25691,5.035,13.293,-8539,-2.745,21.097,758,767,8269
1980,3119,1963,2344,115644,115265,186,7.957,173,7.401,14380,3759,10621,3.261,12.476,13373,3707,9666,3.216,11.602,1007,0.874,23.204,115,116,1459
1980,3121,2195,2788,187647,188910,164,5.828,216,7.676,15993,4117,11876,2.179,8.466,18383,5403,12980,2.86,9.731,-2390,-1.265,16.932,136,136,2180
1980,3122,132,193,45405,46701,14,7.235,15,7.752,2414,467,1947,1,5.169,4916,307,4609,0.657,10.527,-2502,-5.357,10.338,7,7,24
1980,3131,471,730,124762,126361,61,8.391,55,7.565,9273,2884,6389,2.282,7.338,12411,4293,8118,3.397,9.822,-3138,-2.483,14.677,30,30,1566
1980,3132,1796,2239,365945,367544,171,7.627,177,7.895,24751,5349,19402,1.455,6.734,27992,7386,20606,2.01,7.616,-3241,-0.882,13.468,125,125,1804
1980,3133,1585,1814,130120,132131,144,7.906,159,8.729,11982,2990,8992,2.263,9.068,15850,6022,9828,4.558,11.996,-3868,-2.927,18.137,99,100,1610
1980,3141,4380,4675,132193,135523,528,11.185,619,13.113,13709,3005,10704,2.217,10.116,20466,6027,14439,4.447,15.101,-6757,-4.986,20.231,502,508,3140
1980,3149,3434,3583,141401,144988,386,10.659,463,12.785,19099,6208,12891,4.282,13.173,26449,10662,15787,7.354,18.242,-7350,-5.069,26.346,364,364,6987
1980,3151,1427,1563,140371,139575,142,9.111,133,8.534,15967,3490,12477,2.5,11.44,14530,4587,9943,3.286,10.41,1437,1.03,20.82,103,104,2441
1980,3152,13089,14879,957056,970987,1778,11.861,2000,13.342,126815,43270,83545,4.456,13.06,154585,53063,101522,5.465,15.92,-27770,-2.86,26.121,1594,1603,32949
1980,3159,1678,1809,80251,80530,198,10.909,210,11.57,10389,2078,8311,2.58,12.901,10909,3083,7826,3.828,13.547,-520,-0.646,25.802,165,165,2019
1980,3161,380,425,21072,21997,29,6.76,37,8.625,2002,566,1436,2.573,9.101,3866,959,2907,4.36,17.576,-1864,-8.474,18.203,30,30,608
1980,3162,504,752,142688,147032,47,6.128,77,10.039,13129,2378,10751,1.617,8.929,21735,9228,12507,6.276,14.782,-8606,-5.853,17.859,45,46,3051
1980,3169,1370,1424,66972,67963,140,9.831,140,9.831,8463,2422,6041,3.564,12.452,10271,2741,7530,4.033,15.113,-1808,-2.66,24.905,107,108,1815
1980,3211,5660,6236,165945,168771,719,11.501,750,11.997,21556,6622,14934,3.924,12.772,26925,7790,19135,4.616,15.954,-5369,-3.181,25.545,572,572,4965
1980,3212,1067,1348,90577,95034,143,10.724,114,8.549,7715,2911,4804,3.063,8.118,16580,4212,12368,4.432,17.446,-8865,-9.328,16.236,76,76,1423
1980,3219,8438,9216,291529,304187,1088,11.882,970,10.593,33104,10310,22794,3.389,10.883,58520,16795,41725,5.521,19.238,-25416,-8.355,21.766,712,713,8193
1980,3221,365,758,221527,219239,33,4.348,35,4.611,13567,1417,12150,0.646,6.188,9287,1028,8259,0.469,4.236,4280,1.952,8.472,24,24,192
1980,3222,3463,5041,411766,411648,295,5.832,330,6.524,35619,7806,27813,1.896,8.653,35348,8498,26850,2.064,8.587,271,0.066,17.174,207,208,3481
1980,3231,30815,32205,644627,639940,3707,11.708,2623,8.284,78711,21959,56752,3.431,12.3,69528,21618,47910,3.378,10.865,9183,1.435,21.73,2043,2049,14039
1980,3241,1491,2389,555833,567203,204,8.534,207,8.659,23612,3098,20514,0.546,4.163,45832,9019,36813,1.59,8.08,-22220,-3.917,8.326,72,91,1758
1980,3251,1020,2098,279009,274421,150,7.222,108,5.2,25088,8994,16094,3.277,9.142,15564,3469,12095,1.264,5.672,9524,3.471,11.343,47,47,540
1980,3252,386,627,161083,163030,57,9.179,45,7.246,7705,1390,6315,0.853,4.726,11434,2521,8913,1.546,7.013,-3729,-2.287,9.452,31,31,340
1980,3253,766,1148,56310,55706,88,7.686,82,7.162,6861,1486,5375,2.668,12.316,5603,2043,3560,3.667,10.058,1258,2.258,20.116,45,45,570
1980,3254,893,1122,159554,158987,123,11.101,95,8.574,13070,2895,10175,1.821,8.221,12008,2096,9912,1.318,7.553,1062,0.668,15.106,53,54,754
1980,3255,1681,2142,80626,81462,136,6.385,112,5.258,6411,1763,4648,2.164,7.87,8099,1402,6697,1.721,9.942,-1688,-2.072,15.74,66,66,360
1980,3256,2022,2280,115236,115289,197,8.665,184,8.093,11713,2530,9183,2.194,10.16,11822,2698,9124,2.34,10.254,-109,-0.095,20.319,128,128,1128
1980,3259,1546,2032,93419,92910,183,9.091,145,7.203,8911,1800,7111,1.937,9.591,7947,1894,6053,2.039,8.553,964,1.038,17.107,83,84,865
1980,3261,9354,10814,533871,541958,1128,10.544,897,8.384,68764,19568,49196,3.611,12.688,85021,22183,62838,4.093,15.688,-16257,-3,25.376,621,627,9914
1980,3262,1754,2141,214267,226682,185,8.71,151,7.109,14723,4791,9932,2.114,6.495,40493,11892,28601,5.246,17.863,-25770,-11.368,12.99,97,98,539
1980,3271,1341,1646,98473,99437,221,13.667,163,10.08,10285,2991,7294,3.008,10.343,12249,2018,10231,2.029,12.318,-1964,-1.975,20.686,129,131,1216
1980,3272,1409,1690,177174,179797,209,12.617,142,8.572,11673,2263,9410,1.259,6.492,16923,1857,15066,1.033,9.412,-5250,-2.92,12.985,104,104,649
1980,3273,7397,9264,193003,198733,635,6.825,715,7.685,23802,7031,16771,3.538,11.977,35170,8599,26571,4.327,17.697,-11368,-5.72,23.954,486,494,4367
1980,3274,268,365,18104,18021,44,11.94,51,13.84,1477,561,916,3.113,8.196,1310,453,857,2.514,7.269,167,0.927,14.539,40,40,226
1980,3279,1926,2246,97082,98867,195,8.678,197,8.767,8456,2759,5697,2.791,8.553,12170,3435,8735,3.474,12.309,-3714,-3.757,17.106,128,129,918
1980,3311,218,233,15759,14843,49,22.426,20,9.153,3203,1754,1449,11.817,21.579,1319,593,726,3.995,8.886,1884,12.693,17.773,16,16,169
1980,3312,543,713,80131,82024,49,6.945,34,4.819,5955,1910,4045,2.329,7.26,9708,2739,6969,3.339,11.836,-3753,-4.576,14.52,19,19,778
1980,3313,452,765,178432,176753,42,5.515,35,4.596,13771,2000,11771,1.132,7.791,10360,2059,8301,1.165,5.861,3411,1.93,11.723,12,12,265
1980,3314,705,877,110804,109239,94,10.949,57,6.639,12454,3103,9351,2.841,11.401,9345,1782,7563,1.631,8.555,3109,2.846,17.109,29,29,239
1980,3315,2856,3222,317027,329665,193,6.033,147,4.595,22137,4678,17459,1.419,6.715,47894,6184,41710,1.876,14.528,-25757,-7.813,13.43,106,106,1940
1980,3321,2858,3065,166213,165963,237,7.819,169,5.576,17315,3573,13742,2.153,10.433,16741,3082,13659,1.857,10.087,574,0.346,20.174,129,129,1640
1980,3322,1112,1229,95184,95194,103,8.456,81,6.65,8135,2173,5962,2.283,8.546,8164,1456,6708,1.53,8.576,-29,-0.03,17.091,57,57,880
1980,3323,9493,10326,381601,382141,977,9.556,773,7.561,52376,13780,38596,3.606,13.706,53539,12339,41200,3.229,14.01,-1163,-0.304,27.412,575,581,7595
1980,3324,1412,1809,170303,171777,137,7.641,105,5.856,14308,3218,11090,1.873,8.329,17101,4073,13028,2.371,9.955,-2793,-1.626,16.659,62,62,1282
1980,3325,846,933,90818,93562,83,8.93,76,8.176,6434,1765,4669,1.886,6.877,11989,2382,9607,2.546,12.814,-5555,-5.937,13.754,50,50,428
1980,3326,1559,1754,74099,75338,135,7.725,122,6.981,8650,2169,6481,2.879,11.482,11281,2111,9170,2.802,14.974,-2631,-3.492,22.963,84,84,829
1980,3327,19728,20036,356151,353000,2695,13.849,1544,7.934,53611,14121,39490,4,15.187,47512,13821,33691,3.915,13.46,6099,1.728,26.919,1197,1199,8518
1980,3328,5242,5530,126458,128251,448,8.136,401,7.282,17553,5243,12310,4.088,13.686,21024,4801,16223,3.743,16.393,-3471,-2.706,27.373,293,295,3167
1980,3329,4526,5046,397996,398011,573,11.614,348,7.054,36811,6281,30530,1.578,9.249,37273,8092,29181,2.033,9.365,-462,-0.116,18.497,230,230,2673
1980,3331,2969,3418,401090,406085,404,12.087,253,7.569,42460,12591,29869,3.101,10.456,52839,16081,36758,3.96,13.012,-10379,-2.556,20.912,164,165,1853
1980,3332,3435,3693,198667,196632,301,8.259,204,5.597,24229,4617,19612,2.348,12.322,20070,9150,10920,4.653,10.207,4159,2.115,20.414,130,130,1521
1980,3333,2045,2157,168667,167620,164,7.64,143,6.662,15503,2423,13080,1.446,9.249,13345,2712,10633,1.618,7.961,2158,1.287,15.923,105,105,1436
1980,3334,1776,2022,193258,195948,286,14.618,155,7.922,19597,3721,15876,1.899,10.001,25142,4805,20337,2.452,12.831,-5545,-2.83,20.002,106,106,1127
1980,3335,9790,10229,316761,312060,866,8.575,607,6.01,36884,6925,29959,2.219,11.82,27637,7946,19691,2.546,8.856,9247,2.963,17.713,448,448,4073
1980,3336,654,796,191403,195305,52,6.586,39,4.94,9879,2071,7808,1.06,5.058,17826,2416,15410,1.237,9.127,-7947,-4.069,10.116,22,22,1180
1980,3339,5744,6277,393593,390590,505,8.098,423,6.783,45035,11011,34024,2.819,11.53,39001,11878,27123,3.041,9.985,6034,1.545,19.97,273,273,3591
1980,3341,944,1122,317882,296440,208,19.313,118,10.956,67327,16875,50452,5.693,22.712,25094,10741,14353,3.623,8.465,42233,14.247,16.93,72,72,3960
1980,3342,1564,1743,295521,287248,206,12.005,152,8.858,37028,5571,31457,1.939,12.891,20167,8116,12051,2.825,7.021,16861,5.87,14.042,96,97,1775
1980,3343,460,488,63951,64075,66,13.36,78,15.789,7695,2685,5010,4.19,12.009,8053,2004,6049,3.128,12.568,-358,-0.559,24.019,57,57,923
1980,3344,3414,3855,462225,442227,594,15.901,355,9.503,74885,20920,53965,4.731,16.934,34217,11550,22667,2.612,7.737,40668,9.196,15.475,245,245,5907
1980,3345,3462,3980,583544,564708,427,10.919,288,7.365,72354,16503,55851,2.922,12.813,33923,9578,24345,1.696,6.007,38431,6.805,12.014,190,191,3149
1980,3346,578,601,21652,23209,102,16.749,118,19.376,2520,1303,1217,5.614,10.858,5735,1514,4221,6.523,24.711,-3215,-13.853,21.716,84,84,908
1980,3351,1190,1309,90631,92962,112,8.556,112,8.556,8224,2283,5941,2.456,8.847,12781,3336,9445,3.589,13.749,-4557,-4.902,17.693,75,75,1347
1980,3352,340,450,152782,149347,47,10.503,42,9.385,13602,2166,11436,1.45,9.108,6661,1058,5603,0.708,4.46,6941,4.648,8.92,24,24,277
1980,3353,1877,2361,304402,303919,229,9.845,159,6.836,33367,8790,24577,2.892,10.979,32419,9359,23060,3.079,10.667,948,0.312,21.334,96,97,1900
1980,3359,1517,1813,188970,189003,154,8.563,125,6.95,21101,5981,15120,3.165,11.164,21061,4021,17040,2.127,11.143,40,0.021,22.286,80,81,1483
1980,3361,176,237,260459,301629,32,13.617,28,11.915,11504,5657,5847,1.875,3.814,94027,6261,87766,2.076,31.173,-82523,-27.359,7.628,20,20,245
1980,3362,1778,1989,123235,137278,194,9.429,331,16.087,12052,3228,8824,2.351,8.779,39728,7781,31947,5.668,28.94,-27676,-20.161,17.559,248,249,3760
1980,3363,3351,4108,665568,736690,420,10.318,345,8.476,30763,12064,18699,1.638,4.176,172937,11234,161703,1.525,23.475,-142174,-19.299,8.352,252,252,3754
1980,3364,1057,1257,665261,636925,140,11.419,78,6.362,76627,5492,71135,0.862,12.031,20662,9406,11256,1.477,3.244,55965,8.787,6.488,46,46,403
1980,3365,157,206,82096,79612,20,9.78,17,8.313,10058,585,9473,0.735,12.634,5234,644,4590,0.809,6.574,4824,6.059,13.149,7,7,321
1980,3366,1114,1226,202682,203796,150,12.443,109,9.042,22704,3390,19314,1.663,11.141,24251,2399,21852,1.177,11.9,-1547,-0.759,22.281,92,92,1216
1980,3369,413,427,33855,34011,69,16.351,59,13.981,4194,627,3567,1.844,12.331,4500,938,3562,2.758,13.231,-306,-0.9,24.663,45,45,530
1980,3371,11920,12524,388695,394513,1584,12.705,1471,11.799,44775,16073,28702,4.074,11.349,56385,16484,39901,4.178,14.292,-11610,-2.943,22.699,1147,1152,10146
1980,3372,2183,2304,119076,119231,250,10.931,216,9.445,12309,2122,10187,1.78,10.324,12738,3035,9703,2.545,10.683,-429,-0.36,20.647,170,170,1531
1980,3379,1053,1193,39564,40041,95,7.927,106,8.844,4407,851,3556,2.125,11.006,5339,1244,4095,3.107,13.334,-932,-2.328,22.013,79,80,710
1980,3391,8849,9389,216657,215044,1216,13.171,903,9.781,28799,8511,20288,3.958,13.392,25397,8926,16471,4.151,11.81,3402,1.582,23.62,659,661,3011
1980,3399,14016,14690,455965,464598,1681,11.467,1621,11.057,59584,18175,41409,3.912,12.825,76915,18309,58606,3.941,16.555,-17331,-3.73,25.65,1278,1281,9544
1980,4231,22870,28648,325473,335068,2499,8.684,2757,9.581,38942,13521,25421,4.035,11.622,57997,18323,39674,5.468,17.309,-19055,-5.687,23.244,1865,1898,9672
1980,4232,7156,8352,97000,97134,982,11.833,875,10.544,14806,4482,10324,4.614,15.243,14968,4820,10148,4.962,15.41,-162,-0.167,30.486,593,597,2724
1980,4233,7471,9363,117154,117958,1100,11.883,888,9.593,18613,6688,11925,5.67,15.779,20213,5536,14677,4.693,17.136,-1600,-1.356,31.559,601,605,3136
1980,4234,17168,23663,411997,404889,3250,14.035,2238,9.664,67177,26664,40513,6.586,16.591,53311,23524,29787,5.81,13.167,13866,3.425,26.334,1328,1353,6548
1980,4235,5945,8464,140950,139645,849,10.12,699,8.332,20118,7017,13101,5.025,14.407,17473,6124,11349,4.385,12.512,2645,1.894,25.025,380,384,2384
1980,4236,12772,18404,234367,229628,2239,12.349,1692,9.332,43412,14808,28604,6.449,18.905,34082,13768,20314,5.996,14.842,9330,4.063,29.685,1007,1028,4920
1980,4237,10442,13480,151790,151348,1282,9.638,925,6.954,20742,6307,14435,4.167,13.705,19805,7255,12550,4.794,13.086,937,0.619,26.172,577,593,2824
1980,4238,44713,58216,693177,681744,5474,9.513,4126,7.17,108749,32039,76710,4.7,15.952,86076,29479,56597,4.324,12.626,22673,3.326,25.252,2583,2641,13519
1980,4239,20026,21673,220741,219978,3179,14.96,2333,10.979,41042,13268,27774,6.032,18.657,39540,13400,26140,6.092,17.975,1502,0.683,35.949,1706,1717,8593
1980,4241,6672,9162,134054,130178,937,10.411,613,6.811,19571,5906,13665,4.537,15.034,11891,4075,7816,3.13,9.134,7680,5.9,18.269,386,391,1866
1980,4242,2518,3229,91627,91288,383,11.889,368,11.423,11838,3972,7866,4.351,12.968,11229,5448,5781,5.968,12.301,609,0.667,24.601,234,238,1184
1980,4243,10072,11033,114860,116563,1470,13.357,1415,12.857,22133,7772,14361,6.668,18.988,25500,9790,15710,8.399,21.877,-3367,-2.889,37.976,1016,1020,4699
1980,4244,26065,31936,544688,546186,3076,9.577,3440,10.711,78086,24703,53383,4.523,14.297,81121,28958,52163,5.302,14.852,-3035,-0.556,28.593,2444,2481,15198
1980,4245,8878,12013,109848,111183,769,6.361,923,7.634,15807,4041,11766,3.635,14.217,18460,4853,13607,4.365,16.603,-2653,-2.386,28.434,586,603,3194
1980,4246,5658,8504,104748,103724,1030,12.343,712,8.532,17437,6208,11229,5.985,16.811,15261,4812,10449,4.639,14.713,2176,2.098,29.426,400,405,2081
1980,4247,12068,15934,150885,151779,1138,7.101,1320,8.237,23439,6607,16832,4.353,15.443,25203,7682,17521,5.061,16.605,-1764,-1.162,30.886,804,822,4062
1980,4248,4778,5878,128055,127097,342,5.785,410,6.935,15128,3202,11926,2.519,11.903,13175,5131,8044,4.037,10.366,1953,1.537,20.732,281,288,2444
1980,4249,18397,22396,239389,239616,2483,11.099,2435,10.884,39088,12513,26575,5.222,16.313,39479,14602,24877,6.094,16.476,-391,-0.163,32.626,1725,1753,8883
1980,4251,26592,29352,287723,289128,3308,11.46,2337,8.096,44623,15888,28735,5.495,15.434,47380,14320,33060,4.953,16.387,-2757,-0.954,30.867,1523,1525,7086
1980,4411,40024,41063,828598,875426,3284,7.863,4688,11.225,71307,29388,41919,3.357,8.145,165164,39996,125168,4.569,18.867,-93857,-10.721,16.291,3791,3824,31543
1980,4412,12232,12653,79655,83707,1377,10.716,1771,13.782,15188,5770,9418,6.893,18.144,23380,7750,15630,9.258,27.931,-8192,-9.787,36.288,1418,1427,6125
1980,4413,41226,57890,381132,387212,5268,9.163,4466,7.768,56535,22913,33622,5.917,14.601,67944,20555,47389,5.308,17.547,-11409,-2.946,29.201,2844,2914,12192
1980,4421,24078,28126,222798,224346,2970,10.576,2885,10.273,35371,13895,21476,6.194,15.766,38294,12317,25977,5.49,17.069,-2923,-1.303,31.533,2190,2227,8998
1980,4422,19274,22046,123412,121666,3487,16.135,2618,12.114,27330,12312,15018,10.12,22.463,23873,8915,14958,7.327,19.622,3457,2.841,39.244,2027,2055,6867
1980,4431,24614,31442,186568,188419,4043,12.768,4489,14.177,36771,15832,20939,8.403,19.516,40814,15735,25079,8.351,21.661,-4043,-2.146,39.031,3036,3136,10129
1980,4441,55914,70035,654034,656452,6427,9.252,5292,7.618,94714,37954,56760,5.782,14.428,99439,28519,70920,4.344,15.148,-4725,-0.72,28.856,3737,3851,19141
1980,4442,14025,16896,119608,120021,1666,9.939,1399,8.346,19442,6757,12685,5.63,16.199,20305,5202,15103,4.334,16.918,-863,-0.719,32.398,1019,1025,3566
1980,4451,65369,105201,1727773,1698865,11500,10.956,11033,10.511,278659,129293,149366,7.611,16.403,220716,84543,136173,4.976,12.992,57943,3.411,25.984,7113,7264,36990
1980,4452,23388,28957,175745,177957,3937,13.589,3965,13.686,39241,17236,22005,9.685,22.051,43618,16426,27192,9.23,24.51,-4377,-2.46,44.102,2878,2919,11757
1980,4453,28914,34236,180930,179961,3498,10.211,3541,10.336,33831,12303,21528,6.837,18.799,31885,11024,20861,6.126,17.718,1946,1.081,35.436,2709,2737,8222
1980,4461,40695,57220,533357,529648,5498,9.76,3721,6.606,80595,33279,47316,6.283,15.217,72296,21423,50873,4.045,13.65,8299,1.567,27.3,2497,2568,13037
1980,4471,113473,144028,790746,826841,15035,10.255,20198,13.777,152643,71444,81199,8.641,18.461,224668,81148,143520,9.814,27.172,-72025,-8.711,36.922,14005,14412,55513
1980,4481,60918,96058,770383,776519,12060,12.667,10367,10.888,136826,67271,69555,8.663,17.62,148549,48430,100119,6.237,19.13,-11723,-1.51,35.241,6974,7339,25964
1980,4482,12365,33047,178896,177361,4014,12.489,2202,6.851,35863,17962,17901,10.127,20.22,32103,7810,24293,4.403,18.1,3760,2.12,36.201,1156,1205,3827
1980,4483,17121,23744,152623,145739,2726,11.555,2423,10.27,40550,10465,30085,7.181,27.824,25681,9497,16184,6.516,17.621,14869,10.202,35.242,1437,1492,5128
1980,4511,31964,39760,239899,237406,5988,15.177,5376,13.626,54434,24661,29773,10.388,22.929,48646,18071,30575,7.612,20.491,5788,2.438,40.981,3939,4055,12522
1980,4512,7432,10366,68822,67016,1557,15.271,1216,11.927,15905,6579,9326,9.817,23.733,11931,4367,7564,6.516,17.803,3974,5.93,35.607,887,921,3185
1980,4522,525,6613,1124783,1132528,455,6.977,272,4.171,89420,50852,38568,4.49,7.896,106142,11041,95101,0.975,9.372,-16722,-1.477,15.791,20,25,756
1980,4523,15271,30601,819083,820887,2598,8.418,3123,10.119,91452,46755,44697,5.696,11.141,95577,29105,66472,3.546,11.643,-4125,-0.503,22.281,1727,1777,6984
1980,4531,20166,21378,103179,102415,2959,14.054,2313,10.986,21430,8588,12842,8.385,20.925,19798,6699,13099,6.541,19.331,1632,1.594,38.662,1761,1786,5109
1980,4532,22359,26509,154870,151386,4456,17.222,3185,12.31,35665,17049,18616,11.262,23.559,28818,11261,17557,7.439,19.036,6847,4.523,38.072,2492,2519,8025
1980,4533,8383,9911,47018,46187,1514,15.409,1343,13.669,9778,4541,5237,9.832,21.17,8137,3288,4849,7.119,17.618,1641,3.553,35.235,1061,1066,2441
1980,4539,26160,30942,140412,139104,5067,16.653,4037,13.268,34847,16421,18426,11.805,25.051,32189,12472,19717,8.966,23.14,2658,1.911,46.28,2926,3024,9297
1980,4541,5246,7020,92670,95442,902,12.904,842,12.046,15247,5618,9629,5.886,15.975,20831,6750,14081,7.072,21.826,-5584,-5.851,31.95,606,607,3551
1980,4542,4410,5568,83775,83028,549,9.848,562,10.082,13248,3626,9622,4.367,15.956,11653,3327,8326,4.007,14.035,1595,1.921,28.07,398,401,1665
1980,4543,16981,22434,196105,197523,1843,8.127,2331,10.279,28682,9502,19180,4.811,14.521,31623,11929,19694,6.039,16.01,-2941,-1.489,29.042,1663,1692,6700
1980,4811,1024,2430,303039,295445,290,12.036,249,10.334,31322,3713,27609,1.257,10.602,15754,3279,12475,1.11,5.332,15568,5.269,10.665,127,128,1041
1980,4812,389,547,6594,6275,111,21.023,73,13.826,1424,582,842,9.275,22.693,762,362,400,5.769,12.143,662,10.55,24.287,52,52,237
1980,4831,447,706,39029,38200,87,12.306,89,12.588,9419,4484,4935,11.738,24.657,8082,2086,5996,5.461,21.157,1337,3.5,42.314,45,45,658
1980,4832,411,473,17065,15987,60,12.834,49,10.481,4163,1900,2263,11.885,26.041,2086,929,1157,5.811,13.049,2077,12.992,26.097,25,25,215
1980,4841,20351,25343,514211,526672,4285,16.965,4114,16.288,72332,27609,44723,5.242,13.734,97779,25860,71919,4.91,18.565,-25447,-4.832,27.468,3278,3290,13776
1980,4842,41513,45273,564826,580800,7209,15.98,6886,15.264,88518,30918,57600,5.323,15.241,120887,35375,85512,6.091,20.814,-32369,-5.573,30.481,5439,5471,22542
1980,4851,395,432,19961,20326,48,11.085,50,11.547,1846,644,1202,3.168,9.082,2506,995,1511,4.895,12.329,-660,-3.247,18.164,34,34,435
1980,4852,318,698,30820,30757,55,8.065,23,3.372,2213,137,2076,0.445,7.195,2230,743,1487,2.416,7.25,-17,-0.055,14.39,18,18,677
1980,4853,6038,6099,69194,72422,891,14.215,1229,19.608,12207,4497,7710,6.209,16.855,18749,6101,12648,8.424,25.889,-6542,-9.033,33.711,1044,1044,4779
1980,4854,3727,3900,92853,92518,405,10.353,429,10.966,15658,4727,10931,5.109,16.924,14909,5172,9737,5.59,16.115,749,0.81,32.229,351,351,3025
1980,4855,469,496,8892,8683,53,10.653,56,11.256,1931,592,1339,6.818,22.24,1501,623,878,7.175,17.288,430,4.952,34.575,48,48,339
1980,4859,852,908,19362,19093,156,17.459,127,14.214,3337,1246,2091,6.526,17.478,2814,1163,1651,6.091,14.739,523,2.739,29.478,101,101,696
1980,4861,94,308,10984,10969,27,8.94,15,4.967,1225,373,852,3.4,11.168,1180,261,919,2.379,10.758,45,0.41,21.515,3,3,21
1980,4862,243,1071,56534,55261,83,7.954,28,2.683,5448,1427,4021,2.582,9.859,2958,394,2564,0.713,5.353,2490,4.506,10.706,19,19,48
1980,4869,63,260,7006,7224,20,7.634,24,9.16,1022,350,672,4.845,14.148,1464,1004,460,13.899,20.267,-442,-6.119,28.297,3,3,101
1980,4871,157,161,2345,2168,35,22.581,23,14.839,717,396,321,18.266,33.072,388,122,266,5.627,17.897,329,15.175,35.793,18,18,86
1980,4872,672,680,8719,8387,129,19.283,107,15.994,2135,662,1473,7.894,25.458,1503,625,878,7.452,17.922,632,7.536,35.843,76,76,397
1980,4879,44,54,1200,1201,17,34.343,8,16.162,186,149,37,12.406,15.487,187,24,163,1.998,15.57,-1,-0.083,30.974,6,6,19
1980,4881,2056,2504,54847,53574,367,14.639,373,14.878,9836,2321,7515,4.332,18.36,7269,2534,4735,4.73,13.568,2567,4.792,27.137,270,271,1553
1980,4882,320,400,15026,15174,61,15.561,45,11.48,2489,756,1733,4.982,16.403,2738,1222,1516,8.053,18.044,-249,-1.641,32.806,25,25,325
1980,4883,2161,2590,128915,129948,393,15.552,267,10.566,34399,15230,19169,11.72,26.471,36831,3510,33321,2.701,28.343,-2432,-1.872,52.943,181,181,1939
1980,4884,1854,2447,39442,40721,415,16.935,422,17.221,4906,2233,2673,5.484,12.048,7534,2113,5421,5.189,18.502,-2628,-6.454,24.096,330,331,1462
1980,4885,3992,5715,80543,78099,865,15.514,586,10.51,16375,5518,10857,7.065,20.967,11264,4021,7243,5.149,14.423,5111,6.544,28.846,396,398,2446
1980,4889,359,370,6130,5799,60,16.667,40,11.111,1726,576,1150,9.934,29.766,1125,292,833,5.036,19.402,601,10.365,38.803,30,30,203
1980,4921,1066,1550,72167,70282,342,22.876,232,15.518,10658,2923,7735,4.159,15.165,6940,935,6005,1.33,9.875,3718,5.29,19.749,166,166,547
1980,4922,724,725,3868,3829,313,45.166,249,35.931,1485,1016,469,26.534,38.783,1414,882,532,23.035,36.929,71,1.854,73.857,223,223,810
1980,4931,6330,9697,394365,396270,880,9.184,649,6.773,51756,15653,36103,3.95,13.061,55013,12393,42620,3.127,13.883,-3257,-0.822,26.122,339,341,1977
1980,5111,12983,14621,586910,586071,1609,11.104,1347,9.296,53489,14601,38888,2.491,9.127,51609,15939,35670,2.72,8.806,1880,0.321,17.612,1049,1053,8922
1980,5112,4236,5139,78878,73341,1617,35.114,549,11.922,24830,10992,13838,14.988,33.856,13861,6979,6882,9.516,18.9,10969,14.956,37.799,325,326,1706
1980,5121,8621,13915,191080,193567,1923,13.859,1843,13.283,44224,15748,28476,8.136,22.847,49904,14776,35128,7.634,25.781,-5680,-2.934,45.694,1007,1083,7602
1980,5122,1377,1383,10838,9909,369,28.705,174,13.536,3550,1570,1980,15.844,35.826,1759,742,1017,7.488,17.752,1791,18.074,35.503,128,128,488
1980,5151,5532,6488,193325,186681,635,9.937,440,6.885,31127,10608,20519,5.682,16.674,17507,6653,10854,3.564,9.378,13620,7.296,18.756,338,341,4422
1980,5152,7,7,45,36,(D),(D),(D),(D),23,(D),12,(D),63.889,4,(D),0,(D),11.111,19,52.778,22.222,(D),(D),(D)
1980,5173,2035,13901,973730,964548,449,3.246,315,2.277,247900,2664,245236,0.276,25.701,229795,3343,226452,0.347,23.824,18105,1.877,47.648,205,205,2238
1980,5174,567,975,29609,26525,163,17.546,71,7.643,8160,2407,5753,9.074,30.763,1934,571,1363,2.153,7.291,6226,23.472,14.582,42,42,291
1980,5179,953,2004,62525,56814,236,12.062,141,7.207,21555,1920,19635,3.379,37.94,9979,538,9441,0.947,17.564,11576,20.375,35.129,107,107,386
1980,5182,5101,6698,195641,187117,1242,19.161,810,12.496,47350,21536,25814,11.509,25.305,30063,14671,15392,7.841,16.066,17287,9.239,32.133,481,484,5024
1980,5191,2102,2484,27850,27574,241,9.811,186,7.572,3880,1334,2546,4.838,14.071,3296,1474,1822,5.346,11.954,584,2.118,23.907,143,143,1044
1980,5211,21,54,23868,23705,3,5.66,(D),(D),1075,590,485,2.489,4.535,765,(D),344,(D),3.227,310,1.308,6.454,0,0,0
1980,5221,21294,62615,1738953,1698334,3452,5.617,1125,1.831,171462,44211,127251,2.603,10.096,89959,17561,72398,1.034,5.297,81503,4.799,10.594,482,510,5254
1980,5222,23482,44134,353159,348043,3100,7.013,3233,7.314,55870,21395,34475,6.147,16.053,46015,16804,29211,4.828,13.221,9855,2.832,26.442,1353,1368,5197
1980,5223,2772,3063,32581,30374,656,22.043,482,16.196,9151,5534,3617,18.22,30.128,4839,1774,3065,5.841,15.932,4312,14.197,31.863,381,381,1290
1980,5231,4446,8481,188527,179434,1317,16.076,740,9.033,41229,11730,29499,6.537,22.977,22980,7293,15687,4.064,12.807,18249,10.17,25.614,454,457,2379
1980,5232,98,110,5852,5247,17,15.668,14,12.903,1328,73,1255,1.391,25.31,128,89,39,1.696,2.439,1200,22.87,4.879,12,12,81
1980,5239,9581,9928,81584,80852,1888,19.479,1417,14.62,20946,8307,12639,10.274,25.907,19344,9015,10329,11.15,23.925,1602,1.981,47.851,1121,1121,3963
1980,5241,6291,30053,1231862,1219610,2281,7.636,1922,6.434,135095,43560,91535,3.572,11.077,109464,29693,79771,2.435,8.975,25631,2.102,17.951,381,407,2255
1980,5242,87555,92009,990247,964312,10269,11.269,8500,9.328,192071,45899,146172,4.76,19.918,141774,40404,101370,4.19,14.702,50297,5.216,29.404,6169,6177,25761
1980,5259,589,788,9323,8106,65,8.181,78,9.817,3151,507,2644,6.255,38.872,712,273,439,3.368,8.784,2439,30.089,17.567,48,48,120
1980,5311,106080,107743,509103,514470,14161,13.025,16115,14.822,112832,52671,60161,10.238,21.932,123148,56365,66783,10.956,23.937,-10316,-2.005,43.863,13311,13328,43825
1980,5312,33463,34600,176884,177521,6277,18.434,5179,15.21,43964,17939,26025,10.105,24.766,44949,16729,28220,9.424,25.32,-985,-0.555,49.531,4171,4177,11710
1980,5313,20637,21224,178317,177074,3871,18.454,3377,16.099,43459,16608,26851,9.379,24.543,40964,15413,25551,8.704,23.134,2495,1.409,46.268,2663,2666,9812
1980,5321,5564,8984,100395,100314,1253,13.762,1495,16.42,27471,7339,20132,7.316,27.385,27085,11920,15165,11.883,27,386,0.385,54.001,721,739,3823
1980,5322,8108,9619,81606,79557,2033,21.993,1283,13.879,21911,9900,12011,12.444,27.541,18033,7237,10796,9.097,22.667,3878,4.875,45.334,977,982,5156
1980,5323,2059,2282,16276,16260,433,19.913,218,10.025,3946,1632,2314,10.037,24.269,3846,2134,1712,13.125,23.654,100,0.615,47.308,143,143,640
1980,5324,3721,4214,45952,44341,715,17.633,397,9.79,10636,3808,6828,8.588,23.987,7536,2133,5403,4.81,16.996,3100,6.991,33.991,276,276,1384
1980,5331,877,933,9935,10081,162,17.401,158,16.971,3212,1237,1975,12.271,31.863,3569,2150,1419,21.328,35.405,-357,-3.541,63.727,127,127,632
1980,5411,104161,107110,546108,532518,14097,13.413,10073,9.584,101713,39423,62290,7.403,19.1,74396,27596,46800,5.182,13.971,27317,5.13,27.941,7389,7425,20270
1980,5412,44378,47327,341870,331053,7771,16.882,5178,11.249,68202,29139,39063,8.802,20.602,46205,20158,26047,6.089,13.957,21997,6.645,27.914,3831,3871,14276
1980,5413,41689,45365,608053,587178,7471,16.988,4696,10.678,125768,43301,82467,7.374,21.419,83746,25539,58207,4.349,14.262,42022,7.157,28.525,3361,3377,16098
1980,5414,10930,11158,78442,75778,2527,23.886,1370,12.95,20266,9368,10898,12.362,26.744,14962,6417,8545,8.468,19.745,5304,6.999,39.489,1056,1057,3870
1980,5415,2868,3341,29948,29791,1446,45.472,1124,35.346,10335,5623,4712,18.875,34.692,10015,7029,2986,23.595,33.618,320,1.074,67.236,851,853,3299
1980,5416,15478,16054,160919,159800,3670,23.245,3139,19.882,44098,17173,26925,10.747,27.596,41743,16948,24795,10.606,26.122,2355,1.474,52.244,2456,2463,11565
1980,5417,4460,5533,382893,373596,635,11.506,607,10.998,44991,11248,33743,3.011,12.043,26776,7617,19159,2.039,7.167,18215,4.876,14.334,377,379,2412
1980,5418,18425,20148,243670,239437,3244,16.418,2465,12.476,48040,15801,32239,6.599,20.064,39720,14342,25378,5.99,16.589,8320,3.475,33.178,1857,1863,9028
1980,5419,23019,24921,179321,180128,3727,15.377,2360,9.737,33380,12639,20741,7.017,18.531,34575,9771,24804,5.424,19.195,-1195,-0.663,37.063,1762,1781,6782
1980,5511,20626,38984,2657290,2613436,3975,10.357,2769,7.215,418856,122162,296694,4.674,16.027,329186,93027,236159,3.56,12.596,89670,3.431,25.192,566,590,6192
1980,5611,4582,4784,62538,63006,718,14.61,979,19.921,14588,4609,9979,7.315,23.153,15615,6694,8921,10.624,24.783,-1027,-1.63,46.307,782,783,5239
1980,5612,204,251,13620,14418,46,17.326,75,28.249,3368,1613,1755,11.187,23.36,5035,3677,1358,25.503,34.922,-1667,-11.562,46.719,35,36,881
1980,5613,9623,12723,579287,557517,2557,20.995,1469,12.062,157573,50247,107326,9.013,28.263,114371,23457,90914,4.207,20.514,43202,7.749,41.029,1036,1043,10963
1980,5614,16677,18732,195870,192663,3296,18.225,2003,11.075,39664,15113,24551,7.844,20.587,33418,8429,24989,4.375,17.345,6246,3.242,34.691,1496,1516,5826
1980,5615,15642,18278,140361,134707,2761,15.733,1304,7.43,30900,11574,19326,8.592,22.939,19745,6006,13739,4.459,14.658,11155,8.281,29.315,934,944,3777
1980,5616,10437,12501,372908,354563,2788,23.689,1324,11.25,96523,35831,60692,10.106,27.223,59253,17482,41771,4.931,16.712,37270,10.512,33.423,966,967,9817
1980,5617,48592,51050,641985,638834,11230,22.443,9204,18.394,155096,60358,94738,9.448,24.278,149559,47236,102323,7.394,23.411,5537,0.867,46.822,7318,7330,31628
1980,5619,11217,11972,146208,142685,2730,24.397,1166,10.42,36752,15892,20860,11.138,25.758,29473,7325,22148,5.134,20.656,7279,5.101,41.312,814,818,4609
1980,5621,4677,4813,93835,95254,628,13.026,644,13.358,11441,3046,8395,3.198,12.011,14208,3934,10274,4.13,14.916,-2767,-2.905,24.022,526,528,3147
1980,5622,1892,2272,36722,36214,310,13.948,211,9.494,6126,2267,3859,6.26,16.916,5125,1795,3330,4.957,14.152,1001,2.764,28.304,147,147,946
1980,5629,4362,4583,42176,42676,664,14.647,565,12.463,8546,2754,5792,6.453,20.026,9670,2686,6984,6.294,22.659,-1124,-2.634,40.051,441,442,2101
1980,6111,12716,13055,334616,332595,618,4.737,598,4.584,32184,5412,26772,1.627,9.677,27967,5618,22349,1.689,8.409,4217,1.268,16.817,441,443,3524
1980,6112,439,508,33625,32892,20,3.857,41,7.907,4706,791,3915,2.405,14.307,3365,762,2603,2.317,10.23,1341,4.077,20.461,27,28,590
1980,6113,1946,2187,851261,831573,83,3.795,83,3.795,80981,1012,79969,0.122,9.738,42272,3035,39237,0.365,5.083,38709,4.655,10.167,50,52,1614
1980,6114,1636,1818,25699,25078,306,17.038,262,14.588,5725,1426,4299,5.686,22.829,4503,1819,2684,7.254,17.956,1222,4.873,35.913,203,205,1056
1980,6115,3535,3980,41978,41724,561,14.268,465,11.826,8629,3380,5249,8.101,20.681,8151,2532,5619,6.069,19.536,478,1.146,39.072,357,362,1847
1980,6116,9631,10109,86899,87421,1897,18.991,1657,16.588,20253,7940,12313,9.083,23.167,21344,7289,14055,8.338,24.415,-1091,-1.248,46.335,1331,1337,5683
1980,6117,766,782,19679,18967,142,18.228,136,17.458,3188,735,2453,3.875,16.808,1802,653,1149,3.443,9.501,1386,7.307,19.001,114,114,557
1980,6211,153253,157527,852458,839538,16571,10.776,9083,5.906,141973,57438,84535,6.842,16.911,116363,33810,82553,4.027,13.86,25610,3.05,27.721,6835,6860,24577
1980,6212,86060,87436,356363,351467,6390,7.415,3868,4.489,56775,18551,38224,5.278,16.154,46850,11089,35761,3.155,13.33,9925,2.824,26.66,2919,2932,8379
1980,6213,30898,32023,96840,93660,4802,15.517,2650,8.563,23347,11458,11889,12.234,24.928,16969,6754,10215,7.211,18.118,6378,6.81,36.236,1969,1972,5144
1980,6214,4310,5382,79293,76521,846,16.285,472,9.086,16570,6336,10234,8.28,21.654,11029,3666,7363,4.791,14.413,5541,7.241,28.826,306,309,2164
1980,6215,3723,4696,59078,58315,635,13.737,488,10.557,10951,4318,6633,7.405,18.779,9512,3036,6476,5.206,16.311,1439,2.468,32.623,322,338,1726
1980,6216,2398,3101,94577,87160,579,19.791,228,7.794,26863,10017,16846,11.493,30.821,11967,2736,9231,3.139,13.73,14896,17.091,27.46,154,154,1377
1980,6219,2479,2803,52699,50068,514,19.233,253,9.467,13173,3859,9314,7.708,26.31,7824,2937,4887,5.866,15.627,5349,10.683,31.253,178,179,2295
1980,6221,3894,4784,2511801,2463035,180,3.766,172,3.598,177245,37477,139768,1.522,7.196,78159,36250,41909,1.472,3.173,99086,4.023,6.347,98,98,21016
1980,6222,326,397,44455,43243,40,10.376,17,4.41,5236,1878,3358,4.343,12.108,2725,663,2062,1.533,6.302,2511,5.807,12.603,10,10,418
1980,6223,171,201,40837,40411,17,8.608,10,5.063,2819,703,2116,1.74,6.976,1930,810,1120,2.004,4.776,889,2.2,9.552,5,5,338
1980,6231,8297,11090,839049,832716,722,6.534,643,5.819,98948,36115,62833,4.337,11.883,86614,31528,55086,3.786,10.401,12334,1.481,20.803,448,470,22524
1980,6232,3118,3878,86526,82591,556,14.926,250,6.711,16085,7110,8975,8.609,19.475,8075,2080,5995,2.518,9.777,8010,9.698,19.554,178,178,1527
1980,6233,6286,7119,203870,202492,846,12.02,685,9.732,28610,10096,18514,4.986,14.129,25812,10736,15076,5.302,12.747,2798,1.382,25.494,483,490,7221
1980,6239,2412,2864,72502,70998,290,10.304,191,6.786,9945,3305,6640,4.655,14.007,6956,2294,4662,3.231,9.797,2989,4.21,19.595,121,122,1433
1980,6241,10809,14805,235958,231124,1612,11.11,1020,7.03,44712,11966,32746,5.177,19.346,34882,8592,26290,3.717,15.092,9830,4.253,30.185,628,640,4189
1980,6242,3075,3641,38910,38030,367,10.259,240,6.709,7179,1901,5278,4.999,18.877,5310,1435,3875,3.773,13.963,1869,4.915,27.926,142,143,682
1980,6243,3265,4767,225279,219774,670,14.451,409,8.821,46180,13966,32214,6.355,21.012,35640,5391,30249,2.453,16.217,10540,4.796,32.433,196,216,2417
1980,6244,24257,28311,241687,237451,4073,14.729,2758,9.973,49137,20395,28742,8.589,20.694,40671,13969,26702,5.883,17.128,8466,3.565,34.256,2094,2118,9447
1980,7111,4788,4820,58130,58102,862,17.775,921,18.992,16478,5229,11249,9,28.361,16328,5213,11115,8.972,28.103,150,0.258,56.205,722,724,4096
1980,7112,2095,2184,57760,56771,384,17.639,370,16.996,12954,2665,10289,4.694,22.818,11258,2071,9187,3.648,19.831,1696,2.987,39.661,280,280,1372
1980,7113,2126,2164,47455,46013,389,18.259,322,15.114,10055,3589,6466,7.8,21.853,7083,2568,4515,5.581,15.393,2972,6.459,30.787,239,239,1802
1980,7114,938,954,8627,9121,217,23.333,169,18.172,2469,1310,1159,14.362,27.069,3419,1996,1423,21.884,37.485,-950,-10.416,54.139,123,123,863
1980,7115,4526,4557,24259,23875,1544,36.898,799,19.094,8934,5183,3751,21.709,37.42,8146,3084,5062,12.917,34.119,788,3.301,68.239,576,576,2388
1980,7121,1655,1738,30155,30179,71,4.026,122,6.918,3469,234,3235,0.775,11.495,3447,693,2754,2.296,11.422,22,0.073,22.844,86,86,427
1980,7131,1402,1643,51157,50833,371,23.526,239,15.155,7114,2383,4731,4.688,13.995,6197,1352,4845,2.66,12.191,917,1.804,24.382,189,190,791
1980,7132,581,594,18477,18390,111,19.056,88,15.107,2754,1136,1618,6.177,14.976,2558,859,1699,4.671,13.91,196,1.066,27.819,75,75,738
1980,7139,29247,30885,433312,429807,3938,12.923,3112,10.213,81428,29285,52143,6.814,18.945,74513,23750,50763,5.526,17.336,6915,1.609,34.673,2296,2309,15768
1980,7211,29345,33185,1026897,1015130,4078,12.229,4401,13.198,193619,76851,116768,7.571,19.073,170295,65553,104742,6.458,16.776,23324,2.298,33.551,3226,3241,41028
1980,7212,3331,3530,17871,18123,461,12.939,527,14.791,4566,1516,3050,8.365,25.195,5047,1593,3454,8.79,27.849,-481,-2.654,50.389,341,342,892
1980,7213,5538,5611,31775,32235,321,5.624,514,9.006,4107,1078,3029,3.344,12.741,5039,1728,3311,5.361,15.632,-932,-2.891,25.482,367,371,1380
1980,7223,16002,24964,465668,466922,3988,16.08,3663,14.769,105922,53339,52583,11.424,22.685,108492,42600,65892,9.124,23.236,-2570,-0.55,45.37,2108,2129,16854
1980,7224,64424,65181,349415,353955,9348,14.129,11309,17.093,92542,46245,46297,13.065,26.145,101952,44441,57511,12.556,28.804,-9410,-2.659,52.29,8814,8842,34627
1980,7225,175877,222769,3767575,3720978,37466,17.008,32495,14.751,907048,517261,389787,13.901,24.377,816176,322142,494034,8.657,21.934,90872,2.442,43.869,23789,24249,214919
1980,8111,88236,91687,426131,436648,14731,16.196,13266,14.585,89470,45714,43756,10.469,20.49,110582,43162,67420,9.885,25.325,-21112,-4.835,40.98,10306,10340,33474
1980,8112,10055,11110,63263,63397,1409,12.532,1676,14.906,11136,4730,6406,7.461,17.565,11439,4640,6799,7.319,18.043,-303,-0.478,35.131,1334,1334,3382
1980,8113,16649,17700,142314,139209,2630,15.086,2097,12.029,29247,10360,18887,7.442,21.009,23244,8314,14930,5.972,16.697,6003,4.312,33.394,1584,1593,6010
1980,8114,22296,23920,143216,145266,3652,15.303,3540,14.834,25747,10780,14967,7.421,17.724,29927,10408,19519,7.165,20.602,-4180,-2.877,35.448,2718,2723,7975
1980,8121,82823,90763,407546,412347,12355,13.591,12639,13.904,84057,41842,42215,10.147,20.385,93646,37888,55758,9.188,22.71,-9589,-2.325,40.77,10099,10174,28755
1980,8122,17597,19983,108738,109474,1397,7.005,1316,6.599,15436,4745,10691,4.334,14.1,16891,4072,12819,3.72,15.429,-1455,-1.329,28.2,923,935,2870
1980,8123,33312,38920,334965,340463,4067,10.376,4616,11.777,44248,17069,27179,5.013,12.996,55019,19916,35103,5.85,16.16,-10771,-3.164,25.993,3492,3586,14318
1980,8129,13035,19071,189171,182842,3737,20.293,2426,13.174,43448,20129,23319,11.009,23.763,30829,11566,19263,6.326,16.861,12619,6.902,33.722,1521,1555,6956
1980,8131,70548,70630,652916,645831,3596,5.139,2272,3.247,80801,13943,66858,2.159,12.511,66486,7370,59116,1.141,10.295,14315,2.217,20.589,1122,1122,3274
1980,8132,6908,7718,125167,119632,771,10.127,561,7.369,30297,6123,24174,5.118,25.325,19118,4463,14655,3.731,15.981,11179,9.344,31.961,379,383,3398
1980,8133,6525,7575,99912,99177,947,12.763,637,8.585,20406,5174,15232,5.217,20.575,19126,5288,13838,5.332,19.285,1280,1.291,38.57,391,393,2351
1980,8134,27862,29085,235449,235399,1780,6.13,1689,5.816,33482,6228,27254,2.646,14.224,33575,4992,28583,2.121,14.263,-93,-0.04,28.447,1149,1150,3390
1980,8139,54347,56416,422006,417397,4400,7.838,3835,6.832,77061,17587,59474,4.213,18.462,67897,13321,54576,3.191,16.267,9164,2.196,32.534,2786,2791,8891
1981,1131,210,217,4270,4348,35,16.317,30,13.986,682,334,348,7.683,15.687,861,255,606,5.865,19.804,-179,-4.117,31.374,21,21,59
1981,1132,88,104,1007,1186,9,8.612,10,9.569,148,42,106,3.543,12.484,509,143,366,12.062,42.935,-361,-30.451,24.968,7,7,93
1981,1133,10833,10946,91687,95196,1475,13.102,2098,18.636,17348,5878,11470,6.175,18.223,24498,8556,15942,8.988,25.734,-7150,-7.511,36.447,1510,1510,6052
1981,1141,1438,1470,10221,10514,276,18.455,327,21.866,3213,1293,1920,12.298,30.559,3802,1434,2368,13.639,36.161,-589,-5.602,61.119,226,227,919
1981,1142,131,132,538,585,21,15.054,36,25.806,139,46,93,7.87,23.781,241,167,74,28.571,41.232,-102,-17.451,47.562,30,30,134
1981,1151,4143,4511,53192,53385,562,12.398,606,13.369,14160,4424,9736,8.287,26.524,14536,6740,7796,12.625,27.229,-376,-0.704,53.049,403,405,2959
1981,1152,1597,1613,10188,10176,262,16.248,261,16.186,2008,819,1189,8.048,19.733,1987,918,1069,9.021,19.526,21,0.206,39.053,197,197,572
1981,1153,738,753,9536,9298,143,19.233,124,16.678,3131,1516,1615,16.305,33.674,2579,914,1665,9.83,27.737,552,5.937,55.474,92,92,696
1981,2111,6844,8766,164157,150858,1583,19.022,695,8.351,41392,13167,28225,8.728,27.438,15109,7347,7762,4.87,10.015,26283,17.422,20.031,421,427,2392
1981,2121,2961,3741,232577,232329,738,19.849,692,18.612,37896,12637,25259,5.439,16.311,37102,13747,23355,5.917,15.97,794,0.342,31.939,500,502,7864
1981,2122,637,818,85360,85374,226,29.427,126,16.406,10926,4041,6885,4.733,12.798,11018,2985,8033,3.496,12.906,-92,-0.108,25.596,76,78,457
1981,2123,3677,5146,115251,115788,436,8.466,444,8.621,17652,5006,12646,4.323,15.245,18737,3297,15440,2.847,16.182,-1085,-0.937,30.49,271,273,1848
1981,2131,10194,11645,360206,322180,3148,29.58,1143,10.74,126443,45656,80787,14.171,39.246,49684,21111,28573,6.553,15.421,76759,23.825,30.842,806,812,12500
1981,2211,1585,5733,548648,539868,211,3.713,110,1.936,30803,6259,24544,1.159,5.706,13346,3647,9699,0.676,2.472,17457,3.234,4.944,22,22,89
1981,2212,531,2323,138777,137813,104,4.514,66,2.865,8694,2361,6333,1.713,6.309,6836,1397,5439,1.014,4.96,1858,1.348,9.921,30,30,330
1981,2213,3913,4219,33973,33571,300,7.117,293,6.951,4230,1023,3207,3.047,12.6,3423,1358,2065,4.045,10.196,807,2.404,20.393,213,214,964
1981,2361,95187,95547,539864,565193,17524,17.538,26270,26.291,170650,68808,101842,12.174,30.193,221440,94701,126739,16.756,39.18,-50790,-8.986,60.387,20027,20030,74503
1981,2362,33519,34059,644857,653818,4884,14.203,5540,16.111,147436,35878,111558,5.487,22.55,164420,28363,136057,4.338,25.148,-16984,-2.598,45.1,4154,4156,19947
1981,2371,13791,14169,393048,392468,1617,11.391,1669,11.758,83031,18221,64810,4.643,21.156,81153,16057,65096,4.091,20.678,1878,0.479,41.355,1229,1229,9631
1981,2372,7660,7818,68447,68343,1801,23.037,1801,23.037,20268,9190,11078,13.447,29.657,20028,7960,12068,11.647,29.305,240,0.351,58.611,1409,1411,5587
1981,2373,10696,10987,223415,230679,994,8.972,1179,10.641,46434,11908,34526,5.162,20.129,60623,9974,50649,4.324,26.28,-14189,-6.151,40.259,842,842,6392
1981,2379,4547,4597,87587,85661,853,18.727,769,16.883,26758,6620,20138,7.728,31.237,22922,3664,19258,4.277,26.759,3836,4.478,53.518,605,605,2628
1981,2381,62905,63302,537482,552425,8521,13.104,11973,18.412,140414,41365,99049,7.488,25.418,170059,51859,118200,9.388,30.784,-29645,-5.366,50.836,8760,8761,39612
1981,2382,95264,96988,995628,1001936,11154,11.435,12263,12.572,200203,52655,147548,5.255,19.982,212562,53422,159140,5.332,21.215,-12359,-1.234,39.963,9341,9350,40549
1981,2383,65141,65524,501733,516150,9802,14.492,14028,20.74,131612,40784,90828,7.902,25.499,160450,52925,107525,10.254,31.086,-28838,-5.587,50.998,10625,10627,41435
1981,2389,33069,33221,282042,280510,5052,15.132,5381,16.118,79422,24728,54694,8.815,28.313,75969,21923,54046,7.815,27.082,3453,1.231,54.165,3946,3948,15305
1981,3111,1424,2097,58518,59584,131,6.237,138,6.57,5618,1936,3682,3.249,9.429,7698,1906,5792,3.199,12.92,-2080,-3.491,18.857,82,84,993
1981,3112,542,905,77951,78873,57,6.365,38,4.243,4751,1021,3730,1.294,6.024,6525,1234,5291,1.565,8.273,-1774,-2.249,12.047,21,21,262
1981,3113,1239,1629,89769,91299,180,11.275,115,7.203,7528,1691,5837,1.852,8.245,10657,850,9807,0.931,11.673,-3129,-3.427,16.491,65,65,364
1981,3114,1268,1772,183236,186917,119,6.676,140,7.854,16307,2475,13832,1.324,8.724,23431,5696,17735,3.047,12.536,-7124,-3.811,17.448,78,79,1028
1981,3115,1921,2701,144621,145486,108,3.951,173,6.329,12596,2704,9892,1.859,8.658,14266,4945,9321,3.399,9.806,-1670,-1.148,17.316,103,103,1566
1981,3116,4444,5059,331702,330723,431,8.542,404,8.007,35500,11884,23616,3.593,10.734,32980,9802,23178,2.964,9.972,2520,0.762,19.944,295,300,4491
1981,3117,723,855,44171,45650,77,9.032,72,8.446,7258,2277,4981,4.988,15.899,10272,3118,7154,6.83,22.502,-3014,-6.602,31.798,43,43,1632
1981,3118,8154,9728,298279,301983,1177,12.132,1125,11.596,32295,12307,19988,4.075,10.694,39744,15836,23908,5.244,13.161,-7449,-2.467,21.389,807,828,8719
1981,3119,1982,2344,114631,114948,206,8.796,202,8.625,13459,5017,8442,4.365,11.709,14316,3836,10480,3.337,12.454,-857,-0.746,23.418,119,119,1530
1981,3121,2171,2758,183588,184813,195,7.059,204,7.385,16784,5914,10870,3.2,9.082,19139,8004,11135,4.331,10.356,-2355,-1.274,18.163,149,151,3204
1981,3122,125,185,46801,46032,6,3.183,13,6.897,3505,165,3340,0.358,7.614,1914,242,1672,0.526,4.158,1591,3.456,8.316,11,11,227
1981,3131,462,717,120127,123810,36,4.942,59,8.099,6858,1337,5521,1.08,5.539,14134,3578,10556,2.89,11.416,-7276,-5.877,11.078,29,29,656
1981,3132,1793,2236,347136,355620,183,8.162,195,8.698,21442,8387,13055,2.358,6.029,38100,10967,27133,3.084,10.714,-16658,-4.684,12.059,133,134,2868
1981,3133,1627,1862,120127,124375,186,10.12,138,7.508,9745,3000,6745,2.412,7.835,18186,4667,13519,3.752,14.622,-8441,-6.787,15.67,96,98,2609
1981,3141,4286,4585,122034,127380,508,10.951,616,13.279,14090,7010,7080,5.503,11.061,24894,8804,16090,6.912,19.543,-10804,-8.482,22.123,487,488,3889
1981,3149,3497,3639,133589,136858,454,12.609,377,10.471,17537,6472,11065,4.729,12.814,23991,7458,16533,5.449,17.53,-6454,-4.716,25.628,312,312,5002
1981,3151,1402,1543,143864,145331,141,9.091,157,10.123,13806,3319,10487,2.284,9.5,16515,4643,11872,3.195,11.364,-2709,-1.864,18.999,135,135,3055
1981,3152,13553,15310,945421,950585,2224,14.736,1789,11.854,138556,59138,79418,6.221,14.576,148875,50569,98306,5.32,15.661,-10319,-1.086,29.152,1434,1446,30776
1981,3159,1763,1888,78792,79037,266,14.378,190,10.27,10868,3376,7492,4.271,13.751,11313,3384,7929,4.282,14.314,-445,-0.563,27.501,151,151,2297
1981,3161,375,417,21404,21103,37,8.799,44,10.464,3070,730,2340,3.459,14.548,2481,989,1492,4.687,11.757,589,2.791,23.514,35,38,637
1981,3162,515,762,145503,144849,65,8.587,55,7.266,18995,4113,14882,2.84,13.114,17432,5545,11887,3.828,12.035,1563,1.079,24.069,33,33,1295
1981,3169,1398,1447,62554,64714,165,11.522,135,9.427,8319,2539,5780,3.923,12.855,12505,3041,9464,4.699,19.324,-4186,-6.469,25.71,105,105,1995
1981,3211,5431,5997,149128,156855,578,9.465,797,13.052,16938,6052,10886,3.858,10.799,32340,8316,24024,5.302,20.618,-15402,-9.819,21.597,606,608,4772
1981,3212,1079,1346,85251,87568,137,10.197,132,9.825,10558,3421,7137,3.907,12.057,15194,4123,11071,4.708,17.351,-4636,-5.294,24.114,87,89,1105
1981,3219,8669,9463,273925,282544,1207,12.897,999,10.674,35865,14937,20928,5.287,12.694,53036,14835,38201,5.251,18.771,-17171,-6.077,25.387,749,754,8079
1981,3221,347,707,215493,218355,26,3.564,71,9.733,8643,1403,7240,0.643,3.958,14420,3747,10673,1.716,6.604,-5777,-2.646,7.916,23,25,765
1981,3222,3524,5101,398110,404344,343,6.767,278,5.485,27996,8975,19021,2.22,6.924,40670,9313,31357,2.303,10.058,-12674,-3.134,13.848,153,153,2707
1981,3231,32321,33757,656924,650554,4169,12.647,2586,7.845,86525,32685,53840,5.024,13.3,73927,23298,50629,3.581,11.364,12598,1.937,22.727,1971,1977,12140
1981,3241,1545,2424,536186,547403,222,9.225,187,7.771,25376,5452,19924,0.996,4.636,48458,8632,39826,1.577,8.852,-23082,-4.217,9.271,91,91,1289
1981,3251,1126,2203,271739,275703,218,10.125,118,5.481,15872,5559,10313,2.016,5.757,24248,3096,21152,1.123,8.795,-8376,-3.038,11.514,37,37,710
1981,3252,398,641,155333,158442,47,7.425,31,4.897,7456,2509,4947,1.584,4.706,13632,1353,12279,0.854,8.604,-6176,-3.898,9.412,18,18,185
1981,3253,776,1141,58025,57335,74,6.474,78,6.824,6510,1354,5156,2.362,11.354,5037,1210,3827,2.11,8.785,1473,2.569,17.571,37,39,687
1981,3254,945,1183,162789,161930,132,11.365,89,7.663,12319,2124,10195,1.312,7.608,10609,2206,8403,1.362,6.552,1710,1.056,13.103,57,57,428
1981,3255,1652,2102,77033,78724,112,5.286,146,6.89,5480,1138,4342,1.446,6.961,8929,2250,6679,2.858,11.342,-3449,-4.381,13.922,92,97,585
1981,3256,2056,2308,116971,115455,214,9.374,164,7.184,15552,4022,11530,3.484,13.47,12355,2747,9608,2.379,10.701,3197,2.769,21.402,117,117,1289
1981,3259,1625,2144,90500,91757,229,10.92,135,6.438,8442,2648,5794,2.886,9.2,10833,2154,8679,2.348,11.806,-2391,-2.606,18.401,81,81,673
1981,3261,9710,11184,514592,523031,1231,11.192,860,7.819,64712,20752,43960,3.968,12.373,81833,19585,62248,3.745,15.646,-17121,-3.273,24.745,587,589,7920
1981,3262,1838,2216,194148,204159,223,10.229,151,6.927,12751,3356,9395,1.644,6.246,33392,12773,20619,6.256,16.356,-20641,-10.11,12.491,92,92,1248
1981,3271,1350,1655,88097,93014,209,12.648,204,12.345,6452,2253,4199,2.422,6.937,16203,4363,11840,4.691,17.42,-9751,-10.483,13.873,154,155,1820
1981,3272,1488,1772,171709,174208,222,12.788,150,8.641,10852,2873,7979,1.649,6.229,15941,3020,12921,1.734,9.151,-5089,-2.921,12.459,114,114,1307
1981,3273,7352,9263,185464,189328,640,6.915,624,6.742,24597,7746,16851,4.091,12.992,32258,6214,26044,3.282,17.038,-7661,-4.046,25.983,414,416,3328
1981,3274,254,353,17577,17752,36,10.098,43,12.062,1272,216,1056,1.217,7.166,1612,203,1409,1.144,9.081,-340,-1.915,14.331,35,35,89
1981,3279,1987,2296,91209,93869,235,10.312,201,8.82,8692,3029,5663,3.227,9.26,13918,3260,10658,3.473,14.827,-5226,-5.567,18.519,150,151,1096
1981,3311,235,248,18672,18352,36,14.784,27,11.088,2921,1899,1022,10.348,15.917,2234,336,1898,1.831,12.173,687,3.743,24.346,22,22,272
1981,3312,546,723,79799,80070,62,8.665,47,6.569,8821,3189,5632,3.983,11.017,9239,2439,6800,3.046,11.539,-418,-0.522,22.033,29,30,833
1981,3313,456,764,166605,171760,50,6.649,26,3.457,8118,2121,5997,1.235,4.726,18495,3522,14973,2.051,10.768,-10377,-6.042,9.453,8,8,377
1981,3314,791,955,105348,107960,154,16.776,80,8.715,9031,4195,4836,3.886,8.365,14314,5176,9138,4.794,13.259,-5283,-4.894,16.73,48,49,401
1981,3315,2934,3295,287310,301465,222,6.786,175,5.349,21757,6669,15088,2.212,7.217,50316,9955,40361,3.302,16.69,-28559,-9.473,14.434,121,123,3624
1981,3321,2943,3159,156217,160102,270,8.69,166,5.343,13715,5032,8683,3.143,8.566,21475,2199,19276,1.373,13.413,-7760,-4.847,17.133,118,118,1226
1981,3322,1136,1260,89746,92494,102,8.147,86,6.869,5892,1448,4444,1.566,6.37,11290,1480,9810,1.6,12.206,-5398,-5.836,12.74,64,65,534
1981,3323,9821,10678,373806,377523,1121,10.668,781,7.432,63470,26421,37049,6.999,16.812,70682,25553,45129,6.769,18.723,-7212,-1.91,33.624,615,618,5978
1981,3324,1454,1843,159509,165429,153,8.361,127,6.94,11967,3467,8500,2.096,7.234,23667,4738,18929,2.864,14.306,-11700,-7.073,14.468,66,66,636
1981,3325,862,949,84979,88073,76,8.025,72,7.603,5372,2123,3249,2.411,6.1,11668,1763,9905,2.002,13.248,-6296,-7.149,12.199,49,49,540
1981,3326,1582,1768,69419,72643,152,8.671,122,6.959,7375,2832,4543,3.899,10.152,13758,3390,10368,4.667,18.939,-6383,-8.787,20.305,75,75,746
1981,3327,20565,20882,347620,352790,2581,12.612,1746,8.532,45319,16937,28382,4.801,12.846,55711,11582,44129,3.283,15.792,-10392,-2.946,25.692,1365,1368,8744
1981,3328,5320,5611,121313,123230,490,8.815,385,6.926,16000,5350,10650,4.341,12.984,19809,4122,15687,3.345,16.075,-3809,-3.091,25.968,295,301,2763
1981,3329,4769,5317,392182,394680,658,12.726,365,7.059,37191,10551,26640,2.673,9.423,42711,7833,34878,1.985,10.822,-5520,-1.399,18.846,257,257,3472
1981,3331,3191,3677,388157,394936,474,13.29,253,7.094,48307,13665,34642,3.46,12.232,61540,8063,53477,2.042,15.582,-13233,-3.351,24.463,168,168,2143
1981,3332,3603,3866,194870,196863,355,9.373,198,5.228,19733,7127,12606,3.62,10.024,23821,3066,20755,1.557,12.1,-4088,-2.077,20.047,139,140,1056
1981,3333,2067,2187,170038,168856,189,8.71,155,7.143,19404,5860,13544,3.47,11.491,17143,4191,12952,2.482,10.152,2261,1.339,20.305,108,108,1469
1981,3334,1899,2152,186901,189816,314,15.01,194,9.273,22386,7500,14886,3.951,11.794,27744,5288,22456,2.786,14.616,-5358,-2.823,23.587,146,147,1444
1981,3335,10076,10539,310104,314452,911,8.787,567,5.469,28682,9818,18864,3.122,9.121,37584,6400,31184,2.035,11.952,-8902,-2.831,18.243,426,426,3968
1981,3336,679,835,180169,185809,74,9.041,41,5.009,12460,5699,6761,3.067,6.706,23752,1494,22258,0.804,12.783,-11292,-6.077,13.412,26,27,599
1981,3339,5864,6432,374316,383228,593,9.364,394,6.222,41216,14161,27055,3.695,10.755,58842,13513,45329,3.526,15.354,-17626,-4.599,21.51,280,280,3783
1981,3341,1118,1302,327025,321237,309,25.527,126,10.409,45477,14922,30555,4.645,14.157,33887,11678,22209,3.635,10.549,11590,3.608,21.098,78,78,2731
1981,3342,1688,1868,279795,286540,252,13.923,136,7.514,25754,7105,18649,2.48,8.988,39579,7711,31868,2.691,13.813,-13825,-4.825,17.976,84,84,2414
1981,3343,475,502,60784,62472,69,13.814,64,12.813,4462,866,3596,1.386,7.142,7739,2292,5447,3.669,12.388,-3277,-5.246,14.285,48,48,554
1981,3344,3672,4151,459425,460270,642,16.11,310,7.779,59583,24637,34946,5.353,12.945,61350,17556,43794,3.814,13.329,-1767,-0.384,25.89,229,230,4043
1981,3345,3686,4220,590901,587124,508,12.372,280,6.819,61487,18095,43392,3.082,10.473,53741,13935,39806,2.373,9.153,7746,1.319,18.307,170,170,2549
1981,3346,556,580,20234,20810,96,16.424,105,17.964,3179,949,2230,4.56,15.276,4178,1644,2534,7.9,20.077,-999,-4.801,30.553,81,81,773
1981,3351,1196,1307,83108,86097,126,9.648,124,9.495,6807,2211,4596,2.568,7.906,12671,2758,9913,3.203,14.717,-5864,-6.811,15.812,94,95,1060
1981,3352,373,480,144207,148729,55,11.715,34,7.242,7890,1272,6618,0.855,5.305,17093,2760,14333,1.856,11.493,-9203,-6.188,10.61,21,21,563
1981,3353,1955,2465,295900,301808,232,9.603,134,5.546,29943,11576,18367,3.836,9.921,41596,10173,31423,3.371,13.782,-11653,-3.861,19.842,79,79,1262
1981,3359,1643,1954,186798,189588,235,12.362,129,6.786,21669,9221,12448,4.864,11.43,26761,8672,18089,4.574,14.115,-5092,-2.686,22.859,78,78,1889
1981,3361,175,231,239217,249201,35,15.119,36,15.551,37278,13569,23709,5.445,14.959,56189,17076,39113,6.852,22.548,-18911,-7.589,29.918,26,26,309
1981,3362,1718,1901,106625,114758,197,10.136,282,14.51,10839,2915,7924,2.54,9.445,26958,7227,19731,6.298,23.491,-16119,-14.046,18.89,204,204,2309
1981,3363,3399,4150,610152,637457,418,10.162,345,8.387,46630,12830,33800,2.013,7.315,100933,18478,82455,2.899,15.834,-54303,-8.519,14.63,229,230,3540
1981,3364,1140,1352,677222,671603,162,12.352,81,6.176,47115,5885,41230,0.876,7.015,37750,3401,34349,0.506,5.621,9365,1.394,11.242,60,60,1121
1981,3365,171,220,62361,72283,23,10.698,13,6.047,2395,547,1848,0.757,3.313,22315,240,22075,0.332,30.872,-19920,-27.559,6.627,8,8,91
1981,3366,1146,1255,211335,207155,165,13.274,141,11.344,27192,5802,21390,2.801,13.126,18438,5784,12654,2.792,8.901,8754,4.226,17.801,105,105,3360
1981,3369,400,413,32372,33468,49,11.653,64,15.22,3478,840,2638,2.51,10.392,5878,1006,4872,3.006,17.563,-2400,-7.171,20.784,49,49,339
1981,3371,12019,12639,372155,382009,1585,12.585,1496,11.878,42125,17633,24492,4.616,11.027,61440,18401,43039,4.817,16.083,-19315,-5.056,22.054,1170,1173,10746
1981,3372,2278,2400,116064,117544,285,12.11,192,8.158,13561,5278,8283,4.49,11.537,16594,3123,13471,2.657,14.117,-3033,-2.58,23.074,151,151,1441
1981,3379,1088,1224,39453,39706,108,8.915,83,6.851,4808,2015,2793,5.075,12.109,5502,1413,4089,3.559,13.857,-694,-1.748,24.218,55,55,647
1981,3391,9140,9692,220769,218835,1317,13.799,1021,10.698,29936,10229,19707,4.674,13.68,25950,9539,16411,4.359,11.858,3986,1.821,23.716,756,759,3637
1981,3399,14266,14932,439063,445737,1790,12.097,1521,10.279,56638,18932,37706,4.247,12.707,70078,19328,50750,4.336,15.722,-13440,-3.015,25.413,1158,1160,9663
1981,4231,22754,28358,313966,318820,2491,8.753,2690,9.453,43537,17188,26349,5.391,13.656,53011,16536,36475,5.187,16.627,-9474,-2.972,27.311,1848,1908,9216
1981,4232,7359,8599,98047,97566,1111,13.111,860,10.149,16558,5359,11199,5.493,16.971,15552,5424,10128,5.559,15.94,1006,1.031,31.88,623,631,3535
1981,4233,7523,9487,111815,114241,1083,11.491,959,10.175,18127,7091,11036,6.207,15.867,23056,6712,16344,5.875,20.182,-4929,-4.315,31.735,666,675,3928
1981,4234,18179,24952,430806,420853,3624,14.922,2291,9.434,71903,32089,39814,7.625,17.085,51402,19381,32021,4.605,12.214,20501,4.871,24.428,1400,1416,7025
1981,4235,6203,8771,143294,141988,1007,11.692,690,8.012,21760,9054,12706,6.377,15.325,19269,5740,13529,4.043,13.571,2491,1.754,27.142,392,398,2300
1981,4236,13323,19332,248141,241085,2524,13.373,1607,8.515,49430,20816,28614,8.634,20.503,35215,10809,24406,4.483,14.607,14215,5.896,29.214,985,1013,4546
1981,4237,10583,13728,151366,151083,1327,9.763,1055,7.762,22432,8647,13785,5.723,14.848,21757,6734,15023,4.457,14.401,675,0.447,28.801,754,766,4081
1981,4238,45805,59979,697042,694165,6244,10.572,4404,7.457,107362,40515,66847,5.837,15.466,101472,31593,69879,4.551,14.618,5890,0.849,29.236,2879,2949,14996
1981,4239,21349,23015,223378,221648,3588,16.007,2388,10.654,42723,17639,25084,7.958,19.275,39350,13173,26177,5.943,17.753,3373,1.522,35.507,1777,1799,7984
1981,4241,6908,9386,136499,135263,955,10.304,720,7.768,20296,6118,14178,4.523,15.005,17945,5461,12484,4.037,13.267,2351,1.738,26.533,431,444,2307
1981,4242,2597,3366,92250,92211,478,14.529,326,9.909,13550,3753,9797,4.07,14.695,13678,4941,8737,5.358,14.833,-128,-0.139,29.389,233,235,2174
1981,4243,10251,11179,118207,116780,1577,14.21,1414,12.742,26199,11415,14784,9.775,22.435,23499,8916,14583,7.635,20.123,2700,2.312,40.245,1058,1070,5575
1981,4244,26215,32085,558317,551787,3391,10.594,3237,10.113,88077,33515,54562,6.074,15.962,74595,27655,46940,5.012,13.519,13482,2.443,27.038,2296,2346,15461
1981,4245,8720,11885,108145,109091,726,6.081,834,6.986,15440,5325,10115,4.881,14.153,17452,4681,12771,4.291,15.998,-2012,-1.844,28.307,577,598,3331
1981,4246,5978,8937,110410,106846,1143,13.11,706,8.098,22362,8779,13583,8.216,20.929,15347,4598,10749,4.303,14.364,7015,6.566,28.727,430,438,2096
1981,4247,11995,15837,157154,153838,1332,8.393,1398,8.809,31685,10565,21120,6.868,20.596,24956,9131,15825,5.935,16.222,6729,4.374,32.445,861,880,4454
1981,4248,4786,5902,135894,131792,415,7.053,379,6.441,19151,6129,13022,4.651,14.531,10969,3668,7301,2.783,8.323,8182,6.208,16.646,267,275,2242
1981,4249,18612,22699,244735,242208,2593,11.506,2269,10.068,42739,15857,26882,6.547,17.646,37859,11982,25877,4.947,15.631,4880,2.015,31.262,1681,1719,7154
1981,4251,27554,30423,292753,290451,3614,12.098,2512,8.409,51309,20276,31033,6.981,17.665,47110,15636,31474,5.383,16.22,4199,1.446,32.439,1742,1750,9265
1981,4411,38064,39036,752951,789756,3153,7.883,5073,12.684,75901,30870,45031,3.909,9.611,149090,52381,96709,6.633,18.878,-73189,-9.267,19.221,4206,4246,43559
1981,4412,11629,12026,74731,76843,1155,9.381,1726,14.019,13966,4957,9009,6.451,18.175,18092,7263,10829,9.452,23.544,-4126,-5.369,36.349,1389,1407,5781
1981,4413,41609,58503,380279,380561,5153,8.857,4504,7.742,57925,23873,34052,6.273,15.221,58957,19408,39549,5.1,15.492,-1032,-0.271,30.442,2899,2988,11532
1981,4421,23341,27631,213278,217887,2524,9.063,2959,10.625,31372,11661,19711,5.352,14.398,40646,13387,27259,6.144,18.655,-9274,-4.256,28.797,2299,2346,9419
1981,4422,19343,22423,120197,121678,3133,14.094,2745,12.349,23383,10909,12474,8.966,19.217,26275,9722,16553,7.99,21.594,-2892,-2.377,38.434,2127,2166,7523
1981,4431,24032,30953,177638,181822,3963,12.722,4358,13.99,34163,16572,17591,9.114,18.789,42479,16849,25630,9.267,23.363,-8316,-4.574,37.579,3047,3243,11144
1981,4441,55915,70554,644752,648995,5840,8.311,5272,7.502,90022,36587,53435,5.637,13.871,98630,26819,71811,4.132,15.197,-8608,-1.326,27.742,3946,4004,16582
1981,4442,14104,17009,121446,120508,1639,9.666,1533,9.041,20772,6847,13925,5.682,17.237,18923,5844,13079,4.849,15.703,1849,1.534,31.405,1151,1183,4386
1981,4451,65363,108791,1796302,1761697,14069,13.148,10498,9.811,293534,138944,154590,7.887,16.662,222067,78438,143629,4.452,12.605,71467,4.057,25.211,7064,7216,36924
1981,4452,23301,29015,176541,176131,4011,13.836,3961,13.663,40199,19596,20603,11.126,22.823,39350,17395,21955,9.876,22.341,849,0.482,44.683,2850,2921,11960
1981,4453,28306,33292,160890,171838,3434,10.172,4370,12.944,30201,12001,18200,6.984,17.575,52586,20984,31602,12.212,30.602,-22385,-13.027,35.151,2697,2741,8600
1981,4461,41124,59040,532148,532479,6011,10.356,4013,6.914,78509,35318,43191,6.633,14.744,78830,22497,56333,4.225,14.804,-321,-0.06,29.488,2801,2866,13544
1981,4471,108652,139737,796332,792544,15151,10.689,19175,13.527,174494,71247,103247,8.99,22.017,167393,71459,95934,9.016,21.121,7101,0.896,42.242,13328,13605,48470
1981,4481,59820,96834,766077,767401,11716,12.16,10752,11.159,139114,66894,72220,8.717,18.128,141034,48353,92681,6.301,18.378,-1920,-0.25,36.256,7292,8026,29452
1981,4482,12426,34854,189674,184158,4583,13.504,2750,8.103,44388,22014,22374,11.954,24.103,33891,10515,23376,5.71,18.403,10497,5.7,36.807,1309,1436,5297
1981,4483,17242,24669,144898,148665,3128,12.933,2163,8.943,29133,15045,14088,10.12,19.596,37201,8991,28210,6.048,25.023,-8068,-5.427,39.193,1466,1527,5351
1981,4511,31987,40093,245655,242434,5712,14.318,5312,13.316,52341,21249,31092,8.765,21.59,45735,18222,27513,7.516,18.865,6606,2.725,37.73,3960,4087,12312
1981,4512,7539,10741,68331,68593,1591,15.068,1227,11.62,13632,6750,6882,9.841,19.874,14273,4468,9805,6.514,20.808,-641,-0.935,39.748,852,888,2770
1981,4522,502,6918,1116889,1121101,490,7.239,192,2.836,102162,56482,45680,5.038,9.113,110313,9136,101177,0.815,9.84,-8151,-0.727,18.225,32,39,566
1981,4523,14601,30012,809605,813930,2364,7.808,2890,9.546,93247,54317,38930,6.673,11.456,101985,25743,76242,3.163,12.53,-8738,-1.074,22.913,1731,1759,5989
1981,4531,20555,21803,102861,103052,2756,12.753,2370,10.967,19503,7251,12252,7.036,18.925,19914,6448,13466,6.257,19.324,-411,-0.399,37.851,1822,1842,4978
1981,4532,23048,27565,163201,159156,4367,16.144,3336,12.333,36991,17504,19487,10.998,23.242,28928,11604,17324,7.291,18.176,8063,5.066,36.352,2543,2582,7919
1981,4533,8607,10206,47595,47277,1568,15.593,1268,12.609,10114,4939,5175,10.447,21.393,9494,3902,5592,8.253,20.082,620,1.311,40.163,996,997,2827
1981,4539,26520,31280,140670,140381,4626,14.871,4282,13.765,33361,14392,18969,10.252,23.765,32823,13881,18942,9.888,23.381,538,0.383,46.763,3141,3251,10380
1981,4541,5314,7062,90659,91323,967,13.764,894,12.725,13966,4965,9001,5.437,15.293,15228,5099,10129,5.584,16.675,-1262,-1.382,30.586,629,633,2359
1981,4542,4295,5498,81594,82769,551,9.964,615,11.121,11150,3660,7490,4.422,13.471,13523,3413,10110,4.124,16.338,-2373,-2.867,26.942,400,403,1536
1981,4543,16565,22097,191920,193470,1914,8.612,2172,9.772,29006,9689,19317,5.008,14.993,31913,10915,20998,5.642,16.495,-2907,-1.503,29.985,1607,1627,7200
1981,4811,1050,2550,290929,297000,328,13.152,216,8.661,17340,4410,12930,1.485,5.838,29030,3704,25326,1.247,9.774,-11690,-3.936,11.677,129,130,1790
1981,4812,428,610,7657,7110,138,23.938,71,12.316,1954,719,1235,10.113,27.482,852,456,396,6.414,11.983,1102,15.499,23.966,58,58,333
1981,4831,450,708,36433,37694,85,12.169,66,9.449,5673,1714,3959,4.547,15.05,7893,1246,6647,3.306,20.94,-2220,-5.89,30.101,37,37,649
1981,4832,399,467,17914,17599,46,9.85,46,9.85,4081,1557,2524,8.847,23.189,3437,1820,1617,10.342,19.53,644,3.659,39.06,30,30,550
1981,4841,20171,25411,490581,502811,4144,16.318,4113,16.196,70121,27814,42307,5.532,13.946,94476,25539,68937,5.079,18.79,-24355,-4.844,27.892,3162,3172,14024
1981,4842,40974,44833,545898,554705,6522,14.48,6936,15.4,88474,32717,55757,5.898,15.95,106082,33894,72188,6.11,19.124,-17608,-3.174,31.9,5409,5423,23327
1981,4851,375,397,24212,25258,39,9.466,69,16.748,1871,350,1521,1.386,7.408,4116,2828,1288,11.196,16.296,-2245,-8.888,14.815,48,48,305
1981,4852,326,707,31322,31175,31,4.4,26,3.691,2307,602,1705,1.931,7.4,2058,974,1084,3.124,6.602,249,0.799,13.203,17,17,134
1981,4853,5706,5763,62449,66004,825,13.91,1161,19.575,10780,3685,7095,5.583,16.332,18150,5894,12256,8.93,27.498,-7370,-11.166,32.665,967,968,4884
1981,4854,3687,3875,94726,93936,352,9.05,381,9.796,15487,6309,9178,6.716,16.487,13888,4824,9064,5.135,14.785,1599,1.702,29.569,322,322,2714
1981,4855,477,509,10059,9715,80,15.905,68,13.519,2108,911,1197,9.377,21.698,1427,467,960,4.807,14.689,681,7.01,29.377,51,51,364
1981,4859,860,912,19478,19364,145,15.908,144,15.798,3846,1439,2407,7.432,19.862,3621,1915,1706,9.89,18.7,225,1.162,37.4,113,113,791
1981,4861,95,335,11921,11463,46,14.33,18,5.607,1917,649,1268,5.662,16.723,996,487,509,4.248,8.689,921,8.035,17.378,4,4,91
1981,4862,241,1179,58896,57358,137,12.162,32,2.841,5379,1726,3653,3.009,9.378,2248,360,1888,0.628,3.919,3131,5.459,7.839,15,15,107
1981,4869,64,258,6666,6836,26,10.058,27,10.445,636,208,428,3.043,9.304,993,139,854,2.034,14.527,-357,-5.223,18.609,7,7,49
1981,4871,162,165,2776,2568,25,15.291,22,13.456,737,249,488,9.696,28.699,339,186,153,7.243,13.201,398,15.498,26.402,18,18,115
1981,4872,691,698,9084,9129,133,19.374,110,16.023,1952,835,1117,9.147,21.382,2017,718,1299,7.865,22.094,-65,-0.712,42.765,83,83,507
1981,4879,48,58,1351,1276,14,24.779,11,19.469,256,78,178,6.113,20.063,96,29,67,2.273,7.524,160,12.539,15.047,10,10,28
1981,4881,2085,2560,55013,54789,399,15.789,333,13.178,9210,3230,5980,5.895,16.81,8893,4355,4538,7.949,16.232,317,0.579,32.463,253,254,2977
1981,4882,333,432,14299,14705,72,17.349,38,9.157,2728,1386,1342,9.425,18.552,3504,863,2641,5.869,23.829,-776,-5.277,37.103,23,23,265
1981,4883,2260,2687,122740,125864,383,14.579,263,10.011,21673,4400,17273,3.496,17.219,27879,4857,23022,3.859,22.15,-6206,-4.931,34.439,181,183,2460
1981,4884,1789,2333,36520,37239,378,15.936,456,19.224,5168,1947,3221,5.228,13.878,6579,2397,4182,6.437,17.667,-1411,-3.789,27.756,326,327,1604
1981,4885,4193,5955,80726,80702,859,14.743,602,10.332,14968,5490,9478,6.803,18.547,15147,4123,11024,5.109,18.769,-179,-0.222,37.094,406,409,2641
1981,4889,368,376,6245,6180,64,17.089,61,16.288,1348,567,781,9.175,21.812,1211,309,902,5,19.595,137,2.217,39.191,45,45,269
1981,4921,1125,1680,72236,72247,367,22.753,233,14.445,6752,2963,3789,4.101,9.346,6858,1682,5176,2.328,9.492,-106,-0.147,18.691,192,193,1195
1981,4922,765,766,4039,3959,294,39.357,256,34.27,1461,1049,412,26.5,36.908,1319,657,662,16.597,33.321,142,3.587,66.641,224,224,562
1981,4931,6433,9950,392738,394331,841,8.569,571,5.818,51441,19992,31449,5.07,13.045,54655,8522,46133,2.161,13.86,-3214,-0.815,26.09,287,289,2030
1981,5111,13249,14953,594762,590409,1794,12.137,1451,9.816,55814,16529,39285,2.8,9.453,47206,14965,32241,2.535,7.995,8608,1.458,15.991,1162,1168,8433
1981,5112,5478,6487,96495,87700,1985,34.127,644,11.072,32008,14946,17062,17.042,36.497,14350,5852,8498,6.673,16.363,17658,20.135,32.725,399,412,2393
1981,5121,8841,14160,196457,194390,1979,14.101,1728,12.313,53768,19191,34577,9.872,27.66,48854,14654,34200,7.538,25.132,4914,2.528,50.264,1006,1048,6872
1981,5122,1554,1558,11434,11188,373,25.297,206,13.971,3312,1379,1933,12.326,29.603,2849,801,2048,7.159,25.465,463,4.138,50.93,143,143,592
1981,5151,5647,6664,201785,197637,666,10.122,497,7.554,29890,11893,17997,6.018,15.124,21742,7495,14247,3.792,11.001,8148,4.123,22.002,387,394,5054
1981,5152,10,10,60,52,5,62.5,(D),(D),19,15,4,29.126,36.893,5,(D),2,(D),9.709,14,27.184,19.417,(D),(D),(D)
1981,5173,2107,13749,979491,976170,429,3.104,575,4.16,210233,5102,205131,0.523,21.537,205219,6620,198599,0.678,21.023,5014,0.514,42.046,200,201,3162
1981,5174,622,1081,57889,43203,178,17.34,69,6.722,32407,3457,28950,8.002,75.012,3388,986,2402,2.282,7.842,29019,67.17,15.684,43,43,639
1981,5179,1016,2092,94663,79034,289,14.132,195,9.535,42275,3651,38624,4.62,53.49,13482,1080,12402,1.367,17.059,28793,36.431,34.117,130,130,699
1981,5182,5512,7229,198137,197896,1407,20.194,884,12.687,39996,17024,22972,8.602,20.211,39782,14762,25020,7.459,20.102,214,0.108,40.205,523,528,4531
1981,5191,2170,2553,29144,28478,240,9.552,159,6.328,4061,1324,2737,4.649,14.26,2751,781,1970,2.742,9.66,1310,4.6,19.32,122,122,559
1981,5211,22,56,25072,24582,4,7.407,0,0,1143,10,1133,0.041,4.65,126,0,126,0,0.513,1017,4.137,1.025,0,0,0
1981,5221,21135,65398,1816080,1777502,3966,6.196,1179,1.842,186031,52206,133825,2.937,10.466,108801,21185,87616,1.192,6.121,77230,4.345,12.242,636,656,8827
1981,5222,23058,42963,348364,350906,3109,7.141,4252,9.767,55085,22015,33070,6.274,15.698,60057,25213,34844,7.185,17.115,-4972,-1.417,31.396,1513,1535,5825
1981,5223,2871,3206,39202,35969,693,22.095,554,17.663,11910,7262,4648,20.19,33.112,5408,2800,2608,7.785,15.035,6502,18.077,30.071,447,455,1943
1981,5231,4932,9351,219459,204391,1569,17.609,687,7.71,45360,11531,33829,5.642,22.193,15246,3665,11581,1.793,7.459,30114,14.734,14.918,467,468,2129
1981,5232,114,129,6436,6145,29,24.167,11,9.167,955,251,704,4.085,15.542,373,281,92,4.573,6.07,582,9.472,12.141,9,9,49
1981,5239,10387,10758,96663,89979,2306,22.28,1490,14.396,31276,11072,20204,12.305,34.759,17710,8024,9686,8.918,19.682,13566,15.077,39.365,1148,1149,4265
1981,5241,6217,30386,1260377,1244636,2471,8.184,2082,6.896,163337,67590,95747,5.431,13.123,131960,39060,92900,3.138,10.602,31377,2.521,21.205,409,438,2717
1981,5242,88540,93254,1080250,1027143,10427,11.255,9204,9.935,258082,50674,207408,4.933,25.126,154187,79399,74788,7.73,15.011,103895,10.115,30.023,6591,6597,48354
1981,5259,612,801,11933,11779,72,9.011,68,8.511,1814,379,1435,3.218,15.401,1551,290,1261,2.462,13.168,263,2.233,26.336,37,38,87
1981,5311,103136,104984,509933,506760,12842,12.104,15071,14.205,114000,53171,60829,10.492,22.496,107530,49064,58466,9.682,21.219,6470,1.277,42.438,12260,12327,36987
1981,5312,33053,34188,180113,178432,5762,16.732,6259,18.175,44995,19291,25704,10.811,25.217,41941,15671,26270,8.783,23.505,3054,1.712,47.011,4892,4914,11779
1981,5313,20480,21055,182916,180594,3713,17.533,3958,18.69,44214,18585,25629,10.291,24.483,39502,17686,21816,9.793,21.873,4712,2.609,43.747,3115,3125,12062
1981,5321,5479,9031,102144,101285,1197,13.303,1131,12.569,19427,7774,11653,7.675,19.181,18147,6827,11320,6.74,17.917,1280,1.264,35.834,710,722,3427
1981,5322,8340,9992,87089,84328,1912,19.532,1506,15.385,23344,10869,12475,12.889,27.683,17899,8066,9833,9.565,21.226,5445,6.457,42.451,1118,1124,5566
1981,5323,2227,2492,17905,17056,448,18.768,238,9.971,5012,2286,2726,13.403,29.386,3264,1140,2124,6.684,19.138,1748,10.249,38.275,172,172,695
1981,5324,3983,4579,48078,47068,800,18.196,435,9.894,11777,4659,7118,9.898,25.021,9656,3590,6066,7.627,20.515,2121,4.506,41.03,303,303,1695
1981,5331,882,933,9577,9795,161,17.265,160,17.158,2204,824,1380,8.412,22.501,2605,1161,1444,11.853,26.595,-401,-4.094,45.003,125,126,523
1981,5411,108919,112065,590063,567401,15599,14.241,10540,9.622,118847,48927,69920,8.623,20.946,73245,29417,43828,5.185,12.909,45602,8.037,25.818,7779,7814,21713
1981,5412,46753,49940,370368,356289,8308,17.086,5679,11.679,76139,35233,40906,9.889,21.37,47859,19283,28576,5.412,13.433,28280,7.937,26.865,4257,4299,14230
1981,5413,44030,47967,650508,631609,8015,17.181,5383,11.539,134448,47512,86936,7.522,21.287,96818,27690,69128,4.384,15.329,37630,5.958,30.658,3840,3875,15813
1981,5414,12388,12618,85798,81982,2919,24.522,1490,12.517,23237,11503,11734,14.031,28.344,15583,5866,9717,7.155,19.008,7654,9.336,38.016,1146,1147,3673
1981,5415,2906,3443,31891,30067,1355,40.178,1214,35.997,12084,6722,5362,22.357,40.191,8387,4945,3442,16.447,27.895,3697,12.296,55.79,1028,1034,3487
1981,5416,15313,15862,161140,160509,3462,21.756,3564,22.397,43399,16775,26624,10.451,27.038,42148,17858,24290,11.126,26.259,1251,0.779,52.518,2900,2911,13263
1981,5417,4389,5457,390731,387181,594,10.832,647,11.799,43860,10536,33324,2.721,11.328,36917,9689,27228,2.502,9.535,6943,1.793,19.07,435,439,2457
1981,5418,19088,20960,254858,249440,3432,16.706,2600,12.656,49319,18886,30433,7.571,19.772,38655,14411,24244,5.777,15.497,10664,4.275,30.993,2015,2027,9156
1981,5419,23970,26142,197710,186958,3672,14.383,2449,9.592,47696,18496,29200,9.893,25.512,25494,9591,15903,5.13,13.636,22202,11.875,27.272,1851,1859,6621
1981,5511,21470,41405,2772589,2717928,4903,12.162,2719,6.745,455964,154354,301610,5.679,16.776,346447,68250,278197,2.511,12.747,109517,4.029,25.493,560,571,5679
1981,5611,4047,4221,61971,62162,532,11.864,1058,23.595,12452,4126,8326,6.638,20.032,12895,5174,7721,8.323,20.744,-443,-0.713,40.063,829,831,3777
1981,5612,172,200,10638,12149,32,14.191,83,36.807,2303,1606,697,13.219,18.956,5305,2247,3058,18.495,43.666,-3002,-24.71,37.913,46,46,540
1981,5613,10219,13606,558463,566786,2577,19.577,1692,12.854,141262,52877,88385,9.329,24.923,158663,32338,126325,5.706,27.993,-17401,-3.07,49.847,1224,1235,17692
1981,5614,18122,20256,206048,200899,3643,18.656,2185,11.19,45318,17968,27350,8.944,22.558,34874,10827,24047,5.389,17.359,10444,5.199,34.718,1651,1669,7690
1981,5615,16601,19407,147311,143866,2720,14.432,1601,8.494,29512,11265,18247,7.83,20.514,22560,7791,14769,5.415,15.681,6952,4.832,31.363,1158,1190,5471
1981,5616,12185,14503,386242,379185,3388,25.086,1393,10.314,95111,41104,54007,10.84,25.083,80892,25599,55293,6.751,21.333,14219,3.75,42.666,1005,1017,12051
1981,5617,50071,52758,659964,651026,11290,21.758,9551,18.407,155712,58149,97563,8.932,23.918,137013,47800,89213,7.342,21.046,18699,2.872,42.091,7600,7623,34810
1981,5619,13215,14079,162105,154178,3407,26.114,1342,10.286,44965,21194,23771,13.746,29.164,29259,9456,19803,6.133,18.977,15706,10.187,37.955,961,965,5489
1981,5621,4503,4651,92812,92903,553,11.707,698,14.777,12641,3975,8666,4.279,13.607,12920,5279,7641,5.682,13.907,-279,-0.3,27.213,583,583,3559
1981,5622,1953,2366,39627,38616,295,12.669,220,9.448,6603,2687,3916,6.958,17.099,4647,1577,3070,4.084,12.034,1956,5.065,24.068,149,149,838
1981,5629,4421,4658,42308,42321,680,14.715,606,13.114,9202,3127,6075,7.389,21.743,9113,2679,6434,6.33,21.533,89,0.21,43.066,463,463,2100
1981,6111,12872,13210,349947,344214,649,4.923,595,4.513,36638,6832,29806,1.985,10.644,25145,6448,18697,1.873,7.305,11493,3.339,14.61,443,446,3986
1981,6112,448,516,35094,34337,30,5.848,24,4.678,4474,984,3490,2.866,13.03,3024,270,2754,0.786,8.807,1450,4.223,17.614,13,13,110
1981,6113,1962,2224,897733,873996,106,4.799,76,3.44,86108,3045,83063,0.348,9.852,37811,1979,35832,0.226,4.326,48297,5.526,8.652,44,46,451
1981,6114,1640,1823,28787,27583,277,15.191,278,15.245,6815,2072,4743,7.512,24.707,4459,1898,2561,6.881,16.166,2356,8.541,32.332,208,213,1031
1981,6115,3506,4007,43784,42848,516,12.926,486,12.174,8990,2936,6054,6.852,20.981,6994,2516,4478,5.872,16.323,1996,4.658,32.646,384,387,1853
1981,6116,9785,10264,91346,89952,1915,18.801,1758,17.26,23154,8440,14714,9.383,25.74,20555,8124,12431,9.031,22.851,2599,2.889,45.702,1417,1427,6439
1981,6117,738,752,20271,20093,140,18.253,170,22.164,2025,689,1336,3.429,10.078,1670,675,995,3.359,8.312,355,1.767,16.623,134,134,500
1981,6211,162123,166584,907233,881242,18397,11.356,9245,5.707,159583,66300,93283,7.523,18.109,107572,30475,77097,3.458,12.207,52011,5.902,24.414,7046,7090,22922
1981,6212,88533,89978,376415,366257,6617,7.46,4055,4.572,64679,21221,43458,5.794,17.659,44310,12279,32031,3.353,12.098,20369,5.561,24.196,3112,3132,9492
1981,6213,33160,34447,107841,102290,5347,16.09,2915,8.772,28102,14006,14096,13.693,27.473,16884,7005,9879,6.848,16.506,11218,10.967,33.012,2210,2219,5435
1981,6214,4555,5775,87149,84559,862,15.458,465,8.339,17154,6737,10417,7.967,20.286,12006,4283,7723,5.065,14.198,5148,6.088,28.397,334,335,2669
1981,6215,3804,4791,61504,59848,564,11.882,475,10.007,10965,3408,7557,5.694,18.322,7607,3387,4220,5.659,12.711,3358,5.611,25.421,321,332,1919
1981,6216,2734,3517,113415,104304,620,18.532,277,8.28,34410,12654,21756,12.132,32.99,15744,3502,12242,3.357,15.094,18666,17.896,30.189,160,160,1127
1981,6219,2755,3157,62220,58626,628,20.968,304,10.15,17459,8147,9312,13.897,29.781,10068,4106,5962,7.004,17.173,7391,12.607,34.347,196,198,2333
1981,6221,3887,4866,2672234,2599672,232,4.803,160,3.313,223702,50248,173454,1.933,8.605,77238,31404,45834,1.208,2.971,146464,5.634,5.942,106,108,22115
1981,6222,326,423,45729,45395,47,11.422,24,5.832,5689,1957,3732,4.311,12.532,4815,3054,1761,6.728,10.607,874,1.925,21.214,16,16,2508
1981,6223,184,216,43347,41994,27,13.012,10,4.819,4209,1014,3195,2.415,10.023,1550,484,1066,1.153,3.691,2659,6.332,7.382,5,5,270
1981,6231,8466,11526,890963,865341,1026,9.076,583,5.157,129632,63748,65884,7.367,14.98,77320,31304,46016,3.618,8.935,52312,6.045,17.87,414,428,21576
1981,6232,3343,4291,96131,90799,675,16.538,256,6.272,20271,8535,11736,9.4,22.325,9641,3695,5946,4.069,10.618,10630,11.707,21.236,198,200,2812
1981,6233,6459,7392,214317,209208,995,13.717,719,9.912,35820,15037,20783,7.188,17.122,25730,12544,13186,5.996,12.299,10090,4.823,24.598,521,532,9163
1981,6239,2485,2988,77453,74910,321,10.978,193,6.601,11607,4800,6807,6.408,15.495,6497,2052,4445,2.739,8.673,5110,6.822,17.346,136,137,1468
1981,6241,11236,15484,250992,243024,1752,11.589,1020,6.747,48832,14337,34495,5.899,20.093,32974,6440,26534,2.65,13.568,15858,6.525,27.136,636,643,3248
1981,6242,3186,3800,40654,39705,438,11.8,262,7.058,7546,2272,5274,5.722,19.005,5649,1589,4060,4.002,14.227,1897,4.778,28.455,172,172,861
1981,6243,3377,4942,226521,225293,608,12.552,412,8.505,43752,13614,30138,6.043,19.42,40505,7310,33195,3.245,17.979,3247,1.441,35.958,198,201,2336
1981,6244,24959,29268,246438,243542,4033,14.025,3009,10.464,47816,20118,27698,8.261,19.634,41984,14861,27123,6.102,17.239,5832,2.395,34.478,2323,2345,10127
1981,7111,4918,4951,61361,59835,942,19.28,812,16.619,18269,7191,11078,12.018,30.532,15278,3981,11297,6.653,25.534,2991,4.999,51.067,587,587,2484
1981,7112,2066,2163,58601,58795,366,16.855,383,17.638,12480,5421,7059,9.22,21.226,12886,4790,8096,8.147,21.917,-406,-0.691,42.453,297,298,3329
1981,7113,2106,2142,47899,47473,340,15.799,360,16.729,8421,2593,5828,5.462,17.739,7586,2290,5296,4.824,15.98,835,1.759,31.959,253,257,1451
1981,7114,979,997,9773,9192,193,19.825,146,14.997,3358,2175,1183,23.662,36.532,2219,928,1291,10.096,24.141,1139,12.391,48.281,113,113,591
1981,7115,5077,5108,26784,25466,1570,32.535,1005,20.827,10667,4874,5793,19.14,41.888,7949,3189,4760,12.523,31.215,2718,10.673,62.43,723,723,2260
1981,7121,1589,1666,32067,31140,76,4.475,141,8.301,4776,313,4463,1.005,15.337,3030,607,2423,1.949,9.73,1746,5.607,19.461,100,100,286
1981,7131,1528,1807,49769,50372,369,21.447,196,11.392,5569,1784,3785,3.542,11.056,6603,821,5782,1.63,13.108,-1034,-2.053,22.111,160,162,635
1981,7132,612,628,17584,18230,115,18.76,85,13.866,3345,1450,1895,7.954,18.349,4577,1451,3126,7.959,25.107,-1232,-6.758,36.698,69,69,1261
1981,7139,29953,31644,450501,441464,3917,12.536,3122,9.992,85780,33637,52143,7.619,19.431,67390,18926,48464,4.287,15.265,18390,4.166,30.53,2316,2331,12721
1981,7211,28970,32929,1048731,1037832,3900,11.801,4136,12.516,192768,92290,100478,8.893,18.574,171237,59438,111799,5.727,16.499,21531,2.075,32.999,3109,3141,39985
1981,7212,3333,3546,18075,17988,466,13.184,443,12.534,4217,1608,2609,8.94,23.444,4052,1423,2629,7.911,22.527,165,0.917,45.054,313,313,1036
1981,7213,5317,5399,30548,31016,336,6.118,522,9.505,4142,1007,3135,3.247,13.355,5053,2307,2746,7.438,16.292,-911,-2.937,26.709,382,383,1885
1981,7223,16258,25699,475521,470369,4325,17.076,3582,14.143,112451,58605,53846,12.459,23.907,101449,42757,58692,9.09,21.568,11002,2.339,43.136,2085,2100,17859
1981,7224,63124,63897,348498,348301,9446,14.642,10676,16.549,95303,49915,45388,14.331,27.362,94717,43331,51386,12.441,27.194,586,0.168,54.388,8301,8326,33020
1981,7225,177921,227048,3846006,3806665,37092,16.494,32773,14.573,846718,489296,357422,12.854,22.243,768424,314484,453940,8.261,20.186,78294,2.057,40.373,24384,24969,219665
1981,8111,88401,92195,421237,423221,14073,15.307,13563,14.752,91712,44801,46911,10.586,21.67,95822,40090,55732,9.473,22.641,-4110,-0.971,43.34,10406,10452,31132
1981,8112,9757,10829,64894,64052,1270,11.589,1530,13.961,13254,6636,6618,10.36,20.693,11762,4944,6818,7.719,18.363,1492,2.329,36.727,1202,1203,3006
1981,8113,17090,18138,148245,144863,2612,14.586,2150,12.006,30689,11735,18954,8.101,21.185,23971,8307,15664,5.734,16.547,6718,4.637,33.095,1596,1598,5817
1981,8114,22280,23832,142395,142658,3605,15.12,3626,15.208,27315,11336,15979,7.946,19.147,27829,10484,17345,7.349,19.508,-514,-0.36,38.295,2737,2741,7516
1981,8121,80945,89123,400903,404273,11454,12.74,13021,14.483,80271,39321,40950,9.726,19.856,86569,37525,49044,9.282,21.414,-6298,-1.558,39.711,10283,10406,29029
1981,8122,17404,19819,110611,109562,1276,6.419,1394,7.013,16574,5020,11554,4.582,15.128,14386,4407,9979,4.022,13.131,2188,1.997,26.261,984,1016,3221
1981,8123,32723,38373,331961,333176,3935,10.195,4384,11.358,49152,19644,29508,5.896,14.753,51513,20356,31157,6.11,15.461,-2361,-0.709,29.505,3335,3477,15191
1981,8129,14373,20490,224871,206923,4073,20.59,2656,13.427,66843,28597,38246,13.82,32.303,31609,14278,17331,6.9,15.276,35234,17.028,30.551,1566,1620,8167
1981,8131,72023,72114,673824,664742,4351,6.093,2944,4.123,89672,18354,71318,2.761,13.49,71811,10468,61343,1.575,10.803,17861,2.687,21.606,1237,1237,4260
1981,8132,6979,7968,127958,126438,891,11.39,600,7.67,23668,7119,16549,5.63,18.719,20521,6067,14454,4.798,16.23,3147,2.489,32.46,408,409,2880
1981,8133,6764,7877,102062,101085,959,12.415,654,8.467,20913,8343,12570,8.253,20.689,19023,4860,14163,4.808,18.819,1890,1.87,37.638,417,425,3219
1981,8134,27875,29136,238005,236888,1769,6.078,1709,5.872,34153,7636,26517,3.223,14.417,31747,5188,26559,2.19,13.402,2406,1.016,26.803,1215,1215,3524
1981,8139,54294,56428,412024,417215,4230,7.488,4357,7.713,67828,16927,50901,4.057,16.257,77998,20135,57863,4.826,18.695,-10170,-2.438,32.515,3220,3225,14838
1982,1131,191,199,4200,4243,30,14.599,43,20.925,510,234,276,5.516,12.021,601,274,327,6.458,14.166,-91,-2.145,24.042,29,29,122
1982,1132,83,98,1660,1310,17,17.347,17,17.347,919,54,865,4.122,70.153,203,88,115,6.718,15.496,716,54.656,30.992,10,10,47
1982,1133,9889,10000,79589,84483,1259,12.072,2117,20.299,15006,5109,9897,6.047,17.762,24714,8091,16623,9.577,29.253,-9708,-11.491,35.524,1444,1444,5666
1982,1141,1360,1398,9813,9775,245,17.351,273,19.334,3320,1044,2276,10.681,33.966,3219,1236,1983,12.645,32.933,101,1.033,65.865,212,212,1009
1982,1142,121,122,502,505,17,13.71,21,16.935,150,87,63,17.245,29.732,157,90,67,17.839,31.12,-7,-1.388,59.465,17,17,37
1982,1151,3990,4423,54788,53447,621,14.125,568,12.919,16377,6166,10211,11.537,30.642,13604,4350,9254,8.139,25.453,2773,5.188,50.907,388,392,3022
1982,1152,1605,1622,11379,11028,265,16.399,253,15.656,2849,1134,1715,10.283,25.835,2142,921,1221,8.352,19.424,707,6.411,38.848,198,198,656
1982,1153,684,697,9437,9365,136,19.332,149,21.18,3277,1927,1350,20.578,34.994,3219,1305,1914,13.936,34.374,58,0.619,68.749,99,99,870
1982,2111,7505,9554,184118,174027,1733,18.853,1009,10.977,51735,18504,33231,10.633,29.728,31552,11874,19678,6.823,18.131,20183,11.598,36.261,617,631,4023
1982,2121,3131,3865,240218,236975,813,21.358,696,18.285,42364,16048,26316,6.772,17.877,35389,13886,21503,5.86,14.934,6975,2.943,29.867,485,487,6422
1982,2122,665,843,70103,78310,206,24.775,183,22.008,5314,2538,2776,3.241,6.786,21849,3565,18284,4.552,27.901,-16535,-21.115,13.572,117,117,1241
1982,2123,3558,5014,104328,109413,341,6.721,460,9.067,14431,2835,11596,2.591,13.19,24849,5320,19529,4.862,22.711,-10418,-9.522,26.379,267,267,1809
1982,2131,11985,13611,414246,386486,3657,28.927,1719,13.598,143538,49544,93994,12.819,37.139,88720,37361,51359,9.667,22.956,54818,14.184,45.911,1259,1263,19031
1982,2211,1569,5731,569960,559635,108,1.886,97,1.694,34788,3719,31069,0.665,6.216,14351,2631,11720,0.47,2.564,20437,3.652,5.129,42,42,517
1982,2212,529,2349,141884,140604,74,3.164,54,2.309,8580,2543,6037,1.809,6.102,6168,715,5453,0.509,4.387,2412,1.715,8.774,28,28,153
1982,2213,3851,4153,32760,33264,276,6.638,286,6.878,3081,840,2241,2.525,9.262,4019,1852,2167,5.568,12.082,-938,-2.82,18.525,212,212,1097
1982,2361,79271,79675,406036,457846,12822,14.849,26174,30.311,114203,46785,67418,10.219,24.944,217747,96294,121453,21.032,47.559,-103544,-22.615,49.887,18247,18249,71417
1982,2362,32035,32616,596790,617574,4209,12.656,5490,16.508,133490,32377,101113,5.243,21.615,175610,37314,138296,6.042,28.435,-42120,-6.82,43.23,3863,3865,27914
1982,2371,12923,13280,345090,348776,1494,11.069,1929,14.292,73975,14604,59371,4.187,21.21,81012,17221,63791,4.938,23.228,-7037,-2.018,42.42,1372,1376,10237
1982,2372,6887,6977,46686,50208,1663,23.358,1948,27.361,14453,7597,6856,15.131,28.786,21581,10225,11356,20.365,42.983,-7128,-14.197,57.572,1442,1442,6880
1982,2373,9612,9869,189639,202228,866,8.57,1338,13.241,34555,7484,27071,3.701,17.087,59787,10647,49140,5.265,29.564,-25232,-12.477,34.174,927,928,6494
1982,2379,4373,4430,97514,97394,695,15.318,909,20.035,30371,7596,22775,7.799,31.184,30069,4373,25696,4.49,30.874,302,0.31,61.747,639,639,2900
1982,2381,58909,59326,502924,528266,7518,12.18,12310,19.944,131011,36947,94064,6.994,24.8,182143,56875,125268,10.766,34.479,-51132,-9.679,49.6,8204,8210,38815
1982,2382,92982,94900,964361,979592,11195,11.675,13168,13.733,198703,48935,149768,4.995,20.284,229973,56736,173237,5.792,23.476,-31270,-3.192,40.569,9651,9655,42669
1982,2383,60643,61074,457508,482837,8984,14.138,13929,21.919,117103,36549,80554,7.57,24.253,167749,51960,115789,10.761,34.742,-50646,-10.489,48.506,9662,9665,38098
1982,2389,32695,32897,288194,296229,4606,13.748,5817,17.363,72643,22369,50274,7.551,24.523,88259,24130,64129,8.146,29.794,-15616,-5.272,49.045,4026,4027,17650
1982,3111,1380,2028,57687,58699,108,5.263,156,7.602,6301,2237,4064,3.811,10.734,8223,2695,5528,4.591,14.009,-1922,-3.274,21.469,88,88,749
1982,3112,525,886,82116,83005,50,5.583,69,7.705,7093,2160,4933,2.602,8.545,8787,1953,6834,2.353,10.586,-1694,-2.041,17.091,43,43,657
1982,3113,1352,1720,92963,92191,205,12.066,163,9.594,12641,1433,11208,1.554,13.712,11030,3329,7701,3.611,11.964,1611,1.747,23.929,77,77,643
1982,3114,1192,1640,170715,174234,96,5.767,145,8.711,16915,3113,13802,1.787,9.708,23971,5928,18043,3.402,13.758,-7056,-4.05,19.416,83,84,1909
1982,3115,1843,2578,139800,140987,100,3.805,200,7.61,12893,2432,10461,1.725,9.145,15331,4165,11166,2.954,10.874,-2438,-1.729,18.29,123,123,1256
1982,3116,4184,4758,298396,300236,326,6.749,471,9.751,31660,7609,24051,2.534,10.545,35501,11527,23974,3.839,11.824,-3841,-1.279,21.09,337,342,4086
1982,3117,789,914,53745,53541,81,8.752,104,11.237,10408,1935,8473,3.614,19.439,9715,2913,6802,5.441,18.145,693,1.294,36.29,60,60,1047
1982,3118,8278,9793,302524,299843,1217,12.491,1117,11.465,37663,11353,26310,3.786,12.561,31914,11861,20053,3.956,10.644,5749,1.917,21.287,769,792,6291
1982,3119,2003,2380,124964,122827,249,10.609,183,7.797,18379,4119,14260,3.353,14.963,13899,3506,10393,2.854,11.316,4480,3.647,22.632,133,134,1205
1982,3121,2039,2612,179893,181404,157,5.908,248,9.332,16254,3960,12294,2.183,8.96,19172,5951,13221,3.281,10.569,-2918,-1.609,17.92,177,179,2808
1982,3122,107,169,45670,46657,9,5.233,15,8.721,2312,207,2105,0.444,4.955,4207,913,3294,1.957,9.017,-1895,-4.062,9.911,6,6,53
1982,3131,448,687,107383,112591,32,4.578,56,8.011,6982,2898,4084,2.574,6.201,17253,4355,12898,3.868,15.324,-10271,-9.122,12.402,27,27,956
1982,3132,1696,2100,313595,325822,128,6.025,177,8.331,15516,4209,11307,1.292,4.762,40143,7345,32798,2.254,12.321,-24627,-7.558,9.524,124,124,2292
1982,3133,1550,1777,108209,112924,124,6.933,147,8.219,7734,2019,5715,1.788,6.849,17336,4576,12760,4.052,15.352,-9602,-8.503,13.698,98,99,2156
1982,3141,3965,4229,104202,108508,424,9.766,649,14.949,11018,3399,7619,3.133,10.154,19619,5604,14015,5.165,18.081,-8601,-7.927,20.308,507,511,3577
1982,3149,3366,3496,126975,127676,365,10.324,444,12.558,19905,5754,14151,4.507,15.59,21554,6858,14696,5.371,16.882,-1649,-1.292,31.181,357,358,4211
1982,3151,1355,1477,138504,141761,94,6.25,148,9.84,12324,2737,9587,1.931,8.694,18932,3379,15553,2.384,13.355,-6608,-4.661,17.387,115,115,1856
1982,3152,15210,17013,1054356,1069699,1900,11.107,2088,12.206,138953,45332,93621,4.238,12.99,169112,57788,111324,5.402,15.809,-30159,-2.819,25.98,1674,1692,36986
1982,3159,1738,1852,70537,73580,191,10.211,228,12.189,8592,2277,6315,3.095,11.677,14830,3616,11214,4.914,20.155,-6238,-8.478,23.354,175,178,2345
1982,3161,350,394,19603,20333,34,8.553,41,10.314,2132,713,1419,3.507,10.486,3580,850,2730,4.18,17.607,-1448,-7.122,20.971,28,28,496
1982,3162,510,744,136740,141164,63,8.422,71,9.492,12865,2910,9955,2.061,9.114,21916,4693,17223,3.325,15.525,-9051,-6.412,18.227,45,46,1999
1982,3169,1305,1350,55286,56400,135,9.912,159,11.674,6994,1480,5514,2.624,12.401,9196,2329,6867,4.129,16.305,-2202,-3.904,24.802,132,132,1356
1982,3211,4970,5507,124767,137112,401,6.976,884,15.378,12861,5075,7786,3.701,9.38,37781,8979,28802,6.549,27.555,-24920,-18.175,18.76,614,615,4569
1982,3212,990,1293,79807,87397,71,5.312,158,11.822,5356,1634,3722,1.87,6.128,20723,4315,16408,4.937,23.711,-15367,-17.583,12.257,113,113,1442
1982,3219,8458,9179,231709,247089,938,10.095,1163,12.517,28119,9438,18681,3.82,11.38,58679,16760,41919,6.783,23.748,-30560,-12.368,22.76,832,833,8618
1982,3221,268,608,203555,207319,14,2.233,52,8.293,5756,838,4918,0.404,2.776,13184,2546,10638,1.228,6.359,-7428,-3.583,5.553,20,20,288
1982,3222,3622,5213,397285,403416,245,4.685,278,5.316,31196,4799,26397,1.19,7.733,43287,8005,35282,1.984,10.73,-12091,-2.997,15.466,177,183,2596
1982,3231,33378,34910,681472,680725,3904,11.332,2988,8.673,84268,22640,61628,3.326,12.379,82705,25864,56841,3.799,12.15,1563,0.23,24.299,2324,2329,15061
1982,3241,1485,2370,293233,314341,200,8.451,193,8.156,15253,3284,11969,1.045,4.852,58020,10069,47951,3.203,18.458,-42767,-13.605,9.705,99,103,1939
1982,3251,1138,2222,233160,233275,194,8.743,188,8.472,17378,4778,12600,2.048,7.45,17728,3102,14626,1.33,7.6,-350,-0.15,14.899,97,97,852
1982,3252,358,597,148267,152037,46,7.686,49,8.187,5983,1773,4210,1.166,3.935,13502,3594,9908,2.364,8.881,-7519,-4.946,7.87,24,24,238
1982,3253,731,1083,53822,54824,71,6.49,93,8.501,3903,1534,2369,2.798,7.119,5874,1686,4188,3.075,10.714,-1971,-3.595,14.238,52,52,401
1982,3254,958,1192,157298,158053,93,7.841,81,6.83,13735,2040,11695,1.291,8.69,15213,4292,10921,2.716,9.625,-1478,-0.935,17.38,43,43,728
1982,3255,1640,2085,73156,75576,119,5.667,149,7.095,5744,1280,4464,1.694,7.6,10606,2850,7756,3.771,14.034,-4862,-6.433,15.201,89,89,847
1982,3256,1994,2246,123118,123207,155,6.81,215,9.446,13662,4352,9310,3.532,11.089,13874,3550,10324,2.881,11.261,-212,-0.172,22.177,145,147,1723
1982,3259,1635,2127,84434,84880,217,10.262,192,9.08,9864,3551,6313,4.184,11.621,10795,3293,7502,3.88,12.718,-931,-1.097,23.242,96,96,662
1982,3261,9949,11415,493049,503414,1043,9.182,931,8.196,59235,19223,40012,3.819,11.767,79836,21204,58632,4.212,15.859,-20601,-4.092,23.533,657,664,9618
1982,3262,1867,2235,184604,190289,172,7.71,164,7.351,10723,2297,8426,1.207,5.635,22306,4059,18247,2.133,11.722,-11583,-6.087,11.27,109,109,1147
1982,3271,1301,1593,76133,81941,176,10.901,219,13.565,6486,2455,4031,2.996,7.915,18168,3683,14485,4.495,22.172,-11682,-14.257,15.831,151,151,1020
1982,3272,1463,1741,155574,163699,176,10.069,190,10.87,9063,2538,6525,1.55,5.536,25288,3991,21297,2.438,15.448,-16225,-9.912,11.073,135,137,1421
1982,3273,7213,9135,165967,175192,565,6.118,764,8.273,20680,5685,14995,3.245,11.804,39334,7843,31491,4.477,22.452,-18654,-10.648,23.608,507,515,4873
1982,3274,237,336,16266,17417,34,9.841,53,15.34,715,359,356,2.061,4.105,3069,555,2514,3.187,17.621,-2354,-13.516,8.211,39,39,165
1982,3279,1832,2103,79179,83430,153,7.165,218,10.208,5968,1814,4154,2.174,7.153,14463,2887,11576,3.46,17.336,-8495,-10.182,14.307,150,154,1325
1982,3311,289,327,186033,200502,57,18.476,20,6.483,3725,794,2931,0.396,1.858,32419,436,31983,0.217,16.169,-28694,-14.311,3.716,9,9,144
1982,3312,520,695,75042,79013,42,6.03,45,6.461,4704,1226,3478,1.552,5.953,12670,1533,11137,1.94,16.035,-7966,-10.082,11.907,25,25,419
1982,3313,428,672,127232,134155,31,4.606,33,4.903,5791,1322,4469,0.985,4.317,19633,2513,17120,1.873,14.635,-13842,-10.318,8.633,12,12,258
1982,3314,739,909,92222,98653,99,10.832,109,11.926,4911,1074,3837,1.089,4.978,17439,2983,14456,3.024,17.677,-12528,-12.699,9.956,78,79,1123
1982,3315,2834,3196,253529,268801,147,4.538,233,7.194,16289,4035,12254,1.501,6.06,47019,9191,37828,3.419,17.492,-30730,-11.432,12.12,165,165,2803
1982,3321,3130,3347,147601,154506,220,6.601,192,5.761,11617,2362,9255,1.529,7.519,25407,5744,19663,3.718,16.444,-13790,-8.925,15.038,138,138,2147
1982,3322,1198,1333,88164,92524,87,6.529,86,6.454,4935,721,4214,0.779,5.334,13556,1801,11755,1.947,14.651,-8621,-9.318,10.668,59,59,388
1982,3323,9948,10816,356411,371588,795,7.304,931,8.554,40231,10103,30128,2.719,10.827,70603,15095,55508,4.062,19,-30372,-8.174,21.654,680,682,6504
1982,3324,1469,1857,149846,153426,110,5.909,119,6.393,12718,3058,9660,1.993,8.289,19933,2465,17468,1.607,12.992,-7215,-4.703,16.579,76,76,1025
1982,3325,887,963,71318,77348,83,8.628,81,8.42,5180,2733,2447,3.533,6.697,17475,3783,13692,4.891,22.593,-12295,-15.896,13.394,46,46,630
1982,3326,1556,1765,62930,66849,112,6.331,120,6.783,6440,1933,4507,2.892,9.634,14504,5872,8632,8.784,21.697,-8064,-12.063,19.267,87,88,4815
1982,3327,20919,21242,330026,337632,2363,11.235,1944,9.243,42338,13246,29092,3.923,12.54,57539,14556,42983,4.311,17.042,-15201,-4.502,25.079,1539,1540,9135
1982,3328,5316,5614,117965,119966,420,7.47,437,7.772,14930,3823,11107,3.187,12.445,18864,4227,14637,3.524,15.725,-3934,-3.279,24.89,330,332,2306
1982,3329,5306,5863,364359,369640,636,11.056,415,7.214,35426,11948,23478,3.232,9.584,46396,9387,37009,2.54,12.552,-10970,-2.968,19.168,282,282,2671
1982,3331,3332,3810,374688,383246,412,10.908,346,9.161,37711,7309,30402,1.907,9.84,54834,9755,45079,2.545,14.308,-17123,-4.468,19.68,241,241,4222
1982,3332,3673,3941,179679,189317,270,6.866,253,6.434,13325,3649,9676,1.927,7.038,32408,5709,26699,3.016,17.118,-19083,-10.08,14.077,182,182,1940
1982,3333,1973,2108,174577,177442,160,7.583,164,7.773,18001,5930,12071,3.342,10.145,23399,3750,19649,2.113,13.187,-5398,-3.042,20.289,109,109,1086
1982,3334,1928,2164,172123,180406,205,9.384,246,11.261,17000,6295,10705,3.489,9.423,33465,9335,24130,5.174,18.55,-16465,-9.127,18.846,178,180,1785
1982,3335,9413,9884,261827,272640,729,7.374,733,7.415,22379,6776,15603,2.485,8.208,43817,10881,32936,3.991,16.071,-21438,-7.863,16.417,564,564,4269
1982,3336,718,880,168654,174025,42,4.781,39,4.439,9377,1123,8254,0.645,5.388,19830,1199,18631,0.689,11.395,-10453,-6.007,10.777,28,28,396
1982,3339,5376,5971,353220,363202,469,7.867,450,7.548,28634,6536,22098,1.8,7.884,48367,8247,40120,2.271,13.317,-19733,-5.433,15.768,316,317,4444
1982,3341,1405,1656,404773,397303,311,19.866,130,8.304,51642,12191,39451,3.068,12.998,36681,5344,31337,1.345,9.233,14961,3.766,18.465,93,93,1276
1982,3342,1751,1903,201692,198992,243,13.05,161,8.647,29816,7985,21831,4.013,14.984,24383,6945,17438,3.49,12.253,5433,2.73,24.507,104,104,1927
1982,3343,422,453,51933,54608,47,10.151,67,14.471,4385,741,3644,1.357,8.03,9776,1692,8084,3.098,17.902,-5391,-9.872,16.06,52,52,527
1982,3344,3845,4359,466778,468041,599,14.066,398,9.346,53469,14338,39131,3.063,11.424,56161,12761,43400,2.726,11.999,-2692,-0.575,22.848,279,280,5558
1982,3345,3732,4288,637514,631409,421,9.926,328,7.733,68378,11458,56920,1.815,10.829,56089,16262,39827,2.576,8.883,12289,1.946,17.766,217,217,2986
1982,3346,577,600,16692,17842,101,17.265,71,12.137,3182,1435,1747,8.043,17.835,5403,1748,3655,9.797,30.283,-2221,-12.449,35.67,51,51,509
1982,3351,1195,1322,84639,87474,86,6.452,108,8.102,6580,1300,5280,1.486,7.522,12391,2615,9776,2.989,14.165,-5811,-6.643,15.045,81,83,1301
1982,3352,354,464,122513,134078,38,8.234,33,7.151,3953,620,3333,0.462,2.948,27218,1930,25288,1.439,20.3,-23265,-17.352,5.897,19,19,132
1982,3353,1971,2499,277537,284536,191,7.699,155,6.247,24211,6082,18129,2.138,8.509,38462,4861,33601,1.708,13.517,-14251,-5.009,17.018,95,95,1430
1982,3359,1681,2026,189820,192738,212,10.656,139,6.987,18203,3893,14310,2.02,9.444,23944,4269,19675,2.215,12.423,-5741,-2.979,18.889,96,96,1160
1982,3361,175,233,220451,229699,32,13.793,30,12.931,19367,3108,16259,1.353,8.431,38048,2656,35392,1.156,16.564,-18681,-8.133,16.863,20,20,221
1982,3362,1621,1794,97151,101611,147,8.031,220,12.019,9794,1856,7938,1.827,9.639,18655,4982,13673,4.903,18.359,-8861,-8.721,19.278,159,159,1564
1982,3363,3478,4204,555263,586659,311,7.366,347,8.219,30988,5340,25648,0.91,5.282,95296,8237,87059,1.404,16.244,-64308,-10.962,10.564,245,245,3046
1982,3364,1206,1435,648682,668150,108,7.568,92,6.447,48472,13672,34800,2.046,7.255,85737,33493,52244,5.013,12.832,-37265,-5.577,14.509,71,71,983
1982,3365,178,207,43845,51609,13,6.235,16,7.674,914,460,454,0.891,1.771,16264,5801,10463,11.24,31.514,-15350,-29.743,3.542,4,4,40
1982,3366,1129,1229,199755,205259,119,9.616,136,10.99,18095,2731,15364,1.331,8.816,28985,4310,24675,2.1,14.121,-10890,-5.305,17.631,97,99,1940
1982,3369,398,409,28960,29760,60,14.354,78,18.66,2818,1357,1461,4.56,9.469,4258,2228,2030,7.487,14.308,-1440,-4.839,18.938,58,58,692
1982,3371,11614,12202,335406,353351,1313,10.564,1766,14.209,33138,11160,21978,3.158,9.378,68737,19803,48934,5.604,19.453,-35599,-10.075,18.756,1339,1347,11640
1982,3372,2333,2461,118339,120729,201,8.095,245,9.867,12371,2882,9489,2.387,10.247,16958,4255,12703,3.524,14.046,-4587,-3.799,20.494,188,189,2447
1982,3379,1047,1177,36233,37704,86,7.212,117,9.811,3660,1167,2493,3.095,9.707,6578,1774,4804,4.705,17.446,-2918,-7.739,19.414,97,97,937
1982,3391,9485,10032,213409,211901,1297,13.092,1047,10.568,28309,9480,18829,4.474,13.36,25368,7644,17724,3.607,11.972,2941,1.388,23.943,794,798,3231
1982,3399,13983,14625,405888,415209,1758,12.014,1775,12.13,56261,18064,38197,4.351,13.55,74739,20755,53984,4.999,18,-18478,-4.45,27.1,1378,1381,11842
1982,4231,22852,28245,303911,309350,2534,8.905,2953,10.378,42586,14342,28244,4.636,13.766,53309,18551,34758,5.997,17.233,-10723,-3.466,27.533,1869,1927,9857
1982,4232,7708,8878,97848,98806,1064,11.969,1087,12.228,17789,5751,12038,5.82,18.004,19541,8102,11439,8.2,19.777,-1752,-1.773,36.008,694,703,3340
1982,4233,7468,9526,105479,110086,993,10.286,1248,12.928,16484,5350,11134,4.86,14.974,25675,7575,18100,6.881,23.323,-9191,-8.349,29.947,778,788,3849
1982,4234,18935,26046,436166,433605,4033,15.913,2630,10.377,86442,34078,52364,7.859,19.936,82097,28224,53873,6.509,18.934,4345,1.002,37.867,1575,1595,8750
1982,4235,6437,9003,137499,139302,949,10.594,859,9.589,20253,6330,13923,4.544,14.539,23861,6860,17001,4.925,17.129,-3608,-2.59,29.078,481,483,3220
1982,4236,13824,20135,259438,256875,2400,12.046,1978,9.928,50895,18107,32788,7.049,19.813,45475,15785,29690,6.145,17.703,5420,2.11,35.406,1199,1240,7114
1982,4237,10535,13739,150359,151681,1174,8.541,1186,8.629,22618,7253,15365,4.782,14.912,25295,7741,17554,5.103,16.676,-2677,-1.765,29.823,790,811,5312
1982,4238,46767,61076,673989,682437,5901,9.723,5128,8.45,99496,31977,67519,4.686,14.58,116679,35129,81550,5.148,17.097,-17183,-2.518,29.159,3230,3287,17890
1982,4239,20954,22606,210195,214531,3302,14.576,3397,14.995,41582,16021,25561,7.468,19.383,50099,16517,33582,7.699,23.353,-8517,-3.97,38.765,2584,2613,11660
1982,4241,7392,9904,143147,141126,1060,10.832,823,8.41,26556,5897,20659,4.179,18.817,22281,7771,14510,5.506,15.788,4275,3.029,31.576,478,490,3236
1982,4242,2574,3288,91026,90129,421,12.789,429,13.032,15888,5944,9944,6.595,17.628,14091,5002,9089,5.55,15.634,1797,1.994,31.269,298,300,1930
1982,4243,10529,11433,120507,119693,1661,14.625,1509,13.287,27331,9298,18033,7.768,22.834,25989,10804,15185,9.026,21.713,1342,1.121,43.426,1100,1114,5453
1982,4244,26071,32087,575205,569683,3448,10.731,3534,10.999,96579,32528,64051,5.71,16.953,85585,29991,55594,5.265,15.023,10994,1.93,30.047,2499,2533,17261
1982,4245,8992,12181,111822,111700,742,6.037,962,7.827,18257,4614,13643,4.131,16.345,18118,5085,13033,4.552,16.22,139,0.124,32.44,630,653,3615
1982,4246,6585,9735,120408,118596,1175,12.275,850,8.88,22489,6198,16291,5.226,18.963,18641,6467,12174,5.453,15.718,3848,3.245,31.436,450,452,2142
1982,4247,12145,15729,164259,164184,1246,7.804,1720,10.773,34563,9066,25497,5.522,21.051,34448,11983,22465,7.299,20.981,115,0.07,41.963,889,917,5924
1982,4248,4678,5854,136638,136330,328,5.563,412,6.988,15394,4516,10878,3.313,11.292,14830,4473,10357,3.281,10.878,564,0.414,21.756,287,291,2543
1982,4249,18491,22663,240156,242319,2549,11.22,2661,11.713,42231,15225,27006,6.283,17.428,46893,15556,31337,6.42,19.352,-4662,-1.924,34.856,1853,1870,7826
1982,4251,28084,30827,288817,289417,3770,12.401,2917,9.595,51135,16765,34370,5.793,17.668,52339,17939,34400,6.198,18.084,-1204,-0.416,35.337,1816,1820,9097
1982,4411,36653,37621,733916,743736,3208,8.378,4552,11.887,88987,30016,58971,4.036,11.965,108389,40583,67806,5.457,14.574,-19402,-2.609,23.93,3681,3705,34253
1982,4412,11054,11442,70145,71450,1134,9.696,1640,14.023,14032,4838,9194,6.771,19.639,16679,6747,9932,9.443,23.344,-2647,-3.705,39.278,1263,1273,5224
1982,4413,43092,63180,407976,398080,8639,14.069,5085,8.281,88561,46428,42133,11.663,22.247,70231,21650,48581,5.439,17.642,18330,4.605,35.285,3140,3246,12697
1982,4421,22290,26690,202490,207431,2534,9.355,3329,12.29,32688,11166,21522,5.383,15.759,42573,13916,28657,6.709,20.524,-9885,-4.765,31.517,2423,2499,9773
1982,4422,19135,22618,118575,119996,3146,13.882,3234,14.271,26109,11110,14999,9.259,21.758,28751,10684,18067,8.904,23.96,-2642,-2.202,43.517,2374,2449,7206
1982,4431,23161,30463,172984,173593,4763,15.608,4871,15.962,40660,19646,21014,11.317,23.423,41924,18995,22929,10.942,24.151,-1264,-0.728,46.845,3097,3300,11893
1982,4441,54890,69372,612071,625056,5444,7.784,6571,9.396,85460,30977,54483,4.956,13.672,111790,32753,79037,5.24,17.885,-26330,-4.212,27.345,4549,4666,19101
1982,4442,13760,16721,117349,118592,1487,8.839,1690,10.046,19815,6245,13570,5.266,16.709,22340,6934,15406,5.847,18.838,-2525,-2.129,33.417,1223,1229,4572
1982,4451,64840,109693,1822514,1813911,11507,10.478,11754,10.703,294175,116647,177528,6.431,16.218,274071,104232,169839,5.746,15.109,20104,1.108,30.219,7802,7911,44624
1982,4452,22659,28030,170308,169417,4080,14.55,4102,14.629,40677,18579,22098,10.966,24.01,38769,16592,22177,9.794,22.884,1908,1.126,45.768,3030,3082,11901
1982,4453,28725,34225,166586,164817,4353,12.82,3810,11.221,36974,17446,19528,10.585,22.433,33489,12471,21018,7.567,20.319,3485,2.114,40.638,3004,3052,9907
1982,4461,43284,64205,554433,550957,6029,9.474,4895,7.692,89534,36067,53467,6.546,16.251,81731,25033,56698,4.544,14.834,7803,1.416,29.669,3285,3354,15784
1982,4471,100019,130796,764374,775664,14889,11.094,21714,16.179,169472,71314,98158,9.194,21.849,191135,87072,104063,11.225,24.641,-21663,-2.793,43.697,15547,15963,58953
1982,4481,58944,97300,784357,783299,11437,11.73,11845,12.148,154170,67798,86372,8.655,19.682,150805,54362,96443,6.94,19.253,3365,0.43,38.505,7687,8311,30516
1982,4482,12198,35748,188755,190073,4051,11.444,3351,9.467,40216,18346,21870,9.652,21.158,41729,11601,30128,6.103,21.954,-1513,-0.796,42.316,1542,1633,5317
1982,4483,17216,24702,144397,144958,2633,10.647,2688,10.87,26412,10550,15862,7.278,18.221,27505,10075,17430,6.95,18.975,-1093,-0.754,36.441,1583,1626,5413
1982,4511,31958,42141,250715,248487,7589,18.416,5723,13.888,58916,30649,28267,12.334,23.71,55720,19654,36066,7.909,22.424,3196,1.286,44.848,4131,4241,13441
1982,4512,7514,10946,66884,67368,1496,13.827,1243,11.489,13392,5754,7638,8.541,19.879,14202,4463,9739,6.625,21.081,-810,-1.202,39.758,956,968,3389
1982,4522,430,6731,1084666,1099711,349,5.154,431,6.364,97086,42255,54831,3.842,8.828,129881,24164,105717,2.197,11.81,-32795,-2.982,17.657,39,41,1581
1982,4523,12944,27613,767198,779548,2221,7.933,2986,10.666,89079,33888,55191,4.347,11.427,114884,34700,80184,4.451,14.737,-25805,-3.31,22.854,1727,1781,10372
1982,4531,20107,21396,101606,101610,2654,12.33,2912,13.528,21775,7973,13802,7.847,21.43,21618,8174,13444,8.045,21.276,157,0.155,42.551,2234,2251,6211
1982,4532,23490,28784,172968,169963,4480,15.762,3756,13.215,41398,18631,22767,10.962,24.357,35299,13414,21885,7.892,20.769,6099,3.588,41.537,2870,2912,8590
1982,4533,8868,10599,49592,49312,1628,15.466,1482,14.079,11634,5190,6444,10.525,23.593,11194,3955,7239,8.02,22.701,440,0.892,45.401,1156,1169,2768
1982,4539,22914,26657,121295,122052,4482,16.669,4944,18.387,31942,14984,16958,12.277,26.171,33402,15699,17703,12.863,27.367,-1460,-1.196,52.342,3563,3662,11431
1982,4541,5659,7391,91041,92898,931,12.53,1009,13.58,14708,6005,8703,6.464,15.832,18656,7120,11536,7.664,20.082,-3948,-4.25,31.665,686,687,3120
1982,4542,4007,5423,80537,82779,562,10.315,613,11.251,11444,3670,7774,4.433,13.825,15877,4077,11800,4.925,19.18,-4433,-5.355,27.65,398,413,2118
1982,4543,16040,21574,191729,192296,1937,8.857,2527,11.555,36805,13103,23702,6.814,19.14,38108,11503,26605,5.982,19.817,-1303,-0.678,38.28,1707,1725,6950
1982,4811,1076,2714,277791,284105,354,13.351,229,8.637,16719,3195,13524,1.125,5.885,29023,2925,26098,1.03,10.216,-12304,-4.331,11.77,148,154,1438
1982,4812,449,630,8115,7854,106,17.001,93,14.916,1816,528,1288,6.723,23.123,1280,498,782,6.341,16.298,536,6.825,32.597,68,69,426
1982,4831,420,681,38156,37132,62,9.051,70,10.219,6880,1212,5668,3.264,18.528,5020,1548,3472,4.169,13.519,1860,5.009,27.039,39,40,857
1982,4832,410,471,16655,17503,58,12.34,56,11.915,2010,557,1453,3.182,11.484,3695,709,2986,4.051,21.111,-1685,-9.627,22.967,38,38,338
1982,4841,20122,25568,473520,484291,4175,16.331,4169,16.307,65729,24641,41088,5.088,13.572,87608,25653,61955,5.297,18.09,-21879,-4.518,27.144,3204,3232,15995
1982,4842,40435,44433,532988,541497,6523,14.613,6936,15.538,87880,30869,57011,5.701,16.229,104642,31773,72869,5.868,19.325,-16762,-3.095,32.458,5322,5350,23230
1982,4851,373,399,23348,23949,45,11.18,52,12.919,1605,433,1172,1.808,6.702,2764,635,2129,2.651,11.541,-1159,-4.839,13.403,39,39,499
1982,4852,341,690,29392,30428,24,3.397,57,8.068,2512,189,2323,0.621,8.256,4694,534,4160,1.755,15.427,-2182,-7.171,16.511,19,19,127
1982,4853,5345,5405,56364,59168,715,12.875,1012,18.223,10938,3886,7052,6.568,18.487,16532,6217,10315,10.507,27.941,-5594,-9.455,36.973,839,842,4446
1982,4854,3471,3661,92591,93521,258,6.921,392,10.515,11946,3640,8306,3.892,12.774,13820,4894,8926,5.233,14.777,-1874,-2.004,25.547,313,313,2819
1982,4855,497,537,11494,10879,84,15.985,61,11.608,3101,1903,1198,17.492,28.504,1823,858,965,7.887,16.757,1278,11.747,33.514,43,43,252
1982,4859,874,926,18977,19242,147,15.926,141,15.276,3452,1270,2182,6.6,17.94,4065,1385,2680,7.198,21.126,-613,-3.186,35.881,118,118,932
1982,4861,84,332,12682,12274,23,6.959,20,6.051,2057,853,1204,6.95,16.76,1265,599,666,4.88,10.307,792,6.453,20.614,4,4,283
1982,4862,240,1217,62861,60870,100,8.396,48,4.03,6699,1357,5342,2.229,11.005,2882,797,2085,1.309,4.735,3817,6.271,9.469,21,21,226
1982,4869,53,303,7039,7031,54,18.653,27,9.326,807,434,373,6.173,11.479,809,232,577,3.3,11.507,-2,-0.028,22.957,9,9,28
1982,4871,164,168,2818,2820,28,16.716,27,16.119,486,240,246,8.512,17.237,486,212,274,7.519,17.237,0,0,34.474,20,20,187
1982,4872,651,658,9120,9210,87,12.851,125,18.464,1573,434,1139,4.713,17.08,1756,562,1194,6.102,19.067,-183,-1.987,34.16,107,107,442
1982,4879,45,55,1897,1638,9,15.789,13,22.807,614,29,585,1.771,37.496,87,50,37,3.053,5.313,527,32.183,10.626,9,9,40
1982,4881,1977,2501,55372,55203,361,14.466,350,14.025,8638,2631,6007,4.766,15.648,8212,3109,5103,5.632,14.876,426,0.772,29.752,260,261,1719
1982,4882,329,434,11488,12944,64,14.866,57,13.24,1734,756,978,5.841,13.397,4537,1583,2954,12.23,35.052,-2803,-21.656,26.793,39,39,1065
1982,4883,2226,2654,119341,121595,336,12.739,303,11.488,21274,5922,15352,4.87,17.496,25849,5186,20663,4.265,21.258,-4575,-3.762,34.992,221,221,3364
1982,4884,1694,2249,33430,34580,385,16.912,440,19.328,5065,1892,3173,5.471,14.647,7380,2423,4957,7.007,21.342,-2315,-6.695,29.295,336,340,1331
1982,4885,4407,6180,84122,82602,870,14.374,615,10.161,15419,5008,10411,6.063,18.667,12145,4126,8019,4.995,14.703,3274,3.964,29.406,437,440,3018
1982,4889,371,381,6496,6368,72,19.433,51,13.765,1450,554,896,8.7,22.77,1196,387,809,6.077,18.781,254,3.989,37.563,46,46,328
1982,4921,1124,1712,73772,72960,307,18.059,283,16.647,9519,2073,7446,2.841,13.047,7907,1933,5974,2.649,10.838,1612,2.209,21.675,222,222,1418
1982,4922,696,697,4464,4546,224,30.601,294,40.164,1416,621,795,13.662,31.152,1555,997,558,21.934,34.21,-139,-3.058,62.303,256,256,906
1982,4931,6207,9858,377867,382619,913,9.365,695,7.129,55396,18307,37089,4.785,14.478,64856,10360,54496,2.708,16.951,-9460,-2.472,28.956,295,295,2021
1982,5111,12819,14586,596218,592206,1330,9.02,1648,11.177,57347,15642,41705,2.641,9.684,48956,13424,35532,2.267,8.267,8391,1.417,16.533,1315,1316,9212
1982,5112,7017,8257,122094,111840,2377,31.721,850,11.343,41067,18613,22454,16.643,36.719,20450,6588,13862,5.891,18.285,20617,18.434,36.57,544,554,2964
1982,5121,8687,14191,210790,212994,1976,13.977,1869,13.22,48119,15237,32882,7.154,22.592,52591,14035,38556,6.589,24.691,-4472,-2.1,45.183,1138,1176,8113
1982,5122,1766,1774,12878,12786,434,25.262,322,18.743,3310,1535,1775,12.005,25.888,3156,1208,1948,9.448,24.683,154,1.204,49.366,238,238,869
1982,5151,5761,6829,209493,205299,795,11.834,573,8.529,29723,12040,17683,5.865,14.478,21516,8151,13365,3.97,10.48,8207,3.998,20.961,460,465,6114
1982,5152,6,6,60,60,0,0,4,50,13,0,13,0,21.667,10,10,0,16.667,16.667,3,5,33.333,4,4,11
1982,5173,2062,13705,959402,969451,371,2.704,399,2.908,70293,4426,65867,0.457,7.251,91727,4582,87145,0.473,9.462,-21434,-2.211,14.502,261,264,1872
1982,5174,660,1155,56052,56930,170,15.26,88,7.899,12574,3698,8876,6.496,22.087,13938,2256,11682,3.963,24.483,-1364,-2.396,44.174,63,63,1446
1982,5179,1012,2115,75452,85164,267,12.726,233,11.106,10603,2439,8164,2.864,12.45,28333,2121,26212,2.491,33.269,-17730,-20.819,24.9,178,178,1569
1982,5182,5693,7483,210682,204419,1252,17.112,919,12.561,48417,18043,30374,8.827,23.685,36403,10613,25790,5.192,17.808,12014,5.877,35.616,564,586,4676
1982,5191,1928,2149,23894,23296,226,10.529,221,10.296,4064,1244,2820,5.34,17.445,2961,1099,1862,4.718,12.71,1103,4.735,25.421,168,168,857
1982,5211,30,66,24624,24960,7,11.024,(D),(D),324,175,149,0.701,1.298,983,(D),834,(D),3.938,-659,-2.64,2.596,(D),(D),(D)
1982,5221,20578,66396,1847192,1832001,2342,3.554,1344,2.04,151039,28332,122707,1.547,8.244,120754,21054,99700,1.149,6.591,30285,1.653,13.183,836,883,13517
1982,5222,22556,40392,334028,342090,2348,5.627,5016,12.021,46847,15238,31609,4.454,13.694,63238,26570,36668,7.767,18.486,-16391,-4.791,27.389,1519,1552,7365
1982,5223,2985,3365,41526,41535,639,19.135,588,17.607,8189,3280,4909,7.897,19.716,8085,3596,4489,8.658,19.466,104,0.25,38.931,450,451,2131
1982,5231,5202,9878,227635,224007,1383,14.401,834,8.684,28858,7561,21297,3.375,12.883,21913,5509,16404,2.459,9.782,6945,3.1,19.565,593,608,3452
1982,5232,116,131,6143,6287,18,13.9,15,11.583,242,40,202,0.636,3.849,528,81,447,1.288,8.398,-286,-4.549,7.698,13,13,70
1982,5239,11487,11855,128636,113909,2686,23.662,1679,14.791,54244,23198,31046,20.365,47.62,24277,9726,14551,8.538,21.313,29967,26.308,42.625,1331,1331,5523
1982,5241,6099,30174,1221647,1241665,1725,5.699,1914,6.323,112178,32530,79648,2.62,9.034,151116,38348,112768,3.088,12.17,-38938,-3.136,18.069,438,451,2666
1982,5242,88065,92719,910570,872999,10506,11.346,10269,11.09,205704,62035,143669,7.106,23.563,129164,51635,77529,5.915,14.795,76540,8.767,29.591,7452,7455,32544
1982,5259,610,803,10325,10992,87,10.978,66,8.328,1779,403,1376,3.666,16.184,3070,2327,743,21.17,27.929,-1291,-11.745,32.369,54,54,138
1982,5311,97684,99591,490807,496932,11456,11.269,15589,15.335,104701,42823,61878,8.617,21.069,116181,52092,64089,10.483,23.38,-11480,-2.31,42.139,12765,12789,40330
1982,5312,31558,32743,172530,179313,5039,15.027,6621,19.744,38606,17339,21267,9.67,21.53,52312,19294,33018,10.76,29.174,-13706,-7.644,43.06,4996,4999,14220
1982,5313,19469,20073,185788,185257,3198,15.535,4224,20.519,41778,16391,25387,8.848,22.551,40600,17533,23067,9.464,21.916,1178,0.636,43.831,3313,3317,12721
1982,5321,5316,8948,99336,100347,1207,13.522,1163,13.029,18813,7509,11304,7.483,18.748,20802,8073,12729,8.045,20.73,-1989,-1.982,37.496,716,748,3512
1982,5322,8878,10719,90712,89570,2151,20.606,1590,15.232,23935,10523,13412,11.748,26.722,21562,8557,13005,9.553,24.073,2373,2.649,48.146,1192,1194,5907
1982,5323,2550,2877,21234,20322,553,20.164,284,10.356,5774,2617,3157,12.878,28.413,3944,1293,2651,6.363,19.408,1830,9.005,38.815,204,204,804
1982,5324,4425,5151,52547,51815,821,16.413,523,10.456,12057,4714,7343,9.098,23.27,10669,4007,6662,7.733,20.591,1388,2.679,41.182,376,376,1999
1982,5331,890,948,11207,10537,195,21.207,138,15.008,3072,1208,1864,11.464,29.154,1712,818,894,7.763,16.248,1360,12.907,32.495,111,111,498
1982,5411,113083,116541,612087,601386,16497,14.416,12287,10.737,124964,55259,69705,9.189,20.779,103916,37775,66141,6.281,17.279,21048,3.5,34.559,9327,9378,29724
1982,5412,49754,53645,441096,412582,9033,17.281,6283,12.02,114613,41116,73497,9.966,27.779,59101,21937,37164,5.317,14.325,55512,13.455,28.649,4696,4728,16762
1982,5413,45431,49366,654140,660047,8133,16.779,6342,13.084,128470,52471,75999,7.95,19.464,140647,39953,100694,6.053,21.309,-12177,-1.845,38.928,4466,4486,25990
1982,5414,15429,15745,106190,101972,3393,22.725,1764,11.815,30097,14216,15881,13.941,29.515,21845,7215,14630,7.075,21.423,8252,8.092,42.845,1333,1338,5221
1982,5415,2702,3714,43008,40613,1277,34.108,1337,35.71,15609,10040,5569,24.721,38.434,10383,5780,4603,14.232,25.566,5226,12.868,51.132,1136,1137,4085
1982,5416,7249,7533,74161,78401,2370,27.488,4548,52.749,25425,12449,12976,15.879,32.43,34161,22800,11361,29.081,43.572,-8736,-11.143,64.859,3711,3718,17073
1982,5417,2665,3527,304626,304663,482,13.092,791,21.486,51652,12149,39503,3.988,16.954,51108,26088,25020,8.563,16.775,544,0.179,33.551,504,508,3815
1982,5418,18479,20361,252513,248091,3465,17.276,2857,14.244,53070,19725,33345,7.951,21.391,44511,16954,27557,6.834,17.941,8559,3.45,35.883,2170,2189,11446
1982,5419,24217,26403,157513,157319,3464,13.286,2803,10.751,31478,11630,19848,7.393,20.009,31384,11359,20025,7.22,19.949,94,0.06,39.899,2103,2110,8179
1982,5511,22119,42816,2812646,2798687,4601,10.911,3303,7.833,521801,182081,339720,6.506,18.644,490669,113773,376896,4.065,17.532,31132,1.112,35.064,629,642,7636
1982,5611,416,435,14733,16529,123,13.155,1123,120.107,4701,3002,1699,18.163,28.442,8388,7510,878,45.437,50.749,-3687,-22.307,56.884,914,919,6059
1982,5612,56,60,4668,5518,13,15.029,66,76.301,2531,117,2414,2.12,45.868,3985,2229,1756,40.395,72.218,-1454,-26.35,91.736,32,33,299
1982,5613,10169,13815,561900,560114,2485,18.319,1986,14.64,146954,44185,102769,7.889,26.236,143145,26469,116676,4.726,25.556,3809,0.68,51.113,1459,1476,16743
1982,5614,21100,23373,229611,226579,4210,18.672,2558,11.345,49309,19058,30251,8.411,21.762,43539,12243,31296,5.403,19.216,5770,2.547,38.432,1891,1899,7516
1982,5615,17938,21059,156502,152514,3153,15.486,1756,8.625,33657,13374,20283,8.769,22.068,25919,8345,17574,5.472,16.995,7738,5.074,33.989,1283,1298,5835
1982,5616,17539,20738,538378,528662,3878,19.715,1743,8.861,108386,33069,75317,6.255,20.502,89764,23476,66288,4.441,16.979,18622,3.522,33.959,1211,1213,12755
1982,5617,51207,54031,679554,671875,10864,20.258,10059,18.757,174834,68099,106735,10.136,26.022,159608,63449,96159,9.444,23.756,15226,2.266,47.511,7881,7896,35086
1982,5619,18376,19568,221146,212671,4110,22.455,1580,8.632,56065,22343,33722,10.506,26.362,39309,9550,29759,4.491,18.483,16756,7.879,36.967,1131,1132,6550
1982,5621,4139,4324,87100,88299,538,12.241,680,15.472,12484,3984,8500,4.512,14.138,14816,5031,9785,5.698,16.779,-2332,-2.641,28.277,561,562,3835
1982,5622,2048,2473,41657,41188,282,11.487,246,10.02,6768,1715,5053,4.164,16.432,5805,2482,3323,6.026,14.094,963,2.338,28.188,181,181,1164
1982,5629,4298,4510,35544,36389,652,14.47,644,14.292,7081,2678,4403,7.359,19.459,8777,3717,5060,10.215,24.12,-1696,-4.661,38.919,478,478,2383
1982,6111,12550,12878,352454,350103,620,4.815,616,4.784,34112,5497,28615,1.57,9.743,29593,5338,24255,1.525,8.453,4519,1.291,16.905,445,446,3839
1982,6112,433,528,36023,35654,44,8.421,33,6.316,4488,619,3869,1.736,12.588,3733,848,2885,2.378,10.47,755,2.118,20.94,24,24,658
1982,6113,1983,2264,942117,934402,87,3.858,69,3.06,76723,5445,71278,0.583,8.211,61174,2956,58218,0.316,6.547,15549,1.664,13.094,44,44,882
1982,6114,1620,1833,27173,27350,309,16.969,285,15.651,5486,1766,3720,6.457,20.059,5850,1945,3905,7.112,21.389,-364,-1.331,40.117,217,217,1002
1982,6115,3794,4555,48463,48255,550,12.123,514,11.329,9865,3369,6496,6.982,20.443,9477,2869,6608,5.945,19.639,388,0.804,39.279,400,400,2102
1982,6116,9936,10440,88687,89174,1868,17.931,1823,17.499,22475,9340,13135,10.474,25.204,23181,8761,14420,9.825,25.995,-706,-0.792,50.407,1437,1447,6749
1982,6117,473,485,14600,14718,89,16.856,175,33.144,1444,558,886,3.791,9.811,1675,1033,642,7.019,11.381,-231,-1.57,19.622,133,133,658
1982,6211,170293,175113,948260,931077,19168,11.203,11126,6.503,164905,63388,101517,6.808,17.711,131510,39523,91987,4.245,14.125,33395,3.587,28.249,8800,8842,30389
1982,6212,90213,92091,399218,387846,7082,7.78,4951,5.439,74165,23813,50352,6.14,19.122,51712,16209,35503,4.179,13.333,22453,5.789,26.666,3903,3916,13160
1982,6213,35444,37058,115891,111574,5820,16.213,3497,9.742,30852,14866,15986,13.324,27.652,22173,9603,12570,8.607,19.873,8679,7.779,39.746,2621,2647,7557
1982,6214,4635,5824,88924,88226,835,14.629,603,10.564,15703,6197,9506,7.024,17.799,14253,5250,9003,5.951,16.155,1450,1.644,32.31,429,437,3718
1982,6215,3779,4762,62300,61594,556,11.666,564,11.834,11597,3957,7640,6.424,18.828,10079,4762,5317,7.731,16.364,1518,2.465,32.727,372,388,2691
1982,6216,2848,3815,144090,131643,673,18.348,379,10.333,43988,16777,27211,12.744,33.415,19280,4515,14765,3.43,14.646,24708,18.769,29.291,258,258,1760
1982,6219,2903,3362,70106,66059,574,17.643,357,10.973,18280,5190,13090,7.857,27.672,10295,4515,5780,6.835,15.585,7985,12.088,31.169,257,257,2359
1982,6221,3697,4764,2797216,2732813,208,4.386,164,3.458,214166,45207,168959,1.654,7.837,83967,26278,57689,0.962,3.073,130199,4.764,6.145,109,109,17596
1982,6222,337,456,46836,45755,51,11.538,23,5.204,6453,2444,4009,5.342,14.104,4256,1814,2442,3.965,9.302,2197,4.802,18.604,14,14,1223
1982,6223,193,238,42173,42733,42,18.834,12,5.381,4390,1239,3151,2.899,10.273,5608,699,4909,1.636,13.123,-1218,-2.85,20.546,7,7,401
1982,6231,8625,12137,939466,926437,957,7.993,628,5.245,123419,56011,67408,6.046,13.322,97091,34368,62723,3.71,10.48,26328,2.842,20.96,469,474,24868
1982,6232,3405,4515,100388,97826,563,12.772,349,7.917,18004,6735,11269,6.885,18.404,12982,4287,8695,4.382,13.271,5022,5.134,26.541,270,271,3335
1982,6233,6522,7551,216112,216065,803,10.663,763,10.131,30880,11576,19304,5.358,14.292,30584,12458,18126,5.766,14.155,296,0.137,28.31,542,548,9383
1982,6239,2433,2948,69012,68691,280,9.615,208,7.143,9309,3147,6162,4.581,13.552,8759,3118,5641,4.539,12.751,550,0.801,25.503,125,125,1557
1982,6241,12168,16691,247407,253439,1572,9.51,1249,7.556,40187,10843,29344,4.278,15.857,52181,8742,43439,3.449,20.589,-11994,-4.732,31.713,753,781,5192
1982,6242,3342,3990,37217,37434,385,9.769,287,7.282,6879,2301,4578,6.147,18.376,7375,1925,5450,5.142,19.701,-496,-1.325,36.753,190,191,1179
1982,6243,3540,5173,216154,231531,499,9.576,575,11.034,34716,6523,28193,2.817,14.994,65449,13079,52370,5.649,28.268,-30733,-13.274,29.988,272,278,8365
1982,6244,25553,30355,259995,254100,4167,13.932,3275,10.95,59604,24347,35257,9.582,23.457,46959,15899,31060,6.257,18.481,12645,4.976,36.961,2542,2592,11971
1982,7111,5127,5177,71830,70171,886,17.124,880,17.008,21118,5362,15756,7.641,30.095,17560,5076,12484,7.234,25.025,3558,5.07,50.049,662,664,3943
1982,7112,2113,2227,59725,59971,381,17.131,375,16.862,11816,4083,7733,6.808,19.703,12386,4259,8127,7.102,20.653,-570,-0.95,39.406,269,270,3485
1982,7113,2144,2179,28013,28108,380,17.52,360,16.598,7539,2365,5174,8.414,26.822,7726,2758,4968,9.812,27.487,-187,-0.665,53.643,284,284,2432
1982,7114,1128,1148,11469,11041,225,20.152,162,14.51,3346,1462,1884,13.242,30.307,2482,1274,1208,11.539,22.481,864,7.826,44.962,133,133,1147
1982,7115,4570,4591,26442,27370,1403,29.8,1637,34.771,9783,4260,5523,15.565,35.744,11603,4825,6778,17.629,42.394,-1820,-6.65,71.488,1220,1221,3353
1982,7121,192,196,3323,3546,42,16.901,147,59.155,671,188,483,5.302,18.923,1089,916,173,25.832,30.711,-418,-11.788,37.845,110,110,657
1982,7131,2109,2555,55864,52806,946,42.902,246,11.156,9607,4882,4725,9.245,18.193,3578,1034,2544,1.958,6.776,6029,11.417,13.551,205,206,913
1982,7132,704,733,20249,18975,158,22.685,85,12.204,5428,1525,3903,8.037,28.607,2925,688,2237,3.626,15.415,2503,13.191,30.831,70,70,535
1982,7139,31703,33632,479941,472279,4471,13.517,3361,10.161,92241,34117,58124,7.224,19.531,76946,21677,55269,4.59,16.293,15295,3.239,32.585,2564,2579,16565
1982,7211,28321,32467,1085160,1071354,3863,11.821,4288,13.121,211259,88806,122453,8.289,19.719,184654,73541,111113,6.864,17.236,26605,2.483,34.471,3231,3272,45894
1982,7212,3414,3664,20052,19258,497,13.607,474,12.977,6367,2142,4225,11.123,33.062,4912,1450,3462,7.529,25.506,1455,7.555,51.013,322,322,1042
1982,7213,4783,4890,22458,22589,297,5.984,443,8.926,3666,1079,2587,4.777,16.229,3924,1256,2668,5.56,17.372,-258,-1.142,32.459,322,322,888
1982,7223,16578,26000,474342,474783,4247,16.449,3884,15.043,114021,55356,58665,11.659,24.015,114146,43761,70385,9.217,24.042,-125,-0.026,48.031,2237,2277,18434
1982,7224,59144,59955,320911,322476,8834,14.504,10740,17.633,89897,48105,41792,14.917,27.877,92981,42441,50540,13.161,28.834,-3084,-0.956,55.754,8525,8549,33771
1982,7225,178782,230739,3927369,3900669,36316,15.783,35032,15.225,919197,479791,439406,12.3,23.565,862393,351647,510746,9.015,22.109,56804,1.456,44.218,26821,27316,245267
1982,8111,88692,92793,425969,423032,13886,14.986,13621,14.7,99768,43517,56251,10.287,23.584,93848,41584,52264,9.83,22.185,5920,1.399,44.369,10413,10450,32743
1982,8112,9261,10210,60367,59833,1207,11.642,1522,14.68,12580,4488,8092,7.501,21.025,11620,4903,6717,8.195,19.421,960,1.604,38.842,1194,1198,3272
1982,8113,17273,18181,138303,139085,2625,14.568,2302,12.775,27974,10773,17201,7.746,20.113,29524,9727,19797,6.994,21.227,-1550,-1.114,40.226,1682,1684,6118
1982,8114,21883,23462,135666,137227,3566,15.149,3721,15.807,25683,9758,15925,7.111,18.716,28704,11826,16878,8.618,20.917,-3021,-2.201,37.431,2859,2860,8050
1982,8121,77742,85899,388104,389185,10908,12.526,13270,15.239,84065,37996,46069,9.763,21.6,85651,40473,45178,10.399,22.008,-1586,-0.408,43.201,10573,10644,30545
1982,8122,17029,19688,111776,111305,1282,6.481,1467,7.416,17620,4502,13118,4.045,15.83,16658,4760,11898,4.277,14.966,962,0.864,29.932,1008,1019,3315
1982,8123,32153,37921,330467,331777,4261,11.149,4858,12.711,51565,19526,32039,5.885,15.542,54352,21789,32563,6.567,16.382,-2787,-0.84,31.084,3651,3749,15374
1982,8129,18393,24841,278023,274020,4972,20.783,3137,13.113,72839,33151,39688,12.098,26.582,63790,15166,48624,5.535,23.279,9049,3.302,46.559,1681,1718,7471
1982,8131,75099,75213,714546,698620,5465,7.41,2549,3.456,106847,26416,80431,3.781,15.294,74471,9098,65373,1.302,10.66,32376,4.634,21.319,1085,1085,4225
1982,8132,6645,7699,117523,121236,660,8.568,668,8.672,17193,3708,13485,3.059,14.181,24546,4928,19618,4.065,20.247,-7353,-6.065,28.363,412,419,3479
1982,8133,6443,7607,83209,88382,924,12.272,769,10.213,14205,5230,8975,5.917,16.072,24412,5232,19180,5.92,27.621,-10207,-11.549,32.145,460,463,3375
1982,8134,27964,29253,243244,242415,1643,5.605,1764,6.018,35606,7104,28502,2.931,14.688,33719,5255,28464,2.168,13.91,1887,0.778,27.819,1247,1247,3750
1982,8139,54538,56743,426769,423809,4121,7.25,4311,7.585,79062,19036,60026,4.492,18.655,72776,14103,58673,3.328,17.172,6286,1.483,34.344,3134,3140,10039
1983,1131,209,217,3771,3995,44,21.205,25,12.048,534,292,242,7.309,13.367,1000,356,644,8.911,25.031,-466,-11.665,26.733,18,18,60
1983,1132,72,87,1207,1434,5,5.348,18,19.251,139,19,120,1.325,9.693,573,83,490,5.788,39.958,-434,-30.265,19.386,14,14,43
1983,1133,10028,10136,82171,81092,1613,16.003,1500,14.882,20478,6460,14018,7.966,25.253,18307,6741,11566,8.313,22.576,2171,2.677,45.151,1083,1084,5022
1983,1141,1292,1324,8450,9114,227,16.697,298,21.92,2413,945,1468,10.369,26.477,3712,1457,2255,15.987,40.731,-1299,-14.254,52.954,213,215,961
1983,1142,128,129,516,520,22,17.391,17,13.439,171,82,89,15.769,32.885,164,78,86,15,31.538,7,1.346,63.077,10,10,66
1983,1151,4002,4414,51475,53485,569,12.784,643,14.446,12759,4905,7854,9.171,23.855,16782,5686,11096,10.631,31.377,-4023,-7.522,47.711,424,427,2791
1983,1152,1712,1731,12305,12001,286,16.943,200,11.848,2740,1207,1533,10.058,22.832,2136,596,1540,4.966,17.799,604,5.033,35.599,160,160,457
1983,1153,698,711,10001,9697,144,20.426,132,18.723,3215,1434,1781,14.788,33.155,2652,1132,1520,11.674,27.349,563,5.806,54.697,101,101,968
1983,2111,7718,9762,169832,177521,1332,13.67,1296,13.3,31938,12109,19829,6.821,17.991,47235,14031,33204,7.904,26.608,-15297,-8.617,35.982,892,897,5576
1983,2121,2753,3455,185157,212805,507,13.813,938,25.555,20538,9855,10683,4.631,9.651,76185,20236,55949,9.509,35.8,-55647,-26.149,19.302,673,675,8857
1983,2122,546,699,46019,57895,119,15.505,256,33.355,3478,2239,1239,3.867,6.007,27214,4027,23187,6.956,47.006,-23736,-40.999,12.015,174,174,946
1983,2123,3528,4968,96365,100694,387,7.707,494,9.838,13432,4021,9411,3.993,13.339,21931,6412,15519,6.368,21.78,-8499,-8.44,26.679,279,284,2293
1983,2131,11342,12838,291150,354103,1945,14.733,2673,20.247,50812,22620,28192,6.388,14.349,176767,42820,133947,12.093,49.92,-125955,-35.57,28.699,1911,1919,24154
1983,2211,1554,5746,581659,575731,192,3.361,125,2.188,39967,11593,28374,2.014,6.942,28040,3318,24722,0.576,4.87,11927,2.072,9.741,34,34,199
1983,2212,530,2345,137565,138814,101,4.314,93,3.973,8103,1930,6173,1.39,5.837,10470,1552,8918,1.118,7.542,-2367,-1.705,11.675,23,23,99
1983,2213,3708,4014,30322,30356,312,7.846,237,5.96,3286,1227,2059,4.042,10.825,3326,1313,2013,4.325,10.957,-40,-0.132,21.65,165,168,711
1983,2361,79310,79672,420009,415153,16524,20.691,16900,21.162,147414,59564,87850,14.347,35.508,137756,60236,77520,14.509,33.182,9658,2.326,66.364,11682,11688,44438
1983,2362,32998,33591,554523,580981,4597,13.762,4224,12.645,124303,29385,94918,5.058,21.395,177843,31962,145881,5.501,30.611,-53540,-9.215,42.791,2881,2883,20175
1983,2371,12645,12964,301077,326820,1409,10.751,1693,12.918,51786,11803,39983,3.611,15.845,102831,20548,82283,6.287,31.464,-51045,-15.619,31.691,1211,1212,10610
1983,2372,7075,7169,53427,50987,1699,23.901,1578,22.199,18761,9341,9420,18.32,36.796,13695,5669,8026,11.119,26.86,5066,9.936,53.72,1187,1187,4197
1983,2373,9551,9808,185532,188934,988,10.041,1052,10.691,40712,8354,32358,4.422,21.548,47522,8672,38850,4.59,25.153,-6810,-3.604,43.097,756,758,5827
1983,2379,4366,4436,102572,112587,704,15.842,720,16.202,17527,5913,11614,5.252,15.568,37336,5707,31629,5.069,33.162,-19809,-17.594,31.135,516,516,2462
1983,2381,60193,60585,513975,510187,9778,16.3,8586,14.313,153556,45315,108241,8.882,30.098,145919,41286,104633,8.092,28.601,7637,1.497,57.202,6028,6028,31022
1983,2382,93567,95504,927357,946857,12194,12.807,11614,12.198,190237,51193,139044,5.407,20.091,229601,51380,178221,5.426,24.249,-39364,-4.157,40.183,8484,8490,37954
1983,2383,60436,60848,461414,460339,10611,17.411,10802,17.725,136984,42624,94360,9.259,29.757,134422,43446,90976,9.438,29.201,2562,0.557,58.401,7570,7583,32243
1983,2389,32863,33065,270670,277640,5084,15.408,4944,14.984,77422,28406,49016,10.231,27.886,91132,22951,68181,8.266,32.824,-13710,-4.938,55.772,3545,3546,17196
1983,3111,1351,1981,53354,54188,88,4.384,141,7.024,4582,579,4003,1.069,8.456,6269,1563,4706,2.884,11.569,-1687,-3.113,16.912,77,78,784
1983,3112,530,885,74059,75716,47,5.311,47,5.311,4807,1026,3781,1.355,6.349,8154,1586,6568,2.095,10.769,-3347,-4.42,12.698,28,28,670
1983,3113,1389,1752,84991,88433,241,14.098,156,9.125,7498,1559,5939,1.763,8.479,14575,5225,9350,5.908,16.481,-7077,-8.003,16.957,90,90,503
1983,3114,1256,1733,173397,176020,119,6.851,127,7.311,19493,3230,16263,1.835,11.074,24494,5274,19220,2.996,13.916,-5001,-2.841,22.149,70,70,1980
1983,3115,1838,2558,135409,137055,132,5.125,167,6.484,12098,2806,9292,2.047,8.827,15485,4259,11226,3.108,11.298,-3387,-2.471,17.654,100,100,1551
1983,3116,4289,4878,318003,323158,309,6.292,375,7.636,29193,7072,22121,2.188,9.034,39656,9596,30060,2.969,12.271,-10463,-3.238,18.067,256,256,3264
1983,3117,774,895,47572,47036,71,7.889,81,9,8627,2585,6042,5.496,18.341,7719,2217,5502,4.713,16.411,908,1.93,32.822,56,57,1603
1983,3118,8641,10131,298351,299657,1397,14.035,1042,10.469,33023,10486,22537,3.499,11.02,35234,11343,23891,3.785,11.758,-2211,-0.738,22.041,753,771,6752
1983,3119,2058,2413,121947,123058,190,7.876,189,7.834,13904,3549,10355,2.884,11.299,16181,4752,11429,3.862,13.149,-2277,-1.85,22.598,126,129,2432
1983,3121,2003,2562,174557,177717,144,5.553,206,7.944,13654,2577,11077,1.45,7.683,20096,5259,14837,2.959,11.308,-6442,-3.625,15.366,130,132,1979
1983,3122,108,167,43376,44366,14,8.408,13,7.808,3778,594,3184,1.339,8.516,5978,2204,3774,4.968,13.474,-2200,-4.959,17.031,6,6,51
1983,3131,460,685,105038,106867,41,5.925,55,7.948,7644,2212,5432,2.07,7.153,11377,3716,7661,3.477,10.646,-3733,-3.493,14.306,24,24,435
1983,3132,1756,2151,291420,303549,137,6.302,183,8.418,17622,3138,14484,1.034,5.805,41454,10556,30898,3.478,13.656,-23832,-7.851,11.611,118,119,2372
1983,3133,1610,1845,109872,111946,124,6.685,144,7.763,9128,2005,7123,1.791,8.154,13079,3424,9655,3.059,11.683,-3951,-3.529,16.308,97,97,1614
1983,3141,3899,4187,112358,112231,386,9.05,542,12.708,15416,2870,12546,2.557,13.736,15133,5283,9850,4.707,13.484,283,0.252,26.968,428,434,3624
1983,3149,3472,3607,121748,124768,489,13.751,387,10.883,18312,7895,10417,6.328,14.677,24439,6943,17496,5.565,19.588,-6127,-4.911,29.354,295,296,4130
1983,3151,1358,1482,137793,139183,102,6.814,132,8.818,12429,1705,10724,1.225,8.93,15279,4561,10718,3.277,10.978,-2850,-2.048,17.86,106,106,1619
1983,3152,12108,13640,844198,870824,1670,11.943,2356,16.849,110641,37746,72895,4.335,12.705,164333,66592,97741,7.647,18.871,-53692,-6.166,25.411,1915,1936,41654
1983,3159,1809,1920,74188,75439,215,11.271,190,9.961,10231,2514,7717,3.333,13.562,12734,4238,8496,5.618,16.88,-2503,-3.318,27.124,140,141,1673
1983,3161,359,401,19102,19527,30,7.463,32,7.96,1872,385,1487,1.972,9.587,2728,358,2370,1.833,13.971,-856,-4.384,19.174,27,28,273
1983,3162,518,754,127142,132965,45,5.929,55,7.246,10231,1642,8589,1.235,7.695,21609,4580,17029,3.445,16.252,-11378,-8.557,15.389,36,37,1044
1983,3169,1315,1364,50857,53802,144,10.477,165,12.004,5197,1595,3602,2.965,9.659,11093,2582,8511,4.799,20.618,-5896,-10.959,19.319,137,137,1639
1983,3211,4826,5341,126749,125682,473,8.7,664,12.214,22337,5039,17298,4.009,17.773,20217,8114,12103,6.456,16.086,2120,1.687,32.172,449,453,4247
1983,3212,1005,1258,79926,76687,110,8.734,113,8.972,13323,3771,9552,4.917,17.373,6821,2177,4644,2.839,8.895,6502,8.479,17.789,77,77,702
1983,3219,8483,9227,246286,242356,1011,10.929,1059,11.447,43991,10935,33056,4.512,18.151,36008,13110,22898,5.409,14.858,7983,3.294,29.715,790,791,7427
1983,3221,283,622,202026,202547,29,4.677,25,4.032,9164,4871,4293,2.405,4.524,10420,1470,8950,0.726,5.144,-1256,-0.62,9.049,10,10,147
1983,3222,3588,5134,376514,383631,217,4.201,280,5.421,26304,4768,21536,1.243,6.857,40621,12570,28051,3.277,10.589,-14317,-3.732,13.713,180,189,2918
1983,3231,34493,36035,673785,674793,4205,11.878,2938,8.299,80825,24193,56632,3.585,11.978,82761,24734,58027,3.665,12.265,-1936,-0.287,23.955,2336,2341,15274
1983,3241,1488,2335,231881,263089,173,7.329,224,9.49,12311,2655,9656,1.009,4.679,75692,6369,69323,2.421,28.771,-63381,-24.091,9.359,107,109,1353
1983,3251,1144,2233,246947,255626,149,6.653,162,7.234,11514,2873,8641,1.124,4.504,28994,8324,20670,3.256,11.342,-17480,-6.838,9.008,74,74,832
1983,3252,508,778,149823,155875,42,5.405,40,5.148,6245,1951,4294,1.252,4.006,18174,3034,15140,1.946,11.659,-11929,-7.653,8.013,15,15,134
1983,3253,722,1074,48677,51656,62,5.735,76,7.031,2845,813,2032,1.574,5.508,8954,1962,6992,3.798,17.334,-6109,-11.826,11.015,44,44,552
1983,3254,1003,1237,159428,158684,125,10.25,90,7.38,13130,3370,9760,2.124,8.274,11426,2684,8742,1.691,7.2,1704,1.074,14.401,57,57,604
1983,3255,1623,2069,72062,72846,105,5.046,129,6.199,7016,1810,5206,2.485,9.631,8685,2286,6399,3.138,11.922,-1669,-2.291,19.263,77,82,728
1983,3256,2024,2282,119783,122249,176,7.755,151,6.653,10524,1659,8865,1.357,8.609,15289,2586,12703,2.115,12.506,-4765,-3.898,17.217,107,107,654
1983,3259,1697,2212,88336,89706,243,11.111,193,8.825,9872,4442,5430,4.952,11.005,12742,2818,9924,3.141,14.204,-2870,-3.199,22.01,123,124,1352
1983,3261,9800,11266,486947,486895,953,8.464,939,8.34,67280,18782,48498,3.858,13.818,67336,19443,47893,3.993,13.83,-56,-0.012,27.636,657,662,8666
1983,3262,1920,2269,172277,178691,197,8.734,170,7.537,11587,3031,8556,1.696,6.484,24545,5790,18755,3.24,13.736,-12958,-7.252,12.969,95,95,1630
1983,3271,1307,1586,72373,74647,177,11.097,195,12.226,7418,1389,6029,1.861,9.937,12071,2719,9352,3.642,16.171,-4653,-6.233,19.875,146,146,1129
1983,3272,1499,1784,148453,152106,190,10.701,173,9.744,10204,2135,8069,1.404,6.709,17599,4449,13150,2.925,11.57,-7395,-4.862,13.417,121,121,1671
1983,3273,7089,8997,163270,166277,567,6.244,733,8.073,25243,5976,19267,3.594,15.181,31142,7697,23445,4.629,18.729,-5899,-3.548,30.363,479,484,3804
1983,3274,249,346,15525,15734,47,13.885,32,9.453,1653,299,1354,1.9,10.506,1984,469,1515,2.981,12.61,-331,-2.104,21.012,25,25,60
1983,3279,1822,2097,77304,79174,176,8.373,186,8.849,7101,1917,5184,2.421,8.969,10784,2257,8527,2.851,13.621,-3683,-4.652,17.938,120,120,799
1983,3311,278,318,150287,167872,35,10.802,47,14.506,3860,1160,2700,0.691,2.299,39213,2927,36286,1.744,23.359,-35353,-21.06,4.599,34,34,473
1983,3312,511,689,58260,65217,48,6.957,50,7.246,4316,972,3344,1.49,6.618,18334,2642,15692,4.051,28.113,-14018,-21.495,13.236,28,29,503
1983,3313,460,690,116601,122445,35,5.058,39,5.636,6504,1091,5413,0.891,5.312,18078,2907,15171,2.374,14.764,-11574,-9.452,10.624,14,14,287
1983,3314,706,874,83128,88681,66,7.383,106,11.857,4070,1134,2936,1.279,4.589,15308,1981,13327,2.234,17.262,-11238,-12.672,9.179,75,76,667
1983,3315,2800,3121,200651,228049,160,5.056,247,7.805,11082,2353,8729,1.032,4.859,65762,11208,54554,4.915,28.837,-54680,-23.977,9.719,158,158,3618
1983,3321,3141,3355,130309,139846,186,5.526,208,6.179,8923,2216,6707,1.585,6.381,28065,3783,24282,2.705,20.069,-19142,-13.688,12.761,159,159,2753
1983,3322,1204,1324,80885,85046,74,5.564,86,6.466,5890,1032,4858,1.213,6.926,14084,3276,10808,3.852,16.56,-8194,-9.635,13.851,57,57,478
1983,3323,9885,10718,312947,334847,743,6.88,906,8.389,36114,7442,28672,2.223,10.785,79966,15459,64507,4.617,23.881,-43852,-13.096,21.57,645,651,7158
1983,3324,1469,1848,128051,139452,121,6.505,145,7.796,8242,2792,5450,2.002,5.91,31014,5868,25146,4.208,22.24,-22772,-16.33,11.821,85,85,1756
1983,3325,902,977,72824,73357,76,7.775,77,7.877,6016,1375,4641,1.874,8.201,6961,1910,5051,2.604,9.489,-945,-1.288,16.402,53,53,1159
1983,3326,1563,1774,61068,61922,143,8.109,122,6.918,7824,2187,5637,3.532,12.635,9521,2127,7394,3.435,15.376,-1697,-2.741,25.271,80,85,1177
1983,3327,20737,21075,291677,317220,1666,7.761,2446,11.395,29336,9098,20238,2.868,9.248,80564,15792,64772,4.978,25.397,-51228,-16.149,18.496,1777,1778,10791
1983,3328,5342,5646,110380,114045,425,7.53,421,7.459,14058,4140,9918,3.63,12.327,21414,4811,16603,4.219,18.777,-7356,-6.45,24.653,307,311,3054
1983,3329,4960,5509,324239,349857,645,11.77,587,10.712,28158,9668,18490,2.763,8.048,79815,11021,68794,3.15,22.814,-51657,-14.765,16.097,429,429,5374
1983,3331,3149,3583,243305,306373,261,7.09,458,12.441,13415,4882,8533,1.593,4.379,139714,14348,125366,4.683,45.603,-126299,-41.224,8.757,318,318,3589
1983,3332,3672,3926,155353,167326,285,7.244,302,7.676,12694,4222,8472,2.523,7.586,36646,5749,30897,3.436,21.901,-23952,-14.315,15.173,210,212,2306
1983,3333,1997,2122,164224,167742,161,7.598,155,7.315,16659,2223,14436,1.325,9.931,23959,6019,17940,3.588,14.283,-7300,-4.352,19.863,99,99,1601
1983,3334,1855,2085,156462,165389,161,7.576,241,11.341,13376,3259,10117,1.971,8.088,31489,6287,25202,3.801,19.039,-18113,-10.952,16.175,169,169,1271
1983,3335,9446,9903,215854,242840,593,5.921,816,8.148,14975,4517,10458,1.86,6.167,68631,9910,58721,4.081,28.262,-53656,-22.095,12.333,570,573,4753
1983,3336,735,904,140949,157031,42,4.661,36,3.996,3152,569,2583,0.362,2.007,35535,673,34862,0.429,22.629,-32383,-20.622,4.015,26,26,276
1983,3339,5872,6463,301079,335424,380,5.809,538,8.224,18969,6846,12123,2.041,5.655,87500,13365,74135,3.985,26.086,-68531,-20.431,11.31,354,354,3721
1983,3341,1459,1666,334904,333000,293,18.318,160,10.003,46290,10118,36172,3.038,13.901,41276,10034,31242,3.013,12.395,5014,1.506,24.79,115,115,2013
1983,3342,1795,1995,263570,266743,194,9.744,186,9.342,33085,11645,21440,4.366,12.403,39562,8039,31523,3.014,14.832,-6477,-2.428,24.807,145,145,2418
1983,3343,407,435,47125,49068,45,10.147,62,13.98,3949,1729,2220,3.524,8.048,7684,3167,4517,6.454,15.66,-3735,-7.612,16.096,42,42,715
1983,3344,4082,4625,460501,473203,575,12.625,434,9.529,42968,10565,32403,2.233,9.08,67823,16144,51679,3.412,14.333,-24855,-5.253,18.161,309,310,4264
1983,3345,3885,4450,613037,623122,420,9.517,346,7.84,58028,15650,42378,2.512,9.312,77683,24431,53252,3.921,12.467,-19655,-3.154,18.625,215,216,3325
1983,3346,616,641,16587,16603,118,18.941,82,13.162,4047,1099,2948,6.619,24.375,4024,634,3390,3.819,24.237,23,0.139,48.473,58,58,313
1983,3351,1174,1291,76819,78918,95,7.311,112,8.619,6248,1023,5225,1.296,7.917,10374,2465,7909,3.123,13.145,-4126,-5.228,15.834,82,82,1296
1983,3352,333,439,113458,117973,22,4.851,51,11.246,8919,297,8622,0.252,7.56,17594,2079,15515,1.762,14.914,-8675,-7.353,15.12,41,41,587
1983,3353,1995,2501,238931,258895,161,6.422,173,6.901,12200,1626,10574,0.628,4.712,51652,8063,43589,3.114,19.951,-39452,-15.239,9.425,102,102,1118
1983,3359,1822,2170,186667,193349,239,11.168,179,8.364,15313,3550,11763,1.836,7.92,28716,4949,23767,2.56,14.852,-13403,-6.932,15.84,110,110,1614
1983,3361,181,238,214289,217668,37,15.678,33,13.983,21961,1449,20512,0.666,10.089,28800,6762,22038,3.107,13.231,-6839,-3.142,20.178,22,22,259
1983,3362,1655,1824,91408,94526,173,9.482,174,9.537,12786,2803,9983,2.965,13.526,19542,4358,15184,4.61,20.674,-6756,-7.147,27.053,129,130,1081
1983,3363,3588,4297,550096,553051,389,9.13,316,7.417,50090,7365,42725,1.332,9.057,55485,15623,39862,2.825,10.033,-5395,-0.975,18.114,222,224,7572
1983,3364,1218,1460,638688,642409,119,8.148,120,8.216,49410,3581,45829,0.557,7.691,58158,3379,54779,0.526,9.053,-8748,-1.362,15.383,80,80,993
1983,3365,178,217,27920,36343,19,8.656,24,10.934,699,498,201,1.37,1.923,17545,1517,16028,4.174,48.276,-16846,-46.353,3.847,14,14,226
1983,3366,1112,1209,160602,181320,125,10.2,158,12.893,16629,1329,15300,0.733,9.171,57597,6935,50662,3.825,31.765,-40968,-22.594,18.342,110,110,2706
1983,3369,424,434,35996,34260,72,16.862,58,13.583,8186,3782,4404,11.039,23.894,4654,1023,3631,2.986,13.585,3532,10.31,27.169,44,44,740
1983,3371,11519,12101,336216,337520,1383,11.353,1545,12.683,44296,12861,31435,3.81,13.124,46612,17884,28728,5.299,13.81,-2316,-0.686,26.248,1182,1191,11009
1983,3372,2366,2495,115214,117108,237,9.562,204,8.231,13546,3860,9686,3.296,11.567,17400,3741,13659,3.195,14.858,-3854,-3.291,23.134,162,163,1797
1983,3379,1066,1202,37106,36820,114,9.56,95,7.966,5284,1167,4117,3.169,14.351,4723,1313,3410,3.566,12.827,561,1.524,25.655,74,74,664
1983,3391,9749,10318,227989,228422,1275,12.538,977,9.608,24311,7388,16923,3.234,10.643,25190,5940,19250,2.6,11.028,-879,-0.385,21.286,720,721,3146
1983,3399,14347,14984,393849,407190,1860,12.468,1728,11.583,47332,15505,31827,3.808,11.624,74390,18463,55927,4.534,18.269,-27058,-6.645,23.248,1354,1356,10583
1983,4231,22714,27999,292230,297372,2653,9.445,2832,10.082,40743,13257,27486,4.458,13.701,50933,17888,33045,6.015,17.128,-10190,-3.427,27.402,1852,1925,10652
1983,4232,7644,8781,95030,95966,1037,11.783,1077,12.237,15351,4734,10617,4.933,15.996,17223,5521,11702,5.753,17.947,-1872,-1.951,31.993,761,775,3356
1983,4233,7256,8971,101198,101559,997,11.04,1117,12.369,17443,5319,12124,5.237,17.175,18145,6663,11482,6.561,17.866,-702,-0.691,34.35,722,734,3768
1983,4234,20729,28126,458665,449136,4432,16.265,2679,9.831,90387,32862,57525,7.317,20.125,70871,23387,47484,5.207,15.779,19516,4.345,31.559,1662,1686,9078
1983,4235,6283,8710,119351,128112,863,9.803,1049,11.916,13987,5865,8122,4.578,10.918,31495,10184,21311,7.949,24.584,-17508,-13.666,21.836,550,566,4301
1983,4236,14267,20519,256757,258290,2372,11.656,2033,9.99,43915,15353,28562,5.944,17.002,46681,17113,29568,6.625,18.073,-2766,-1.071,34.004,1160,1194,7034
1983,4237,10754,14017,146046,149254,1229,8.795,1142,8.173,18775,6348,12427,4.253,12.579,25188,7380,17808,4.945,16.876,-6413,-4.297,25.159,738,759,4400
1983,4238,46479,60699,611498,641542,5593,9.2,5776,9.501,79376,30835,48541,4.806,12.373,139831,34770,105061,5.42,21.796,-60455,-9.423,24.745,3576,3666,19095
1983,4239,21392,22986,199816,204917,3479,15.174,3362,14.664,37920,13492,24428,6.584,18.505,48063,17775,30288,8.674,23.455,-10143,-4.95,37.01,2575,2600,11723
1983,4241,7621,10183,138382,140839,1035,10.299,769,7.652,19252,6208,13044,4.408,13.67,24159,5948,18211,4.223,17.154,-4907,-3.484,27.339,503,507,2789
1983,4242,2689,3395,93967,92499,427,12.735,343,10.23,14367,3014,11353,3.258,15.532,11302,3047,8255,3.294,12.219,3065,3.314,24.437,237,237,1391
1983,4243,10642,11508,119467,120007,1770,15.518,1566,13.73,24710,10419,14291,8.682,20.591,25810,9540,16270,7.95,21.507,-1100,-0.917,41.181,1171,1182,5555
1983,4244,26827,32836,576617,579505,3478,10.631,3235,9.889,83294,23996,59298,4.141,14.373,88906,29462,59444,5.084,15.342,-5612,-0.968,28.747,2308,2346,16235
1983,4245,8379,11509,102630,105707,725,6.211,1051,9.004,14368,3973,10395,3.759,13.592,20473,5799,14674,5.486,19.368,-6105,-5.775,27.185,677,728,3930
1983,4246,6265,9392,112014,115262,1131,12.114,1019,10.915,18403,6259,12144,5.43,15.966,24817,7011,17806,6.083,21.531,-6414,-5.565,31.933,554,570,2646
1983,4247,11834,15304,151681,157414,1049,6.751,1520,9.782,23461,6928,16533,4.401,14.904,34777,11627,23150,7.386,22.093,-11316,-7.189,29.808,957,972,6918
1983,4248,4647,5787,136432,136603,359,6.166,430,7.385,15514,3579,11935,2.62,11.357,15895,6330,9565,4.634,11.636,-381,-0.279,22.714,274,282,3356
1983,4249,19153,23277,237699,240390,2905,12.555,2629,11.362,38242,14713,23529,6.12,15.908,43609,16551,27058,6.885,18.141,-5367,-2.233,31.817,1794,1816,8072
1983,4251,28330,30947,278039,283220,3467,11.29,2988,9.731,42519,14983,27536,5.29,15.013,52907,16722,36185,5.904,18.681,-10388,-3.668,30.025,1958,1965,9653
1983,4411,36491,37512,747702,742143,3796,10.094,3984,10.594,100677,34080,66597,4.592,13.566,89753,38282,51471,5.158,12.094,10924,1.472,24.188,3297,3313,32076
1983,4412,10954,11385,70155,70221,1266,11.083,1342,11.748,14054,5137,8917,7.315,20.014,14213,5572,8641,7.935,20.24,-159,-0.226,40.028,1056,1066,4402
1983,4413,44375,65174,417860,412164,6495,10.136,4306,6.72,71640,28205,43435,6.843,17.381,60333,18558,41775,4.503,14.638,11307,2.743,29.276,2744,2821,11023
1983,4421,21752,26219,196033,199062,2642,9.997,3062,11.586,32812,12026,20786,6.041,16.483,38696,14617,24079,7.343,19.439,-5884,-2.956,32.967,2198,2290,9789
1983,4422,19354,22959,122125,120570,3266,14.322,2956,12.963,27704,12405,15299,10.289,22.978,24361,9305,15056,7.718,20.205,3343,2.773,40.41,2113,2212,6594
1983,4431,23858,31191,177952,177149,4552,14.591,4564,14.63,41522,18060,23462,10.195,23.439,39801,18614,21187,10.508,22.468,1721,0.972,44.935,2850,3005,10495
1983,4441,55280,69833,625728,622692,5786,8.275,5970,8.538,95781,30881,64900,4.959,15.382,89833,29173,60660,4.685,14.427,5948,0.955,28.853,4089,4219,17631
1983,4442,14229,17232,116376,117378,1864,10.945,1461,8.579,18858,6988,11870,5.953,16.066,20822,6068,14754,5.17,17.739,-1964,-1.673,32.132,1028,1045,3856
1983,4451,65555,109427,1865125,1843027,11917,10.886,12005,10.966,299811,141290,158521,7.666,16.267,257065,105358,151707,5.717,13.948,42746,2.319,27.896,7340,7615,42497
1983,4452,23363,28733,176526,173723,4382,15.426,3731,13.134,42387,19182,23205,11.042,24.399,36631,16008,20623,9.215,21.086,5756,3.313,42.172,2780,2871,11721
1983,4453,28998,34386,168377,167540,3854,11.23,3719,10.837,35941,12826,23115,7.655,21.452,34272,13412,20860,8.005,20.456,1669,0.996,40.912,2786,2820,9383
1983,4461,42598,61422,550720,548371,6299,10.361,5043,8.295,84414,35408,49006,6.457,15.394,79381,27864,51517,5.081,14.476,5033,0.918,28.952,3117,3255,14950
1983,4471,98035,129703,751306,758730,17382,13.346,18460,14.174,167421,82527,84894,10.877,22.066,182168,78283,103885,10.318,24.01,-14747,-1.944,44.132,12499,12752,49634
1983,4481,57870,96221,781040,782755,10426,10.773,11534,11.918,153407,64978,88429,8.301,19.598,159433,56376,103057,7.202,20.368,-6026,-0.77,39.197,7274,7799,30109
1983,4482,12286,35617,184581,186734,3712,10.401,3853,10.796,36922,16129,20793,8.637,19.773,40861,15909,24952,8.52,21.882,-3939,-2.109,39.545,1388,1546,5354
1983,4483,17583,25194,144969,144670,2934,11.757,2458,9.849,27982,12879,15103,8.902,19.342,27632,9879,17753,6.829,19.1,350,0.242,38.2,1489,1565,5768
1983,4511,31544,41867,257156,252995,5747,13.758,5560,13.31,55363,23121,32242,9.139,21.883,47315,19894,27421,7.863,18.702,8048,3.181,37.404,3981,4138,12945
1983,4512,7652,11393,69972,68087,1618,14.475,1188,10.628,15916,6777,9139,9.954,23.376,12292,4474,7818,6.571,18.054,3624,5.323,36.107,861,885,2897
1983,4522,449,6613,1025741,1055250,347,5.197,474,7.1,82481,34479,48002,3.267,7.816,139114,49384,89730,4.68,13.183,-56633,-5.367,15.633,18,22,916
1983,4523,12870,26929,721421,744061,2456,9.005,3143,11.524,78427,35957,42470,4.833,10.54,124935,47314,77621,6.359,16.791,-46508,-6.251,21.081,1507,1544,6330
1983,4531,20940,22290,104169,102997,3350,15.323,2494,11.408,22471,9612,12859,9.332,21.817,20152,7606,12546,7.385,19.566,2319,2.252,39.131,1886,1910,5663
1983,4532,24381,29978,184718,178816,4708,16.023,3516,11.967,46536,25457,21079,14.236,26.025,35278,14105,21173,7.888,19.729,11258,6.296,39.457,2563,2642,8976
1983,4533,9001,10843,49096,49398,1686,15.718,1453,13.546,11775,4925,6850,9.97,23.837,12420,3635,8785,7.359,25.143,-645,-1.306,47.674,1063,1065,2445
1983,4539,25940,31485,137169,135078,4943,15.905,4129,13.286,35818,16801,19017,12.438,26.517,31761,13408,18353,9.926,23.513,4057,3.003,47.026,2896,3022,9488
1983,4541,5725,7385,92923,92438,980,13.234,1020,13.774,19366,7018,12348,7.592,20.95,18239,7350,10889,7.951,19.731,1127,1.219,39.462,668,673,2878
1983,4542,3964,5214,78002,79312,523,9.843,722,13.588,12383,3324,9059,4.191,15.613,15054,5661,9393,7.138,18.981,-2671,-3.368,31.226,380,383,1694
1983,4543,16235,21792,189680,191277,2256,10.396,2072,9.548,31202,10898,20304,5.697,16.312,34672,11734,22938,6.135,18.127,-3470,-1.814,32.625,1423,1454,6432
1983,4811,1101,2782,283586,280522,352,12.779,297,10.782,37731,12357,25374,4.405,13.45,30276,6231,24045,2.221,10.793,7455,2.658,21.585,131,131,1013
1983,4812,449,639,8047,8068,101,15.968,88,13.913,1642,463,1179,5.739,20.352,1652,446,1206,5.528,20.476,-10,-0.124,40.704,65,65,407
1983,4831,398,663,33910,34956,57,8.501,72,10.738,6337,2785,3552,7.967,18.129,8227,1948,6279,5.573,23.536,-1890,-5.407,36.258,34,34,324
1983,4832,400,459,14535,15678,41,8.779,57,12.206,1190,434,756,2.768,7.59,3475,542,2933,3.457,22.165,-2285,-14.575,15.181,38,38,312
1983,4841,20103,25475,457315,466164,4284,16.785,4380,17.161,70375,25484,44891,5.467,15.097,89039,31284,57755,6.711,19.1,-18664,-4.004,30.193,3044,3063,15134
1983,4842,40906,44799,517792,526017,6744,15.092,6515,14.58,89386,29811,59575,5.667,16.993,106428,33374,73054,6.345,20.233,-17042,-3.24,33.986,4811,4835,20678
1983,4851,374,402,30514,27135,49,12.189,49,12.189,8938,3302,5636,12.169,32.94,1752,641,1111,2.362,6.457,7186,26.483,12.913,40,42,623
1983,4852,358,700,28317,28972,43,6.178,35,5.029,3039,1412,1627,4.874,10.489,4390,1035,3355,3.572,15.153,-1351,-4.663,20.979,17,17,149
1983,4853,5248,5306,52859,54574,812,15.162,911,17.011,9037,3366,5671,6.168,16.559,12481,4623,7858,8.471,22.87,-3444,-6.311,33.119,770,770,4000
1983,4854,3443,3641,92375,92334,299,8.187,321,8.79,10740,3017,7723,3.268,11.632,10734,3831,6903,4.149,11.625,6,0.006,23.25,268,268,2458
1983,4855,513,547,11930,11704,90,16.605,80,14.76,2600,644,1956,5.502,22.215,2098,1044,1054,8.92,17.925,502,4.289,35.851,57,57,450
1983,4859,910,961,19231,19294,153,16.156,125,13.2,3535,1460,2075,7.567,18.322,3668,1653,2015,8.568,19.012,-133,-0.689,36.644,99,102,1477
1983,4861,83,331,12089,12421,32,9.682,31,9.38,1555,735,820,5.918,12.52,2257,544,1713,4.38,18.172,-702,-5.652,25.039,8,8,169
1983,4862,239,1290,63179,63147,119,9.493,46,3.67,5804,3220,2584,5.099,9.191,5612,839,4773,1.329,8.887,192,0.304,17.775,24,24,82
1983,4869,59,325,7485,7291,47,14.944,26,8.267,1410,876,534,12.015,19.339,1026,457,569,6.268,14.072,384,5.267,28.144,3,3,20
1983,4871,173,177,2783,2794,40,23.392,28,16.374,568,237,331,8.482,20.329,588,208,380,7.445,21.045,-20,-0.716,40.659,20,20,168
1983,4872,653,659,8104,8591,115,17.665,99,15.207,1263,398,865,4.633,14.702,2282,622,1660,7.241,26.564,-1019,-11.862,29.405,79,79,560
1983,4879,54,64,1847,1875,14,23.14,7,11.57,201,49,152,2.613,10.72,242,29,213,1.547,12.907,-41,-2.187,21.44,5,5,27
1983,4881,2003,2563,57539,56536,369,14.559,312,12.31,10869,3872,6997,6.849,19.225,8901,2258,6643,3.994,15.744,1968,3.481,31.488,231,233,1423
1983,4882,350,441,10766,11707,70,15.964,65,14.823,1601,407,1194,3.477,13.676,3541,1322,2219,11.293,30.248,-1940,-16.572,27.352,31,31,587
1983,4883,2184,2617,106710,112689,340,12.935,363,13.81,16434,5429,11005,4.818,14.583,28505,5522,22983,4.9,25.295,-12071,-10.712,29.167,237,238,3258
1983,4884,1657,2142,29752,31616,324,14.764,429,19.549,4276,1713,2563,5.418,13.525,8001,3432,4569,10.855,25.307,-3725,-11.782,27.05,306,341,2454
1983,4885,4731,6581,82063,83271,1069,16.712,700,10.943,14629,6334,8295,7.607,17.568,17085,4500,12585,5.404,20.517,-2456,-2.949,35.136,501,503,2368
1983,4889,369,379,5364,5923,62,16.316,64,16.842,1103,248,855,4.187,18.622,2173,803,1370,13.557,36.687,-1070,-18.065,37.245,53,53,544
1983,4921,1194,1799,74008,73809,379,21.657,281,16.057,9064,3031,6033,4.107,12.28,8678,3359,5319,4.551,11.757,386,0.523,23.515,177,177,1107
1983,4922,908,921,6324,5515,426,52.399,210,25.83,2896,2254,642,40.874,52.516,1246,737,509,13.365,22.595,1650,29.921,45.19,182,182,662
1983,4931,6126,9606,360226,368350,775,7.997,946,9.761,51148,13686,37462,3.715,13.886,67181,18572,48609,5.042,18.238,-16033,-4.353,27.771,312,328,2884
1983,5111,13118,14983,602672,604313,1561,10.492,1352,9.087,47895,13867,34028,2.295,7.926,51043,13745,37298,2.274,8.446,-3148,-0.521,15.851,1064,1064,8538
1983,5112,7087,8349,131769,127652,1355,16.337,1245,15.011,31845,8167,23678,6.398,24.947,23837,9665,14172,7.571,18.673,8008,6.273,37.347,844,857,4084
1983,5121,8875,14210,202697,207555,2186,15.387,2180,15.345,45735,15693,30042,7.561,22.035,54680,15059,39621,7.255,26.345,-8945,-4.31,44.07,1121,1205,8058
1983,5122,1570,1574,10520,10509,478,31.92,325,21.703,3136,1925,1211,18.318,29.841,3060,1358,1702,12.922,29.118,76,0.723,58.236,259,259,960
1983,5151,5996,7058,216642,212955,829,11.941,598,8.614,31607,13497,18110,6.338,14.842,24103,9795,14308,4.6,11.318,7504,3.524,22.637,454,455,7205
1983,5152,5,5,48,52,0,0,0,0,0,0,0,0,0,8,0,8,0,15.534,-8,-15.534,0,0,0,0
1983,5173,2376,12056,939954,960336,1338,10.389,2983,23.163,455926,35128,420798,3.658,47.476,508325,221055,287270,23.019,52.932,-52399,-5.456,94.951,142,142,1407
1983,5174,679,1263,52916,54418,205,16.956,97,8.023,13764,3757,10007,6.904,25.293,16534,13281,3253,24.406,30.384,-2770,-5.09,50.587,67,67,1010
1983,5179,1179,2241,67501,72509,484,22.181,366,16.774,26522,6088,20434,8.396,36.578,37213,13136,24077,18.116,51.322,-10691,-14.744,73.155,133,133,1074
1983,5182,5783,7559,221544,216529,1191,15.89,1064,14.195,48855,17267,31588,7.974,22.563,38959,13296,25663,6.141,17.993,9896,4.57,35.985,660,666,5177
1983,5191,2122,2550,29415,29173,314,12.687,164,6.626,3780,1210,2570,4.148,12.957,3325,659,2666,2.259,11.398,455,1.56,22.795,130,130,457
1983,5211,37,75,24518,24585,10,13.986,3,4.196,742,384,358,1.562,3.018,886,213,673,0.866,3.604,-144,-0.586,6.036,(D),(D),(D)
1983,5221,20331,68078,1864124,1856409,3941,5.861,2265,3.369,200359,55413,144946,2.985,10.793,186005,42132,143873,2.27,10.02,14354,0.773,20.039,929,1043,20222
1983,5222,22272,39330,355747,345202,2781,6.974,3880,9.729,72582,20994,51588,6.082,21.026,51563,23035,28528,6.673,14.937,21019,6.089,29.874,1526,1541,6367
1983,5223,3061,3491,40307,39497,859,25.669,570,17.033,9892,3733,6159,9.451,25.045,8166,5405,2761,13.685,20.675,1726,4.37,41.35,414,414,1741
1983,5231,5624,10612,250864,239319,1764,17.212,1037,10.119,50132,14687,35445,6.137,20.948,27051,8822,18229,3.686,11.303,23081,9.644,22.607,603,616,3928
1983,5232,119,133,6682,6424,21,15.909,19,14.394,793,152,641,2.366,12.345,285,124,161,1.93,4.437,508,7.908,8.874,12,12,43
1983,5239,13564,13936,179590,158176,3968,30.665,1976,15.27,70799,37525,33274,23.724,44.76,28660,12885,15775,8.146,18.119,42139,26.641,36.238,1569,1577,7441
1983,5241,6235,30904,1256040,1240664,3385,11.081,2675,8.756,169115,52428,116687,4.226,13.631,140073,40157,99916,3.237,11.29,29042,2.341,22.58,376,381,3331
1983,5242,94623,99340,983080,890699,17014,17.831,9170,9.61,329076,130768,198308,14.682,36.946,141192,71519,69673,8.03,15.852,187884,21.094,31.704,6755,6769,56166
1983,5259,653,848,10196,10286,103,12.447,62,7.492,2536,1115,1421,10.84,24.655,2525,226,2299,2.197,24.548,11,0.107,49.096,47,48,152
1983,5311,96534,98622,488521,489210,12182,12.305,12937,13.068,102402,48458,53944,9.905,20.932,103453,46039,57414,9.411,21.147,-1051,-0.215,41.864,10444,10462,36376
1983,5312,31823,33048,175890,174637,5693,17.295,5431,16.499,44287,20918,23369,11.978,25.36,42084,17184,24900,9.84,24.098,2203,1.261,48.196,3908,3910,11384
1983,5313,19866,20468,194236,190308,3708,18.284,3333,16.435,45086,19380,25706,10.183,23.691,37445,17430,20015,9.159,19.676,7641,4.015,39.352,2510,2513,10673
1983,5321,5369,8825,101779,100165,1179,13.308,1247,14.076,25876,7324,18552,7.312,25.834,22673,11425,11248,11.406,22.636,3203,3.198,45.272,656,675,3173
1983,5322,9720,11734,94613,95689,2398,20.966,1805,15.781,23279,10123,13156,10.579,24.328,25829,9154,16675,9.566,26.993,-2550,-2.665,48.656,1267,1281,6394
1983,5323,2682,3061,20813,20968,594,20.102,382,12.927,4660,2206,2454,10.521,22.224,5114,1474,3640,7.03,24.39,-454,-2.165,44.449,277,278,1050
1983,5324,4834,5644,52954,52533,988,18.349,469,8.71,12458,5713,6745,10.875,23.715,11717,2812,8905,5.353,22.304,741,1.411,44.608,314,315,1669
1983,5331,876,934,10475,10699,144,15.238,166,17.566,2550,963,1587,9.001,23.834,3010,1057,1953,9.879,28.133,-460,-4.299,47.668,123,123,705
1983,5411,118526,122193,644472,627152,17214,14.45,11083,9.303,121508,48976,72532,7.809,19.375,86914,32380,54534,5.163,13.859,34594,5.516,27.717,8287,8343,25076
1983,5412,50441,53317,418731,412075,9345,17.973,6702,12.89,80499,35476,45023,8.609,19.535,66845,30131,36714,7.312,16.222,13654,3.313,32.443,4945,5055,23461
1983,5413,46620,51205,609858,625845,8060,15.951,6711,13.281,108805,41080,67725,6.564,17.385,140994,35475,105519,5.668,22.529,-32189,-5.143,34.771,4613,4645,21269
1983,5414,11717,11944,78562,81418,2296,19.144,2395,19.969,17014,7507,9507,9.22,20.897,22600,9662,12938,11.867,27.758,-5586,-6.861,41.794,1894,1895,6635
1983,5415,5037,5988,54145,49456,3028,62.228,784,16.112,21783,14055,7728,28.419,44.046,12841,7962,4879,16.099,25.965,8942,18.081,51.93,463,470,1686
1983,5416,28175,29344,245690,231449,8466,32.014,2667,10.085,78851,40591,38260,17.538,34.068,50015,13084,36931,5.653,21.61,28836,12.459,43.219,1799,1803,9114
1983,5417,5583,6829,392010,394313,1155,17.788,483,7.439,42120,15739,26381,3.992,10.682,47565,11084,36481,2.811,12.063,-5445,-1.381,21.364,224,228,1467
1983,5418,21658,23704,283367,278958,4052,17.527,2880,12.458,54022,21517,32505,7.713,19.366,45183,18503,26680,6.633,16.197,8839,3.169,32.394,2140,2155,12129
1983,5419,26645,29342,191417,185519,4325,15.236,2414,8.504,46008,18487,27521,9.965,24.8,33821,10066,23755,5.426,18.23,12187,6.569,36.461,1748,1768,6517
1983,5511,22676,42568,2757148,2785990,4180,9.792,4418,10.35,447166,136589,310577,4.903,16.051,504436,121497,382939,4.361,18.106,-57270,-2.056,32.101,646,662,7502
1983,5611,8723,9182,127817,119310,2047,24.58,339,4.071,34406,14657,19749,12.285,28.837,17346,2345,15001,1.965,14.539,17060,14.299,29.077,153,154,1314
1983,5612,127,130,7306,6270,56,50.45,18,16.216,4263,3632,631,57.931,67.996,2241,174,2067,2.775,35.744,2022,32.251,71.489,11,11,84
1983,5613,11112,14647,540999,547249,2464,16.768,2559,17.415,153452,39477,113975,7.214,28.041,165327,37974,127353,6.939,30.211,-11875,-2.17,56.081,1682,1702,21114
1983,5614,17386,19510,198022,199275,3166,16.235,3149,16.147,40149,15132,25017,7.594,20.148,43163,16733,26430,8.397,21.66,-3014,-1.512,40.295,2439,2448,9532
1983,5615,18727,21924,159396,156628,3330,15.646,2050,9.632,35006,12967,22039,8.279,22.35,29217,13701,15516,8.747,18.654,5789,3.696,37.308,1459,1496,7694
1983,5616,10098,12386,372453,372304,2280,18.241,2507,20.057,85577,27334,58243,7.342,22.986,83924,36755,47169,9.872,22.542,1653,0.444,45.084,1933,1944,19357
1983,5617,54663,57638,701915,691940,13082,23.574,8793,15.845,163350,63793,99557,9.219,23.608,143590,48126,95464,6.955,20.752,19760,2.856,41.504,6839,6851,35121
1983,5619,10853,11740,153680,154022,2181,18.25,2602,21.773,34746,11687,23059,7.588,22.559,35734,13984,21750,9.079,23.201,-988,-0.641,45.118,2053,2062,9319
1983,5621,3999,4168,78692,82487,482,11.369,625,14.742,10092,2414,7678,2.927,12.235,17972,6415,11557,7.777,21.788,-7880,-9.553,24.469,501,501,4112
1983,5622,2056,2521,43638,42584,297,11.885,253,10.124,8076,2836,5240,6.66,18.965,6004,2469,3535,5.798,14.099,2072,4.866,28.199,180,180,1055
1983,5629,4323,4553,36605,36559,659,14.549,612,13.511,8559,3297,5262,9.018,23.411,8437,2581,5856,7.06,23.078,122,0.334,46.156,459,459,1894
1983,6111,12780,13119,358064,352281,719,5.534,466,3.587,36288,7197,29091,2.043,10.301,24558,4604,19954,1.307,6.971,11730,3.33,13.942,355,355,3469
1983,6112,432,526,35544,34669,40,7.641,35,6.686,5183,528,4655,1.523,14.95,3529,1264,2265,3.646,10.179,1654,4.771,20.359,22,22,190
1983,6113,1994,2328,919079,901328,139,6.067,65,2.837,76390,7880,68510,0.874,8.475,40689,1147,39542,0.127,4.514,35701,3.961,9.029,39,40,695
1983,6114,1763,2012,29587,28111,425,22.049,256,13.281,7315,2660,4655,9.463,26.022,4458,1387,3071,4.934,15.859,2857,10.163,31.718,205,205,1024
1983,6115,2867,3283,38683,38418,518,15.657,569,17.198,8948,3561,5387,9.269,23.291,8461,3636,4825,9.464,22.024,487,1.268,44.048,395,417,2472
1983,6116,10117,10626,90348,89590,2012,19.276,1636,15.674,19996,9177,10819,10.243,22.32,18409,7221,11188,8.06,20.548,1587,1.771,41.096,1288,1299,4954
1983,6117,1225,1250,21705,21328,302,26.48,83,7.278,2534,1203,1331,5.641,11.881,1807,330,1477,1.547,8.473,727,3.409,16.945,52,52,193
1983,6211,177287,182760,988494,962307,18002,10.061,10336,5.777,172738,68408,104330,7.109,17.95,119981,35498,84483,3.689,12.468,52757,5.482,24.936,8118,8171,26605
1983,6212,92636,94760,418134,408798,7171,7.674,4537,4.855,69441,23245,46196,5.686,16.987,50649,14425,36224,3.529,12.39,18792,4.597,24.78,3518,3560,11281
1983,6213,38603,40369,129634,123314,6485,16.744,3206,8.278,33061,16610,16451,13.47,26.811,20399,8277,12122,6.712,16.542,12662,10.268,33.085,2257,2290,6153
1983,6214,5018,6419,111095,104924,1127,18.324,590,9.593,26384,12576,13808,11.986,25.146,13854,4434,9420,4.226,13.204,12530,11.942,26.408,368,371,2259
1983,6215,3940,4945,63526,63051,652,13.429,472,9.722,10837,3472,7365,5.507,17.188,9986,3732,6254,5.919,15.838,851,1.35,31.676,327,340,2735
1983,6216,3244,4306,158177,150955,836,20.518,373,9.154,39221,13864,25357,9.184,25.982,24726,4970,19756,3.292,16.38,14495,9.602,32.759,252,257,3080
1983,6219,3256,3792,74463,73098,752,21,330,9.215,15809,6192,9617,8.471,21.627,12887,4233,8654,5.791,17.63,2922,3.997,35.26,213,214,2398
1983,6221,3676,4816,2902820,2842744,260,5.439,189,3.954,248693,122002,126691,4.292,8.748,125941,31342,94599,1.103,4.43,122752,4.318,8.861,92,97,15787
1983,6222,346,485,186512,117077,60,12.752,31,6.589,140702,139158,1544,118.86,120.179,4008,1698,2310,1.45,3.423,136694,116.756,6.847,20,20,1203
1983,6223,191,234,44920,43767,17,7.203,21,8.898,3735,1029,2706,2.351,8.534,1419,462,957,1.056,3.242,2316,5.292,6.484,11,11,314
1983,6231,8559,12348,959781,951453,950,7.756,751,6.131,116807,48811,67996,5.13,12.277,99090,38421,60669,4.038,10.415,17717,1.862,20.829,468,501,23797
1983,6232,3795,5081,112606,106528,766,15.958,204,4.25,24176,10679,13497,10.025,22.695,11902,2256,9646,2.118,11.173,12274,11.522,22.345,127,132,1545
1983,6233,6766,7810,218236,217613,1074,13.987,811,10.562,32553,14550,18003,6.686,14.959,31189,16067,15122,7.383,14.332,1364,0.627,28.665,527,539,11317
1983,6239,2558,3111,73408,71439,348,11.487,185,6.107,11600,4710,6890,6.593,16.238,7658,1919,5739,2.686,10.72,3942,5.518,21.439,114,117,1182
1983,6241,12817,17618,251958,249991,2190,12.768,1258,7.334,50885,17756,33129,7.103,20.355,46585,9819,36766,3.928,18.635,4300,1.72,37.269,683,709,4751
1983,6242,3561,4259,37573,37430,582,14.128,303,7.355,8042,2967,5075,7.927,21.485,7735,1665,6070,4.448,20.665,307,0.82,41.33,160,163,932
1983,6243,3646,5321,229604,222815,598,11.394,453,8.631,53331,10004,43327,4.49,23.935,39042,7425,31617,3.332,17.522,14289,6.413,35.044,205,217,3193
1983,6244,27134,31952,266461,263189,4656,14.945,3060,9.822,54265,24071,30194,9.146,20.618,48088,15440,32648,5.867,18.271,6177,2.347,36.543,2220,2264,10469
1983,7111,4902,4950,66549,65537,847,17.03,894,17.975,18970,5338,13632,8.145,28.945,17200,5686,11514,8.676,26.245,1770,2.701,52.489,667,667,4337
1983,7112,2174,2274,61985,60380,437,19.561,357,15.98,13196,5272,7924,8.731,21.855,9885,3636,6249,6.022,16.371,3311,5.484,32.743,269,272,1662
1983,7113,2093,2128,27282,27139,378,17.881,350,16.556,8823,3502,5321,12.904,32.51,8604,2503,6101,9.223,31.703,219,0.807,63.407,236,236,1861
1983,7114,940,957,9376,9523,191,20.18,170,17.961,3189,1419,1770,14.902,33.489,3509,1812,1697,19.029,36.85,-320,-3.36,66.978,129,129,1240
1983,7115,6784,6808,30874,29251,2680,44.316,1159,19.165,13775,9635,4140,32.94,47.093,10465,3704,6761,12.663,35.777,3310,11.316,71.554,811,811,2434
1983,7121,1986,2126,32405,32573,178,8.628,52,2.521,3318,631,2687,1.937,10.186,3605,214,3391,0.657,11.067,-287,-0.881,20.373,29,29,119
1983,7131,2335,2790,59801,57529,707,26.425,478,17.866,11717,3355,8362,5.832,20.367,6912,2178,4734,3.786,12.015,4805,8.352,24.03,382,387,1456
1983,7132,671,696,17468,18244,126,18.354,107,15.586,2507,1170,1337,6.413,13.742,4020,1277,2743,7,22.035,-1513,-8.293,27.484,86,86,1131
1983,7139,31800,33760,460296,461968,4910,14.805,3719,11.214,83158,35938,47220,7.779,18.001,86689,27510,59179,5.955,18.765,-3531,-0.764,36.002,2793,2811,19500
1983,7211,28716,32967,1062649,1073107,4286,13.081,3880,11.842,175202,85732,89470,7.989,16.327,196882,73010,123872,6.804,18.347,-21680,-2.02,32.653,2807,2839,43254
1983,7212,3532,3778,20070,20164,553,14.9,420,11.316,5433,2179,3254,10.806,26.944,5532,2008,3524,9.958,27.435,-99,-0.491,53.888,256,256,1437
1983,7213,4748,4854,22776,22550,311,6.38,352,7.221,3943,1065,2878,4.723,17.486,3435,985,2450,4.368,15.233,508,2.253,30.466,261,264,793
1983,7223,16926,26138,473604,473222,4694,18.03,4486,17.231,119188,61832,57356,13.066,25.186,117803,59015,58788,12.471,24.894,1385,0.293,49.788,2467,2483,20540
1983,7224,59271,60069,324042,324305,9740,16.204,9821,16.339,90863,52086,38777,16.061,28.018,91172,41816,49356,12.894,28.113,-309,-0.095,56.036,7915,7936,33238
1983,7225,187391,241489,4087111,4007187,42460,17.989,31549,13.366,968694,530122,438572,13.229,24.174,806819,329727,477092,8.228,20.134,161875,4.04,40.269,23144,23701,220672
1983,8111,93096,97460,438928,433283,16226,17.046,11680,12.271,100173,49094,51079,11.331,23.12,88976,35618,53358,8.22,20.535,11197,2.584,41.071,8920,8977,27706
1983,8112,9440,10532,64937,62613,1639,15.812,1306,12.599,15298,9105,6193,14.542,24.433,10618,4445,6173,7.099,16.958,4680,7.475,33.917,949,958,2731
1983,8113,17361,18282,126983,133043,2619,14.364,2522,13.832,23028,9239,13789,6.944,17.309,34990,12223,22767,9.187,26.3,-11962,-8.991,34.618,1912,1913,8352
1983,8114,22274,23863,136431,136834,3938,16.639,3546,14.983,26595,12207,14388,8.921,19.436,27241,10001,17240,7.309,19.908,-646,-0.472,38.872,2570,2586,6889
1983,8121,80376,89370,433073,424192,12226,13.739,11456,12.874,99656,45718,53938,10.778,23.493,82173,37291,44882,8.791,19.372,17483,4.121,38.743,8798,8887,26646
1983,8122,17112,19834,112853,112311,1411,7.144,1244,6.299,16562,5346,11216,4.76,14.747,15470,4091,11379,3.643,13.774,1092,0.972,27.549,808,834,2781
1983,8123,32508,38322,328901,331090,4733,12.393,4472,11.709,52176,22154,30022,6.691,15.759,56518,22849,33669,6.901,17.07,-4342,-1.311,31.518,3254,3397,14786
1983,8129,12264,18965,198199,198399,3884,20.689,3500,18.644,48096,18425,29671,9.287,24.242,49611,24325,25286,12.261,25.006,-1515,-0.764,48.484,2148,2212,15523
1983,8131,79340,79454,747741,730858,7264,9.392,3035,3.924,100625,23354,77271,3.195,13.768,66993,10785,56208,1.476,9.166,33632,4.602,18.333,1605,1605,6627
1983,8132,6935,7950,107867,107831,842,10.762,590,7.541,17394,3781,13613,3.506,16.131,17260,4995,12265,4.632,16.007,134,0.124,32.013,328,341,2689
1983,8133,6660,7765,84309,83983,917,11.935,754,9.813,17088,4806,12282,5.723,20.347,16642,4145,12497,4.936,19.816,446,0.531,39.632,422,447,2455
1983,8134,28253,29608,243154,242744,2064,7.019,1663,5.655,34381,8066,26315,3.323,14.164,33513,6472,27041,2.666,13.806,868,0.358,27.612,1140,1140,4033
1983,8139,54423,56576,428860,427470,4366,7.704,4560,8.046,76167,23166,53001,5.419,17.818,73351,17079,56272,3.995,17.159,2816,0.659,34.319,3233,3245,11500
1984,1131,226,233,3914,3843,43,19.154,26,11.581,681,178,503,4.632,17.723,553,137,416,3.565,14.392,128,3.331,28.783,17,17,96
1984,1132,90,105,1337,1276,22,22.564,7,7.179,270,153,117,11.995,21.168,142,32,110,2.509,11.133,128,10.035,22.266,5,5,18
1984,1133,10629,10733,90280,86316,1913,18.317,1335,12.782,24074,7934,16140,9.192,27.891,16018,5608,10410,6.497,18.557,8056,9.333,37.115,996,998,4126
1984,1141,1252,1268,8644,8561,214,16.519,269,20.764,3047,950,2097,11.097,35.594,2870,1283,1587,14.987,33.526,177,2.068,67.052,170,170,719
1984,1142,132,133,592,554,21,16.092,16,12.261,199,45,154,8.13,35.953,132,54,78,9.756,23.848,67,12.105,47.696,13,13,50
1984,1151,4068,4464,52065,51662,566,12.761,509,11.476,14011,5526,8485,10.697,27.121,13477,3217,10260,6.227,26.087,534,1.034,52.174,340,343,2399
1984,1152,1776,1793,13171,12784,282,15.991,223,12.645,2706,825,1881,6.454,21.168,1890,677,1213,5.296,14.785,816,6.383,29.569,183,183,518
1984,1153,754,766,10086,10046,170,22.942,120,16.194,3136,1131,2005,11.259,31.218,3059,1236,1823,12.304,30.451,77,0.767,60.903,84,84,1096
1984,2111,7969,9945,186640,176579,1276,12.882,1196,12.075,52206,8996,43210,5.095,29.565,33546,10859,22687,6.15,18.998,18660,10.568,37.995,782,798,4481
1984,2121,2747,3457,183528,184373,575,16.604,587,16.951,31828,9100,22728,4.936,17.263,33083,10666,22417,5.785,17.944,-1255,-0.681,34.526,452,452,6256
1984,2122,544,704,46776,46422,160,22.792,156,22.222,8449,2169,6280,4.672,18.2,7916,2212,5704,4.765,17.052,533,1.148,34.105,111,114,899
1984,2123,3545,5003,98663,97737,427,8.555,403,8.075,16230,3726,12504,3.812,16.606,14270,4094,10176,4.189,14.6,1960,2.005,29.201,248,251,1294
1984,2131,11014,12669,283041,285365,2064,16.245,2137,16.819,64923,19768,45155,6.927,22.751,69682,24992,44690,8.758,24.419,-4759,-1.668,45.502,1617,1626,14421
1984,2211,1606,5824,586314,583976,223,3.861,125,2.165,30309,7900,22409,1.353,5.19,25617,3246,22371,0.556,4.387,4692,0.803,8.773,40,40,252
1984,2212,538,2388,139919,138705,147,6.231,89,3.773,8523,2760,5763,1.99,6.145,6003,925,5078,0.667,4.328,2520,1.817,8.656,29,29,171
1984,2213,3715,4019,29561,29188,355,8.97,232,5.862,3445,1214,2231,4.159,11.803,2766,978,1788,3.351,9.476,679,2.326,18.953,172,172,705
1984,2361,89062,89435,519166,470939,21999,25.83,13464,15.809,211931,85588,126343,18.174,45.002,115399,47797,67602,10.149,24.504,96532,20.498,49.008,9719,9721,35962
1984,2362,35482,36081,609722,585859,5743,16.343,3863,10.993,181057,38738,142319,6.612,30.905,133765,25298,108467,4.318,22.832,47292,8.072,45.665,2761,2764,18518
1984,2371,12892,13213,309377,305591,1759,13.414,1560,11.896,72183,13389,58794,4.381,23.621,65078,14687,50391,4.806,21.296,7105,2.325,42.592,1173,1173,10048
1984,2372,8027,8139,68459,60886,2305,30.107,1339,17.49,28270,13666,14604,22.445,46.431,13146,5407,7739,8.881,21.591,15124,24.84,43.182,1046,1047,4179
1984,2373,9793,10075,205327,194884,1237,12.458,945,9.518,58219,12047,46172,6.182,29.874,37548,9005,28543,4.621,19.267,20671,10.607,38.534,695,695,6503
1984,2379,4557,4667,97985,100392,890,19.526,672,14.743,22363,5938,16425,5.915,22.276,27660,3714,23946,3.699,27.552,-5297,-5.276,44.551,503,504,2382
1984,2381,64541,64933,593213,552760,12079,19.258,7654,12.203,210138,60690,149448,10.979,38.016,129177,41957,87220,7.59,23.369,80961,14.647,46.739,5659,5660,31930
1984,2382,99587,101509,1037531,982562,15669,15.904,9696,9.841,279605,68267,211338,6.948,28.457,169433,44679,124754,4.547,17.244,110172,11.213,34.488,7411,7417,34605
1984,2383,65200,65595,535754,498297,13688,21.669,8834,13.985,189343,58647,130696,11.769,37.998,114604,37541,77063,7.534,22.999,74739,14.999,45.998,6563,6565,28726
1984,2389,34480,34729,308603,290673,5963,17.596,4280,12.63,102302,28785,73517,9.903,35.195,66695,18957,47738,6.522,22.945,35607,12.25,45.89,3151,3153,14231
1984,3111,1322,1946,53024,53376,108,5.495,147,7.479,5495,1580,3915,2.96,10.295,6229,1584,4645,2.968,11.67,-734,-1.375,20.59,100,100,643
1984,3112,542,888,69352,71523,53,5.989,47,5.311,4234,777,3457,1.086,5.92,8613,2205,6408,3.083,12.042,-4379,-6.123,11.84,25,25,157
1984,3113,1470,1816,87234,86276,236,13.206,178,9.961,10594,2622,7972,3.039,12.279,8852,3196,5656,3.704,10.26,1742,2.019,20.52,114,115,1054
1984,3114,1242,1715,175333,174792,123,7.126,145,8.401,23225,2901,20324,1.66,13.287,22276,5208,17068,2.98,12.744,949,0.543,25.489,87,87,1421
1984,3115,1816,2520,133807,134262,142,5.6,173,6.823,12257,2218,10039,1.652,9.129,13111,3262,9849,2.43,9.765,-854,-0.636,18.258,115,116,1323
1984,3116,4237,4832,329409,323346,348,7.169,392,8.076,38590,7690,30900,2.378,11.935,26893,7957,18936,2.461,8.317,11697,3.617,16.634,276,279,3422
1984,3117,761,871,44926,46375,50,5.624,86,9.674,6472,654,5818,1.41,13.956,9345,2218,7127,4.783,20.151,-2873,-6.195,27.912,56,58,1088
1984,3118,8880,10340,304914,303197,1425,13.919,1221,11.926,36110,13010,23100,4.291,11.91,32491,12942,19549,4.269,10.716,3619,1.194,21.432,887,901,7469
1984,3119,2053,2413,125209,123554,207,8.573,210,8.697,16004,5454,10550,4.414,12.953,12669,4872,7797,3.943,10.254,3335,2.699,20.508,146,146,2076
1984,3121,1996,2558,173255,173631,185,7.242,178,6.968,15890,4183,11707,2.409,9.152,16687,5126,11561,2.952,9.611,-797,-0.459,18.303,122,122,2672
1984,3122,107,161,41337,42360,9,5.488,15,9.146,2784,80,2704,0.189,6.572,4970,600,4370,1.416,11.733,-2186,-5.161,13.145,8,8,19
1984,3131,467,684,108835,106608,36,5.255,38,5.547,11488,1566,9922,1.469,10.776,6938,2724,4214,2.555,6.508,4550,4.268,13.016,23,23,649
1984,3132,1752,2132,298867,295523,138,6.431,166,7.735,28666,3622,25044,1.226,9.7,22171,6501,15670,2.2,7.502,6495,2.198,15.005,111,111,1853
1984,3133,1623,1863,111389,109906,154,8.327,127,6.867,12518,1816,10702,1.652,11.39,9650,4057,5593,3.691,8.78,2868,2.61,17.56,92,92,1008
1984,3141,3911,4191,124611,118714,459,10.961,452,10.794,22380,3769,18611,3.175,18.852,10603,5324,5279,4.485,8.932,11777,9.92,17.863,358,358,2475
1984,3149,3640,3775,130450,126145,567,15.362,399,10.81,24315,7596,16719,6.022,19.275,15708,7287,8421,5.777,12.452,8607,6.823,24.905,310,311,5518
1984,3151,1369,1491,148189,142923,144,9.69,134,9.017,20770,4972,15798,3.479,14.532,10439,3736,6703,2.614,7.304,10331,7.228,14.608,109,109,1816
1984,3152,11907,13433,898638,873956,1759,12.993,1969,14.544,155335,46124,109211,5.278,17.774,106397,46183,60214,5.284,12.174,48938,5.6,24.348,1689,1700,33320
1984,3159,1922,2029,77550,74566,285,14.311,210,10.545,14388,4490,9898,6.022,19.296,8332,2838,5494,3.806,11.174,6056,8.122,22.348,172,172,1960
1984,3161,370,405,18283,18629,42,10.461,35,8.717,2200,520,1680,2.791,11.81,2890,748,2142,4.015,15.513,-690,-3.704,23.619,26,26,435
1984,3162,497,712,120463,123610,43,5.882,81,11.081,10574,2268,8306,1.835,8.554,17007,4769,12238,3.858,13.759,-6433,-5.204,17.109,50,52,1633
1984,3169,1268,1314,49865,50446,137,10.243,184,13.757,7389,2036,5353,4.036,14.647,8462,2506,5956,4.968,16.775,-1073,-2.127,29.295,150,152,1773
1984,3211,4923,5408,141144,134045,604,11.235,540,10.045,26367,6078,20289,4.534,19.67,12111,4438,7673,3.311,9.035,14256,10.635,18.07,398,399,2343
1984,3212,1072,1321,87076,83588,146,11.292,90,6.961,13558,2289,11269,2.738,16.22,6434,2308,4126,2.761,7.697,7124,8.523,15.395,53,53,573
1984,3219,8755,9513,281724,264336,1188,12.674,909,9.698,62815,14059,48756,5.319,23.763,28040,9175,18865,3.471,10.608,34775,13.156,21.215,705,710,5752
1984,3221,249,584,202417,202609,19,3.212,34,5.748,7752,793,6959,0.391,3.826,8103,2186,5917,1.079,3.999,-351,-0.173,7.652,16,16,256
1984,3222,3664,5216,394702,385972,284,5.477,222,4.282,40179,5101,35078,1.322,10.41,22865,7049,15816,1.826,5.924,17314,4.486,11.848,148,151,2669
1984,3231,35962,37541,720441,698084,4451,12.095,2968,8.065,109745,24442,85303,3.501,15.721,64713,23516,41197,3.369,9.27,45032,6.451,18.54,2375,2376,14282
1984,3241,1481,2352,226626,229389,228,9.779,187,8.021,20563,3086,17477,1.345,8.964,26189,6722,19467,2.93,11.417,-5626,-2.453,17.928,91,92,1175
1984,3251,1168,2235,247197,245598,148,6.647,131,5.884,20322,10521,9801,4.284,8.275,17312,3410,13902,1.388,7.049,3010,1.226,14.098,53,55,453
1984,3252,373,606,139119,139111,41,6.777,39,6.446,8668,1880,6788,1.351,6.231,8429,2057,6372,1.479,6.059,239,0.172,12.118,18,18,509
1984,3253,705,1051,46982,47755,84,7.928,101,9.533,3543,746,2797,1.562,7.419,5102,1624,3478,3.401,10.684,-1559,-3.265,14.838,43,43,312
1984,3254,1033,1263,161686,161632,129,10.308,106,8.47,13809,2151,11658,1.331,8.543,13334,3548,9786,2.195,8.25,475,0.294,16.499,67,67,1136
1984,3255,1680,2131,73603,72835,151,7.185,92,4.378,8567,2008,6559,2.757,11.762,7014,2439,4575,3.349,9.63,1553,2.132,19.26,51,53,438
1984,3256,2081,2328,120660,120285,207,8.982,160,6.943,11667,1812,9855,1.506,9.7,10864,3758,7106,3.124,9.032,803,0.668,18.064,113,120,1237
1984,3259,1766,2292,90707,88669,239,10.644,146,6.502,11307,3145,8162,3.547,12.752,7223,1539,5684,1.736,8.146,4084,4.606,16.292,102,103,613
1984,3261,10202,11796,567102,534323,1109,9.518,819,7.029,109014,19014,90000,3.559,20.402,43714,16228,27486,3.037,8.181,65300,12.221,16.362,600,602,8131
1984,3262,1973,2336,185675,178920,214,9.29,149,6.468,24981,3911,21070,2.186,13.962,11518,5180,6338,2.895,6.438,13463,7.525,12.875,101,101,838
1984,3271,1328,1602,80148,76227,193,12.165,162,10.211,13063,2268,10795,2.975,17.137,5300,1400,3900,1.837,6.953,7763,10.184,13.906,122,122,656
1984,3272,1519,1790,153897,151086,192,10.793,170,9.556,18381,2302,16079,1.524,12.166,12519,4619,7900,3.057,8.286,5862,3.88,16.572,121,121,873
1984,3273,7034,9027,177344,170017,660,7.329,617,6.851,35776,7301,28475,4.294,21.043,21144,5980,15164,3.517,12.436,14632,8.606,24.873,399,405,3158
1984,3274,250,347,16820,16137,40,11.594,36,10.435,2589,732,1857,4.536,16.044,1275,720,555,4.462,7.901,1314,8.143,15.802,28,28,94
1984,3279,1853,2124,81598,79336,215,10.236,168,7.998,12117,2546,9571,3.209,15.273,7682,3000,4682,3.781,9.683,4435,5.59,19.366,118,119,694
1984,3311,244,280,160116,154625,43,15.552,36,13.02,15942,3494,12448,2.26,10.31,5060,807,4253,0.522,3.272,10882,7.038,6.545,25,26,321
1984,3312,507,677,64496,61539,49,7.19,58,8.511,9959,1245,8714,2.023,16.183,4040,1472,2568,2.392,6.565,5919,9.618,13.13,36,37,597
1984,3313,481,709,126780,122817,26,3.659,29,4.082,16426,2294,14132,1.868,13.374,8529,2916,5613,2.374,6.944,7897,6.43,13.889,10,10,265
1984,3314,722,889,85561,83269,102,11.644,76,8.676,11269,2440,8829,2.93,13.533,6971,2253,4718,2.706,8.372,4298,5.162,16.743,50,51,438
1984,3315,2814,3125,226135,213404,178,5.699,175,5.603,43451,8450,35001,3.96,20.361,18153,9935,8218,4.656,8.506,25298,11.855,17.013,112,113,1787
1984,3321,3192,3404,145544,137432,259,7.673,202,5.984,26237,4362,21875,3.174,19.091,10065,3668,6397,2.669,7.324,16172,11.767,14.647,145,146,2102
1984,3322,1206,1327,84572,82775,101,7.631,94,7.102,9619,1403,8216,1.695,11.621,5922,2129,3793,2.572,7.154,3697,4.466,14.309,64,64,1227
1984,3323,9961,10776,332769,323108,933,8.673,896,8.329,59547,12147,47400,3.759,18.429,40335,12811,27524,3.965,12.483,19212,5.946,24.967,687,692,7076
1984,3324,1451,1818,127344,127640,96,5.233,129,7.032,13621,2046,11575,1.603,10.671,14485,5503,8982,4.311,11.348,-864,-0.677,21.343,77,77,1208
1984,3325,923,997,79190,75902,95,9.635,73,7.404,11465,1830,9635,2.411,15.105,4976,1813,3163,2.389,6.556,6489,8.549,13.112,51,51,580
1984,3326,1638,1847,68947,65133,155,8.542,90,4.96,13050,1636,11414,2.512,20.036,5349,2166,3183,3.326,8.212,7701,11.823,16.425,56,58,978
1984,3327,21064,21382,331100,311008,2154,10.157,1803,8.502,68416,10858,57558,3.491,21.998,28197,10457,17740,3.362,9.066,40219,12.932,18.133,1420,1420,7387
1984,3328,5425,5746,129275,120423,482,8.455,391,6.859,27640,4385,23255,3.641,22.953,9932,3919,6013,3.254,8.248,17708,14.705,16.495,320,320,2938
1984,3329,5258,5783,352928,339170,746,13.163,515,9.087,55204,12882,42322,3.798,16.276,28188,9036,19152,2.664,8.311,27016,7.965,16.622,386,386,3605
1984,3331,3091,3479,241801,243254,305,8.644,404,11.45,35285,4029,31256,1.656,14.505,38225,11974,26251,4.922,15.714,-2940,-1.209,29.011,258,258,2184
1984,3332,3713,3963,166768,160060,316,8.023,267,6.779,28504,7044,21460,4.401,17.808,15478,4896,10582,3.059,9.67,13026,8.138,19.34,192,194,2060
1984,3333,2053,2177,169997,168160,194,9.009,147,6.826,21721,8408,13313,5,12.917,17697,8352,9345,4.967,10.524,4024,2.393,21.048,106,106,1031
1984,3334,1794,2023,169133,162629,176,8.562,241,11.725,25251,2670,22581,1.642,15.527,12183,4540,7643,2.792,7.491,13068,8.035,14.983,177,178,1442
1984,3335,9507,9924,230702,222922,714,7.214,660,6.669,38790,5152,33638,2.311,17.401,23210,7601,15609,3.41,10.412,15580,6.989,20.823,493,494,3476
1984,3336,746,908,148849,144879,47,5.191,42,4.638,17859,1192,16667,0.823,12.327,10101,2009,8092,1.387,6.972,7758,5.355,13.944,18,18,139
1984,3339,5895,6471,316166,310187,467,7.229,446,6.903,44091,7446,36645,2.4,14.214,32286,10400,21886,3.353,10.409,11805,3.806,20.817,313,314,2937
1984,3341,1634,1851,362729,349020,342,19.284,187,10.544,66109,15550,50559,4.455,18.941,39198,10137,29061,2.904,11.231,26911,7.71,22.462,123,125,2411
1984,3342,1867,2065,285924,276885,225,11.035,173,8.485,47674,7379,40295,2.665,17.218,29158,6713,22445,2.424,10.531,18516,6.687,21.061,109,109,1494
1984,3343,395,421,48564,47694,42,9.836,54,12.646,6547,862,5685,1.807,13.727,4716,2559,2157,5.366,9.888,1831,3.839,19.776,37,37,286
1984,3344,4327,4893,539291,499041,722,15.189,443,9.319,110299,23071,87228,4.623,22.102,29690,10265,19425,2.057,5.949,80609,16.153,11.899,326,326,3485
1984,3345,4020,4603,650528,634613,456,10.065,311,6.865,86352,26391,59961,4.159,13.607,55152,18327,36825,2.888,8.691,31200,4.916,17.381,190,190,1901
1984,3346,610,632,18481,17457,91,14.331,97,15.276,4459,2155,2304,12.345,25.543,2389,1027,1362,5.883,13.685,2070,11.858,27.371,64,64,485
1984,3351,1185,1300,83738,80818,101,7.784,96,7.399,12574,1158,11416,1.433,15.559,6710,2401,4309,2.971,8.303,5864,7.256,16.605,73,73,1054
1984,3352,350,453,127704,120431,38,8.482,28,6.25,21499,1000,20499,0.83,17.852,7065,2055,5010,1.706,5.866,14434,11.985,11.733,21,21,213
1984,3353,1997,2503,251229,244485,172,6.891,158,6.33,34077,5403,28674,2.21,13.938,20375,5475,14900,2.239,8.334,13702,5.604,16.668,102,102,739
1984,3359,1891,2248,207225,196756,266,12.069,178,8.076,33489,4930,28559,2.506,17.021,12485,4206,8279,2.138,6.345,21004,10.675,12.691,129,130,1658
1984,3361,192,249,260518,237425,30,12.27,21,8.589,50124,3666,46458,1.544,21.112,4463,2567,1896,1.081,1.88,45661,19.232,3.76,16,16,102
1984,3362,1746,1930,118729,104979,249,13.241,150,7.977,33233,5721,27512,5.45,31.657,6076,2511,3565,2.392,5.788,27157,25.869,11.576,108,109,1360
1984,3363,3712,4412,655624,603430,444,10.189,335,7.688,129855,21983,107872,3.643,21.519,24895,12981,11914,2.151,4.126,104960,17.394,8.251,228,228,2327
1984,3364,1217,1473,670058,666512,115,7.839,103,7.021,52927,10455,42472,1.569,7.941,46814,16159,30655,2.424,7.024,6113,0.917,14.047,67,67,850
1984,3365,176,211,32175,30241,14,6.542,20,9.346,6018,263,5755,0.87,19.9,1992,718,1274,2.374,6.587,4026,13.313,13.174,12,12,105
1984,3366,1108,1206,163325,161618,130,10.802,125,10.386,24144,2533,21611,1.567,14.939,20402,3228,17174,1.997,12.624,3742,2.315,25.247,97,97,1358
1984,3369,432,442,38461,37253,65,14.857,56,12.8,5338,796,4542,2.137,14.329,2788,513,2275,1.377,7.484,2550,6.845,14.968,47,47,407
1984,3371,11987,12572,376398,356436,1867,15.137,1391,11.278,70787,17349,53438,4.867,19.86,30843,14450,16393,4.054,8.653,39944,11.207,17.306,1093,1099,9500
1984,3372,2516,2648,135535,125238,320,12.408,182,7.057,29747,5595,24152,4.468,23.752,9154,3829,5325,3.057,7.309,20593,16.443,14.619,141,143,3015
1984,3379,1089,1206,41351,39170,118,9.788,117,9.706,7772,1394,6378,3.559,19.842,3360,1703,1657,4.348,8.578,4412,11.264,17.156,82,96,1249
1984,3391,9863,10412,235884,230312,1204,11.638,1071,10.352,32657,6839,25818,2.969,14.179,21827,7477,14350,3.246,9.477,10830,4.702,18.954,810,813,4289
1984,3399,14740,15350,417866,405979,1981,13.075,1583,10.448,74998,16738,58260,4.123,18.473,51246,21158,30088,5.212,12.623,23752,5.851,25.246,1269,1271,9019
1984,4231,22902,28085,309371,300811,2631,9.365,2649,9.429,50412,13089,37323,4.351,16.759,33534,13432,20102,4.465,11.148,16878,5.611,22.296,1887,1943,8834
1984,4232,7830,8952,103789,99613,1123,12.686,923,10.427,20862,4468,16394,4.485,20.943,12386,4891,7495,4.91,12.434,8476,8.509,24.868,671,675,2668
1984,4233,7524,9242,116355,108839,1158,12.695,917,10.053,26708,6684,20024,6.141,24.539,11810,5114,6696,4.699,10.851,14898,13.688,21.702,624,626,3271
1984,4234,22128,29978,506573,484026,4881,16.806,3012,10.371,114394,44329,70065,9.158,23.634,69729,29426,40303,6.079,14.406,44665,9.228,28.812,1874,1910,10731
1984,4235,6392,8761,126803,123218,914,10.48,835,9.574,21374,5441,15933,4.416,17.346,14215,6277,7938,5.094,11.536,7159,5.81,23.073,494,518,3191
1984,4236,14806,21429,301137,279492,2729,13.009,1827,8.709,79185,36753,42432,13.15,28.332,34714,12976,21738,4.643,12.42,44471,15.911,24.841,1236,1259,6413
1984,4237,10784,14100,153628,149957,1223,8.704,1124,8,24843,6727,18116,4.486,16.567,17514,6621,10893,4.415,11.679,7329,4.887,23.359,816,831,4167
1984,4238,46584,60643,629936,620378,5438,8.971,5390,8.892,103569,28920,74649,4.662,16.694,84228,29570,54658,4.766,13.577,19341,3.118,27.154,3419,3517,16823
1984,4239,22084,23633,219512,209481,3831,16.468,3093,13.295,51837,16194,35643,7.731,24.746,31494,13231,18263,6.316,15.034,20343,9.711,30.069,2437,2456,9297
1984,4241,7830,10376,143395,140744,1040,10.129,823,8.016,22275,5877,16398,4.176,15.827,16956,6888,10068,4.894,12.047,5319,3.779,24.095,512,518,3722
1984,4242,2726,3444,97855,95607,460,13.514,380,11.163,13461,5312,8149,5.556,14.08,9104,3385,5719,3.541,9.522,4357,4.557,19.045,274,275,2077
1984,4243,10960,11853,131396,125786,1848,15.838,1478,12.667,31108,9666,21442,7.685,24.731,19799,8604,11195,6.84,15.74,11309,8.991,31.481,1160,1169,5435
1984,4244,27139,33262,601580,590633,3543,10.71,3183,9.622,96928,24898,72030,4.215,16.411,75071,25633,49438,4.34,12.71,21857,3.701,25.421,2375,2416,15850
1984,4245,8195,11271,99503,101209,635,5.58,852,7.487,13322,3737,9585,3.692,13.163,16683,4887,11796,4.829,16.484,-3361,-3.321,26.326,562,595,3427
1984,4246,6860,10174,115174,114997,1152,11.495,847,8.452,18576,5422,13154,4.715,16.153,18449,5000,13449,4.348,16.043,127,0.11,32.086,494,524,2529
1984,4247,11512,14950,148891,148777,983,6.51,1285,8.509,25072,5527,19545,3.715,16.852,24646,8510,16136,5.72,16.566,426,0.286,33.132,791,821,5149
1984,4248,4567,5696,140780,138989,331,5.764,424,7.384,17102,3851,13251,2.771,12.305,13488,5097,8391,3.667,9.704,3614,2.6,19.409,316,324,3239
1984,4249,19628,23739,250330,244326,3018,12.853,2502,10.655,44412,13559,30853,5.55,18.177,32570,12207,20363,4.996,13.331,11842,4.847,26.661,1821,1834,7735
1984,4251,29027,31683,298021,288157,3595,11.49,2805,8.965,55603,16676,38927,5.787,19.296,35939,12682,23257,4.401,12.472,19664,6.824,24.944,1918,1926,7999
1984,4411,37423,38461,839891,795195,4223,11.107,3340,8.785,149088,38831,110257,4.883,18.749,59894,26379,33515,3.317,7.532,89194,11.217,15.064,2763,2773,20940
1984,4412,11114,11545,79792,74996,1377,12.013,1213,10.582,19797,5835,13962,7.78,26.398,10220,4189,6031,5.586,13.627,9577,12.77,27.255,966,977,3419
1984,4413,46572,68422,462707,441275,7069,10.566,4033,6.028,91308,36421,54887,8.254,20.692,48232,16751,31481,3.796,10.93,43076,9.762,21.86,2739,2841,11067
1984,4421,22005,26603,211167,203674,3048,11.54,2667,10.097,42516,13622,28894,6.688,20.875,27431,12027,15404,5.905,13.468,15085,7.406,26.936,1925,2008,8325
1984,4422,20122,23982,135803,128851,3633,15.485,2593,11.052,33947,13265,20682,10.295,26.346,20015,8201,11814,6.365,15.533,13932,10.812,31.067,1956,2000,6044
1984,4431,24426,32168,197031,187370,5351,16.924,4250,13.442,51892,24180,27712,12.905,27.695,32310,16260,16050,8.678,17.244,19582,10.451,34.488,2893,3068,10654
1984,4441,56070,70775,679740,653419,6237,8.863,5436,7.724,125607,38148,87459,5.838,19.223,72785,25438,47347,3.893,11.139,52822,8.084,22.278,3945,3997,16884
1984,4442,14614,17612,121715,119011,1958,11.264,1500,8.629,22103,7651,14452,6.429,18.572,16601,5361,11240,4.505,13.949,5502,4.623,27.898,1128,1145,3947
1984,4451,65713,109205,1953339,1909470,11300,10.34,11459,10.485,315378,133340,182038,6.983,16.517,229259,91955,137304,4.816,12.006,86119,4.51,24.013,7684,7860,41929
1984,4452,23509,28762,180627,178643,4120,14.333,4084,14.208,40452,17704,22748,9.91,22.644,36608,16380,20228,9.169,20.492,3844,2.152,40.985,3071,3113,11736
1984,4453,28907,34279,168409,168475,3860,11.243,3965,11.549,32485,13654,18831,8.104,19.282,32629,13499,19130,8.012,19.367,-144,-0.085,38.564,3085,3122,9735
1984,4461,44392,64663,592719,572820,7136,11.302,4083,6.467,107583,45366,62217,7.92,18.781,66403,23396,43007,4.084,11.592,41180,7.189,23.185,2855,2945,14464
1984,4471,95696,127789,786566,769289,15210,11.815,17106,13.288,178866,74479,104387,9.682,23.251,144495,70076,74419,9.109,18.783,34371,4.468,37.566,11869,12125,46708
1984,4481,57580,97037,782505,781703,11586,11.99,10778,11.154,155169,70672,84497,9.041,19.85,151400,49686,101714,6.356,19.368,3769,0.482,38.736,7099,7551,28122
1984,4482,12453,36034,195140,190030,3605,10.06,3207,8.949,41702,17162,24540,9.031,21.945,31327,12209,19118,6.425,16.485,10375,5.46,32.971,1381,1473,5183
1984,4483,18107,25706,147514,146370,2928,11.497,2449,9.617,27820,10332,17488,7.059,19.007,25337,9768,15569,6.674,17.31,2483,1.696,34.621,1578,1632,5415
1984,4511,32092,42414,265170,261422,5869,13.915,5398,12.798,53370,23155,30215,8.857,20.415,45729,18952,26777,7.25,17.492,7641,2.923,34.985,3891,4054,12641
1984,4512,7859,11799,77017,75549,1617,13.912,1265,10.884,16142,6644,9498,8.794,21.366,13060,5749,7311,7.61,17.287,3082,4.079,34.574,914,957,3280
1984,4522,446,6684,1100156,1062305,410,6.172,327,4.923,129194,44523,84671,4.191,12.162,54487,15577,38910,1.466,5.129,74707,7.033,10.258,22,23,644
1984,4523,13070,27469,772472,746575,3005,11.052,2445,8.993,113717,49913,63804,6.686,15.232,62262,21476,40786,2.877,8.34,51455,6.892,16.679,1418,1452,5186
1984,4531,21929,23251,111981,108166,3424,15.027,2493,10.941,25040,9898,15142,9.151,23.15,17506,7016,10490,6.486,16.184,7534,6.965,32.369,1936,1964,5571
1984,4532,25781,31525,202314,193706,5172,16.81,3657,11.886,48369,19362,29007,9.996,24.97,31329,13686,17643,7.065,16.174,17040,8.797,32.347,2754,2843,9329
1984,4533,9433,11295,53042,51019,1820,16.462,1342,12.138,11918,5482,6436,10.745,23.36,7952,3152,4800,6.178,15.587,3966,7.774,31.173,1043,1046,2315
1984,4539,26952,32525,149084,143318,5173,16.11,4345,13.531,40542,16934,23608,11.816,28.288,28634,15029,13605,10.486,19.979,11908,8.309,39.959,3132,3212,11034
1984,4541,5962,7561,96549,94368,1160,15.54,967,12.955,18775,6975,11800,7.391,19.896,14434,5908,8526,6.261,15.295,4341,4.6,30.591,637,641,2290
1984,4542,4061,5356,79779,78264,598,11.309,462,8.737,11519,3194,8325,4.081,14.718,8396,2952,5444,3.772,10.728,3123,3.99,21.456,335,344,1801
1984,4543,16376,22019,197126,193621,2119,9.673,1894,8.646,33117,11191,21926,5.78,17.104,25850,9761,16089,5.041,13.351,7267,3.753,26.702,1401,1413,5624
1984,4811,1080,2851,289518,287636,362,12.853,293,10.403,29217,4049,25168,1.408,10.158,26038,3445,22593,1.198,9.052,3179,1.105,18.105,139,140,1576
1984,4812,466,700,10961,9553,133,19.762,79,11.738,3769,955,2814,9.997,39.456,918,514,404,5.381,9.61,2851,29.846,19.22,54,57,459
1984,4831,390,635,31905,32998,56,8.622,85,13.087,4830,1678,3152,5.085,14.637,6919,1923,4996,5.828,20.968,-2089,-6.331,29.275,39,39,389
1984,4832,387,443,15405,14906,39,8.657,54,11.987,2926,560,2366,3.757,19.63,2031,564,1467,3.784,13.625,895,6.004,27.251,39,39,447
1984,4841,20938,26298,505959,482115,4796,18.529,3967,15.326,109710,29144,80566,6.045,22.756,61791,28902,32889,5.995,12.817,47919,9.939,25.633,2903,2938,14393
1984,4842,42724,46634,566309,542386,7762,16.974,5951,13.014,125884,34156,91728,6.297,23.209,78358,31710,46648,5.846,14.447,47526,8.762,28.894,4486,4503,18092
1984,4851,385,411,30808,30678,46,11.33,36,8.867,2305,918,1387,2.992,7.514,2078,1091,987,3.556,6.774,227,0.74,13.547,28,29,869
1984,4852,344,682,24595,25268,104,15.453,86,12.779,3493,1720,1773,6.807,13.824,4900,1556,3344,6.158,19.393,-1407,-5.568,27.648,33,33,414
1984,4853,5146,5209,52908,52608,873,16.597,975,18.536,10902,4188,6714,7.961,20.723,10414,4527,5887,8.605,19.795,488,0.928,39.591,833,833,3916
1984,4854,3400,3600,94638,93218,280,7.739,316,8.734,13076,3033,10043,3.254,14.027,10106,3769,6337,4.043,10.841,2970,3.186,21.683,262,262,2842
1984,4855,576,613,12922,12437,126,21.724,60,10.345,3108,1431,1677,11.506,24.991,2158,492,1666,3.956,17.352,950,7.639,34.704,43,43,422
1984,4859,968,1012,20551,20073,190,19.202,145,14.654,4034,1507,2527,7.508,20.097,3079,1404,1675,6.994,15.339,955,4.758,30.678,122,122,1244
1984,4861,80,319,11597,11914,11,3.374,25,7.669,963,81,882,0.68,8.083,1554,486,1068,4.079,13.043,-591,-4.961,16.166,6,6,38
1984,4862,242,1314,59032,61011,97,7.47,66,5.083,4578,1365,3213,2.237,7.504,8322,4637,3685,7.6,13.64,-3744,-6.137,15.007,18,19,1876
1984,4869,59,339,7403,7445,33,9.925,20,6.015,648,238,410,3.197,8.704,744,263,481,3.533,9.993,-96,-1.289,17.408,8,8,91
1984,4871,193,196,2763,2772,52,27.882,33,17.694,489,224,265,8.081,17.641,495,171,324,6.169,17.857,-6,-0.216,35.281,26,26,135
1984,4872,675,680,8316,8163,133,19.955,106,15.904,1783,650,1133,7.963,21.842,1555,496,1059,6.076,19.049,228,2.793,38.099,83,83,366
1984,4879,56,69,2170,2035,17,25.185,14,20.741,403,58,345,2.85,19.803,110,55,55,2.703,5.405,293,14.398,10.811,10,10,47
1984,4881,2065,2634,62591,59773,418,16.161,323,12.488,13215,4232,8983,7.08,22.109,7614,2877,4737,4.813,12.738,5601,9.371,25.477,226,227,1301
1984,4882,358,448,11275,11082,58,13.063,50,11.261,2303,590,1713,5.324,20.782,1923,309,1614,2.788,17.353,380,3.429,34.706,33,33,198
1984,4883,2137,2561,109971,108156,312,12.067,361,13.962,28194,8253,19941,7.631,26.068,24855,5081,19774,4.698,22.981,3339,3.087,45.961,245,248,2341
1984,4884,1642,2244,32426,32101,450,20.422,369,16.746,6418,2779,3639,8.657,19.993,5660,1802,3858,5.614,17.632,758,2.361,35.264,288,290,1001
1984,4885,5200,7073,88395,84946,1281,18.777,779,11.419,20628,7021,13607,8.265,24.284,13724,5172,8552,6.089,16.156,6904,8.128,32.312,505,510,2814
1984,4889,367,373,4699,5033,78,20.828,81,21.629,1023,438,585,8.703,20.326,1707,860,847,17.087,33.916,-684,-13.59,40.652,60,63,714
1984,4921,1285,2057,82980,78483,531,27.534,274,14.208,16825,5155,11670,6.568,21.438,7810,1453,6357,1.851,9.951,9015,11.487,19.902,200,203,913
1984,4922,1208,1248,8973,7330,541,50.093,205,18.981,4826,3416,1410,46.606,65.844,1485,858,627,11.706,20.261,3341,45.583,40.521,177,177,755
1984,4931,6180,9598,379201,370094,736,7.663,748,7.788,62294,14976,47318,4.047,16.832,43676,12018,31658,3.247,11.801,18618,5.031,23.603,280,289,2068
1984,5111,13599,15550,627141,615101,1851,12.114,1310,8.574,68931,18396,50535,2.991,11.206,45254,15860,29394,2.578,7.357,23677,3.849,14.714,1085,1087,8128
1984,5112,7160,8447,145469,137166,1426,16.997,1311,15.627,41649,13225,28424,9.642,30.364,24985,11158,13827,8.135,18.215,16664,12.149,36.43,918,932,5726
1984,5121,9178,14260,213065,209238,2040,14.326,2000,14.045,50731,13193,37538,6.305,24.246,42457,12673,29784,6.057,20.291,8274,3.954,40.582,1078,1133,6166
1984,5122,1780,1785,11894,11673,523,31.233,302,18.035,4356,2453,1903,21.014,37.317,3916,1148,2768,9.835,33.548,440,3.769,67.095,237,237,808
1984,5151,6221,7320,226579,222392,934,12.987,678,9.427,33683,15425,18258,6.936,15.146,25366,11525,13841,5.182,11.406,8317,3.74,22.812,515,518,6871
1984,5152,9,9,60,54,5,71.429,(D),(D),25,22,3,40.741,46.296,17,(D),3,(D),31.481,8,14.815,62.963,(D),(D),(D)
1984,5173,2849,15073,948293,947792,4621,34.088,1587,11.707,335174,252098,83076,26.598,35.364,331641,110349,221292,11.643,34.991,3533,0.373,69.982,244,244,1823
1984,5174,709,1309,57698,55571,186,14.486,136,10.592,15644,5161,10483,9.287,28.151,11463,3742,7721,6.734,20.628,4181,7.524,41.255,58,58,1035
1984,5179,1339,2586,65016,65179,669,27.742,320,13.27,20599,11359,9240,17.427,31.604,20936,10066,10870,15.444,32.121,-337,-0.517,63.207,160,161,1720
1984,5182,5841,7734,237814,230040,1191,15.591,1001,13.104,47644,17068,30576,7.42,20.711,32090,10200,21890,4.434,13.95,15554,6.761,27.899,622,629,3871
1984,5191,2250,2679,30963,30069,376,14.464,217,8.348,5055,1617,3438,5.378,16.812,3244,1383,1861,4.599,10.789,1811,6.023,21.577,156,156,815
1984,5211,36,77,24159,24349,(D),(D),5,6.536,540,(D),455,(D),2.218,923,108,815,0.444,3.791,-383,-1.573,4.436,4,4,63
1984,5221,20366,69532,1906978,1887623,3617,5.255,2223,3.229,223274,60138,163136,3.186,11.828,184317,39010,145307,2.067,9.765,38957,2.064,19.529,873,939,18816
1984,5222,22282,39457,387604,370740,3532,8.974,3333,8.469,79077,27397,51680,7.39,21.33,45048,18620,26428,5.022,12.151,34029,9.179,24.302,1523,1557,6968
1984,5223,3579,4044,47341,43698,1072,28.42,528,13.998,14188,6727,7461,15.394,32.468,6912,2390,4522,5.469,15.818,7276,16.651,31.635,391,391,1517
1984,5231,6233,11883,285012,268053,2281,20.26,1032,9.166,61902,20349,41553,7.591,23.093,27848,10098,17750,3.767,10.389,34054,12.704,20.778,648,665,4311
1984,5232,127,142,6737,6724,21,15.385,10,7.326,551,146,405,2.171,8.195,521,271,250,4.031,7.749,30,0.446,15.498,8,8,266
1984,5239,14530,14923,207103,201672,3573,24.765,2582,17.896,83112,30024,53088,14.888,41.211,70611,37098,33513,18.395,35.013,12501,6.199,70.026,2082,2083,31822
1984,5241,6496,30926,1251183,1253942,2625,8.492,2598,8.404,148778,48868,99910,3.897,11.865,153976,41073,112903,3.276,12.279,-5198,-0.415,23.73,369,374,5769
1984,5242,96508,101343,737156,729599,14562,14.579,11648,11.661,197335,80656,116679,11.055,27.047,183858,114868,68990,15.744,25.2,13477,1.847,50.4,9008,9018,94729
1984,5259,691,894,8759,8402,127,14.589,80,9.19,1991,942,1049,11.212,23.698,1245,570,675,6.785,14.819,746,8.879,29.638,57,58,463
1984,5311,97274,99406,504007,494694,13852,14,12921,13.059,115367,52602,62765,10.633,23.321,97345,48670,48675,9.838,19.678,18022,3.643,39.356,10428,10435,35716
1984,5312,34417,35857,197233,186262,7150,20.73,4417,12.806,58085,24880,33205,13.358,31.185,35885,15649,20236,8.402,19.266,22200,11.919,38.532,3385,3396,11284
1984,5313,21593,22377,222409,209517,4753,22.149,2918,13.598,59800,22535,37265,10.756,28.542,33891,14144,19747,6.751,16.176,25909,12.366,32.352,2273,2276,10300
1984,5321,5603,9081,109345,105673,1376,15.349,1144,12.761,23485,7799,15686,7.38,22.224,16139,6964,9175,6.59,15.273,7346,6.952,30.545,678,729,4033
1984,5322,11143,14125,127786,111215,4209,32.574,1802,13.946,57475,37988,19487,34.157,51.679,22599,11257,11342,10.122,20.32,34876,31.359,40.64,1297,1318,7175
1984,5323,2922,3622,30160,25351,905,27.088,343,10.266,13629,8902,4727,35.116,53.762,3555,1443,2112,5.692,14.023,10074,39.739,28.047,243,243,832
1984,5324,5434,6709,73905,63749,1576,25.454,541,8.738,30548,19823,10725,31.095,47.919,9196,2945,6251,4.62,14.425,21352,33.494,28.851,366,367,1764
1984,5331,880,923,11278,10721,151,16.467,139,15.158,2720,941,1779,8.778,25.372,1606,588,1018,5.485,14.981,1114,10.391,29.961,110,110,450
1984,5411,121846,125525,698253,671327,15055,12.154,11738,9.476,132522,44491,88031,6.627,19.74,78688,31958,46730,4.76,11.721,53834,8.019,23.443,8647,8705,24452
1984,5412,53825,56731,435819,427229,9740,17.699,6342,11.524,81539,33716,47823,7.892,19.086,64131,32101,32030,7.514,15.011,17408,4.075,30.022,4645,4704,25601
1984,5413,49935,54715,696113,666923,9137,17.202,5941,11.185,162223,48647,113576,7.294,24.324,103776,31932,71844,4.788,15.56,58447,8.764,31.121,4200,4244,17635
1984,5414,12446,12655,88968,83617,2423,19.703,1708,13.889,24393,8377,16016,10.018,29.172,13590,5986,7604,7.159,16.253,10803,12.92,32.505,1297,1302,4332
1984,5415,7968,9022,82387,68220,4190,55.744,1179,15.685,38309,23880,14429,35.005,56.155,10103,5270,4833,7.725,14.81,28206,41.346,29.619,880,883,3658
1984,5416,31919,33112,270412,250171,9348,30.048,5345,17.181,95074,43274,51800,17.298,38.004,53958,25880,28078,10.345,21.568,41116,16.435,43.137,4061,4071,18065
1984,5417,5941,7217,407845,398955,1179,16.706,860,12.186,55815,19199,36616,4.812,13.99,38415,8994,29421,2.254,9.629,17400,4.361,19.258,573,575,2526
1984,5418,22936,25083,317347,299895,4335,17.786,2915,11.96,75870,25876,49994,8.628,25.299,40725,17244,23481,5.75,13.58,35145,11.719,27.16,2233,2240,11333
1984,5419,28026,30959,206111,198800,4332,14.366,2721,9.024,47452,17848,29604,8.978,23.869,33034,10712,22322,5.388,16.617,14418,7.253,33.233,2018,2035,7531
1984,5511,23433,43641,2859644,2804562,4403,10.222,3265,7.58,473815,137708,336107,4.91,16.894,363702,84817,278885,3.024,12.968,110113,3.926,25.936,727,745,9442
1984,5611,9411,9884,137022,129419,2126,22.164,1542,16.076,40952,15740,25212,12.162,31.643,25732,11941,13791,9.227,19.883,15220,11.76,39.765,1172,1178,6630
1984,5612,158,172,11479,8667,86,62.319,18,13.043,5893,4160,1733,47.998,67.994,434,235,199,2.711,5.007,5459,62.986,10.015,14,14,162
1984,5613,12052,15821,729461,645593,3062,20.034,1988,13.007,267335,61075,206260,9.46,41.409,98674,28359,70315,4.393,15.284,168661,26.125,30.568,1413,1429,14686
1984,5614,18080,20288,210691,201880,3245,16.341,2384,12.006,49457,18032,31425,8.932,24.498,31784,11326,20458,5.61,15.744,17673,8.754,31.488,1834,1856,7459
1984,5615,20292,23689,178476,169042,3660,16.043,1910,8.372,42961,15607,27354,9.233,25.414,24107,9601,14506,5.68,14.261,18854,11.153,28.522,1388,1422,7312
1984,5616,10611,12947,402583,387591,2213,17.463,1664,13.131,85943,23618,62325,6.094,22.174,55280,18387,36893,4.744,14.262,30663,7.911,28.525,1261,1263,12303
1984,5617,59543,62611,768457,734992,14449,24.062,9324,15.527,193874,62241,131633,8.468,26.378,126775,49949,76826,6.796,17.248,67099,9.129,34.497,7348,7362,35238
1984,5619,11462,12331,163470,156608,2168,18.04,1542,12.831,43349,12141,31208,7.752,27.68,29784,9995,19789,6.382,19.018,13565,8.662,38.036,1139,1145,5789
1984,5621,3964,4099,84373,81812,512,12.367,594,14.348,15341,2602,12739,3.18,18.752,10421,5809,4612,7.1,12.738,4920,6.014,25.475,469,469,3572
1984,5622,2025,2550,45931,44644,265,10.46,232,9.157,9303,3412,5891,7.643,20.838,6607,2644,3963,5.922,14.799,2696,6.039,29.599,161,162,1344
1984,5629,4473,4732,40590,38441,707,15.249,516,11.129,11149,3462,7687,9.006,29.003,6727,2499,4228,6.501,17.5,4422,11.503,34.999,398,398,1926
1984,6111,13038,13438,368914,362910,820,6.178,490,3.692,37037,6790,30247,1.871,10.206,25214,6334,18880,1.745,6.948,11823,3.258,13.895,370,370,4258
1984,6112,421,531,35869,35407,48,9.125,38,7.224,4444,1486,2958,4.197,12.551,3627,674,2953,1.904,10.244,817,2.307,20.487,26,27,346
1984,6113,2014,2355,913986,904095,103,4.402,73,3.12,75053,2323,72730,0.257,8.301,55379,1836,53543,0.203,6.125,19674,2.176,12.251,46,46,716
1984,6114,1917,2195,33618,31468,476,22.726,275,13.13,8629,3330,5299,10.582,27.422,4253,1443,2810,4.586,13.515,4376,13.906,27.031,214,214,901
1984,6115,3094,3512,41510,40431,592,17.376,382,11.212,9399,3364,6035,8.32,23.247,7298,2909,4389,7.195,18.051,2101,5.197,36.101,261,276,2413
1984,6116,10681,11194,96391,93654,2197,20.143,1623,14.88,22703,8721,13982,9.312,24.241,17230,7083,10147,7.563,18.398,5473,5.844,36.795,1298,1306,5385
1984,6117,1340,1364,22522,22178,280,21.317,179,13.628,2892,1134,1758,5.113,13.04,2187,886,1301,3.995,9.861,705,3.179,19.723,132,132,513
1984,6211,179974,185695,1063746,1033197,14504,7.872,11620,6.307,177970,57278,120692,5.544,17.225,116357,40213,76144,3.892,11.262,61613,5.963,22.524,9163,9231,31535
1984,6212,94442,96626,440402,429432,6394,6.681,4540,4.744,70405,21044,49361,4.9,16.395,48626,14553,34073,3.389,11.323,21779,5.072,22.647,3479,3517,11291
1984,6213,41795,43618,145592,137364,6633,15.793,3396,8.086,37518,16965,20553,12.35,27.313,20880,8916,11964,6.491,15.2,16638,12.112,30.401,2440,2482,6772
1984,6214,5488,7036,110703,104511,1262,18.837,589,8.792,25719,12810,12909,12.257,24.609,13145,4812,8333,4.604,12.578,12574,12.031,25.155,386,390,2685
1984,6215,4169,5202,68956,66182,748,14.733,498,9.809,13987,5116,8871,7.73,21.134,8660,3518,5142,5.316,13.085,5327,8.049,26.17,345,384,2127
1984,6216,3838,5118,191453,175313,1194,25.31,393,8.331,52510,21062,31448,12.014,29.952,20130,4421,15709,2.522,11.482,32380,18.47,22.965,258,264,2907
1984,6219,3733,4327,81725,77466,925,22.766,397,9.771,21332,7969,13363,10.287,27.537,12682,6293,6389,8.124,16.371,8650,11.166,32.742,272,273,3644
1984,6221,3678,4912,3061652,2989160,266,5.467,174,3.576,343594,257413,86181,8.612,11.495,200005,29738,170267,0.995,6.691,143589,4.804,13.382,116,116,19836
1984,6222,369,521,243980,213902,59,11.776,19,3.792,124698,118809,5889,55.544,58.297,63673,1257,62416,0.588,29.767,61025,28.529,59.535,10,10,638
1984,6223,186,229,46604,45631,7,3.024,12,5.184,3507,489,3018,1.072,7.686,1593,480,1113,1.052,3.491,1914,4.195,6.982,5,5,110
1984,6231,8421,12379,975691,967599,861,6.962,838,6.776,114176,44084,70092,4.556,11.8,97870,46461,51409,4.802,10.115,16306,1.685,20.229,565,580,28436
1984,6232,4165,5591,124243,118476,770,14.425,264,4.946,23664,9672,13992,8.164,19.974,12333,4550,7783,3.84,10.41,11331,9.564,20.819,167,167,2837
1984,6233,7096,8165,224008,221214,1097,13.726,751,9.397,31936,11845,20091,5.355,14.437,26389,14631,11758,6.614,11.929,5547,2.508,23.858,505,508,10522
1984,6239,2728,3313,78278,75932,374,11.646,171,5.325,10869,3238,7631,4.264,14.314,6222,1855,4367,2.443,8.194,4647,6.12,16.388,117,117,997
1984,6241,13694,18648,263196,256844,2249,12.412,1192,6.579,45529,12742,32787,4.961,17.726,32985,7842,25143,3.053,12.842,12544,4.884,25.685,713,749,4348
1984,6242,3862,4598,39540,38399,631,14.26,285,6.441,7557,2918,4639,7.599,19.68,5386,1494,3892,3.891,14.027,2171,5.654,28.053,182,187,766
1984,6243,3820,5465,230198,230051,592,10.979,446,8.272,36881,7907,28974,3.437,16.032,36563,6871,29692,2.987,15.893,318,0.138,31.787,211,232,3335
1984,6244,29166,34213,296114,281409,5341,16.146,3073,9.29,67517,26600,40917,9.452,23.992,37833,15468,22365,5.497,13.444,29684,10.548,26.888,2397,2417,11419
1984,7111,4900,4948,64514,65475,833,16.837,832,16.817,15618,5598,10020,8.55,23.853,17413,5210,12203,7.957,26.595,-1795,-2.742,47.707,609,609,3760
1984,7112,2135,2230,63228,62267,387,17.196,428,19.018,14435,5554,8881,8.92,23.182,13013,4092,8921,6.572,20.899,1422,2.284,41.797,316,317,2158
1984,7113,2120,2152,31052,29209,392,18.343,362,16.94,10047,2490,7557,8.525,34.397,6342,2977,3365,10.192,21.712,3705,12.684,43.425,257,257,2133
1984,7114,995,1012,10819,10044,198,20.153,139,14.148,3660,1214,2446,12.087,36.44,2125,914,1211,9.1,21.157,1535,15.283,42.314,107,107,566
1984,7115,8050,8074,40643,35324,2989,40.636,1552,21.1,19002,10075,8927,28.522,53.793,8359,4368,3991,12.366,23.664,10643,30.13,47.328,1156,1156,3052
1984,7121,2136,2286,36449,35729,237,10.683,102,4.598,4279,711,3568,1.99,11.976,2809,549,2260,1.537,7.862,1470,4.114,15.724,73,73,357
1984,7131,1911,2385,57614,58544,396,15.361,782,30.334,5879,2067,3812,3.531,10.042,7805,3011,4794,5.143,13.332,-1926,-3.29,20.084,666,673,2549
1984,7132,662,689,18609,17836,120,17.341,126,18.208,3697,822,2875,4.609,20.728,2236,949,1287,5.321,12.537,1461,8.192,25.074,99,99,575
1984,7139,32128,34202,480577,469756,4599,13.537,4141,12.189,95298,34723,60575,7.392,20.287,73382,25943,47439,5.523,15.621,21916,4.665,31.243,3213,3242,19185
1984,7211,29135,33526,1139660,1101475,4645,13.958,4151,12.473,224700,104249,120451,9.464,20.4,148671,65294,83377,5.928,13.497,76029,6.902,26.995,3034,3066,41913
1984,7212,3642,3892,21599,20832,564,14.701,453,11.808,6068,2169,3899,10.412,29.129,4537,1760,2777,8.449,21.78,1531,7.349,43.559,310,312,1166
1984,7213,4650,4760,22420,22478,316,6.585,393,8.19,3680,1196,2484,5.321,16.372,3847,1230,2617,5.472,17.115,-167,-0.743,32.743,278,278,965
1984,7223,16902,26604,491365,482807,4523,17.159,4034,15.304,117934,55226,62708,11.439,24.427,100976,46456,54520,9.622,20.914,16958,3.512,41.829,2475,2498,19686
1984,7224,57439,58218,323632,323631,8762,14.813,10628,17.968,88518,45738,42780,14.133,27.352,88244,46728,41516,14.439,27.267,274,0.085,54.534,8570,8593,38125
1984,7225,193499,249673,4398325,4245545,42493,17.296,34498,14.042,1038056,551795,486261,12.997,24.45,733804,354855,378949,8.358,17.284,304252,7.166,34.568,25777,26332,230091
1984,8111,98462,102987,493810,466634,17851,17.803,12414,12.381,130389,56510,73879,12.11,27.942,75997,36022,39975,7.72,16.286,54392,11.656,32.572,9579,9631,28247
1984,8112,9767,11007,73742,69287,1713,15.895,1253,11.627,19166,10433,8733,15.058,27.662,10305,3911,6394,5.645,14.873,8861,12.789,29.746,961,964,2606
1984,8113,17983,18888,137324,132003,2728,14.681,2115,11.382,31005,9628,21377,7.294,23.488,20326,7970,12356,6.038,15.398,10679,8.09,30.796,1637,1643,5919
1984,8114,23220,24715,146844,141388,4143,17.061,3280,13.507,34357,13483,20874,9.536,24.3,23355,10775,12580,7.621,16.518,11002,7.781,33.037,2464,2475,6714
1984,8121,81163,90275,455426,447290,12372,13.747,11814,13.127,101673,45600,56073,10.195,22.731,84781,40281,44500,9.006,18.954,16892,3.777,37.909,9398,9572,30679
1984,8122,17458,20131,116251,114583,1554,7.787,1203,6.028,17479,5790,11689,5.053,15.254,14124,4443,9681,3.878,12.326,3355,2.928,24.653,807,831,2952
1984,8123,32539,38363,338567,333085,4651,12.142,4535,11.839,57707,22925,34782,6.883,17.325,46851,20045,26806,6.018,14.066,10856,3.259,28.132,3484,3613,15338
1984,8129,13103,20006,204131,201431,3845,19.731,2808,14.409,46091,18385,27706,9.127,22.882,40560,16240,24320,8.062,20.136,5531,2.746,40.272,1538,1619,8455
1984,8131,114847,114955,897013,823710,38493,39.57,3141,3.229,215570,109837,105733,13.334,26.171,69163,10145,59018,1.232,8.397,146407,17.774,16.793,2012,2012,5797
1984,8132,7383,8444,115645,111855,1017,12.401,531,6.475,21607,5163,16444,4.616,19.317,14047,3505,10542,3.134,12.558,7560,6.759,25.116,350,352,2413
1984,8133,6989,8084,88192,87048,928,11.705,616,7.77,16654,4490,12165,5.157,19.132,14312,3835,10477,4.406,16.442,2342,2.69,32.883,380,381,2496
1984,8134,28821,30193,250547,248074,2255,7.539,1695,5.666,36697,8091,28606,3.262,14.793,31887,6106,25781,2.461,12.854,4810,1.939,25.708,1206,1206,3639
1984,8139,55196,57369,440564,434529,4847,8.509,4040,7.092,77707,20379,57328,4.69,17.883,65915,16062,49853,3.696,15.169,11792,2.714,30.339,2913,2918,10887
1985,1131,220,228,3168,3543,38,16.63,39,17.068,611,238,373,6.718,17.248,1420,906,514,25.575,40.085,-809,-22.837,34.495,30,30,422
1985,1132,91,106,1298,1317,16,15.166,15,14.218,217,66,151,5.011,16.477,268,146,122,11.086,20.349,-51,-3.872,32.954,11,11,128
1985,1133,10749,10847,89053,89583,1665,15.439,1540,14.28,19900,7253,12647,8.096,22.214,20976,6930,14046,7.736,23.415,-1076,-1.201,44.428,1114,1114,4652
1985,1141,1187,1202,7358,8023,191,15.484,254,20.592,2104,831,1273,10.358,26.225,3476,973,2503,12.128,43.325,-1372,-17.101,52.449,189,189,705
1985,1142,131,131,505,549,24,18.113,27,20.377,109,78,31,14.208,19.854,196,66,130,12.022,35.701,-87,-15.847,39.709,23,23,55
1985,1151,3958,4331,54603,53100,545,12.433,650,14.828,16967,5017,11950,9.448,31.953,13738,4603,9135,8.669,25.872,3229,6.081,51.744,433,437,3032
1985,1152,1802,1820,13340,13203,318,17.603,291,16.108,2934,1265,1669,9.581,22.222,2706,1073,1633,8.127,20.495,228,1.727,40.991,213,213,836
1985,1153,779,792,9015,9513,164,21.216,126,16.3,2236,958,1278,10.07,23.505,3247,723,2524,7.6,34.132,-1011,-10.628,47.009,89,89,579
1985,2111,8033,9929,163586,163821,1251,12.577,1287,12.939,30652,9821,20831,5.995,18.711,31128,12999,18129,7.935,19.001,-476,-0.291,37.421,855,869,5020
1985,2121,2639,3314,172376,178048,542,16.012,684,20.207,23710,8558,15152,4.807,13.317,35157,11944,23213,6.708,19.746,-11447,-6.429,26.633,502,506,7285
1985,2122,482,636,39427,43017,93,13.85,164,24.423,4660,1354,3306,3.148,10.833,11811,3239,8572,7.53,27.457,-7151,-16.624,21.666,110,110,1326
1985,2123,3547,5024,103609,101409,434,8.649,422,8.41,17458,5948,11510,5.865,17.215,13140,4110,9030,4.053,12.957,4318,4.258,25.915,294,296,2090
1985,2131,10939,12634,282942,282981,1935,15.259,2029,16,62825,16290,46535,5.757,22.201,62884,24524,38360,8.666,22.222,-59,-0.021,44.402,1531,1534,14240
1985,2211,1599,5777,593809,589934,153,2.643,176,3.041,30530,3894,26636,0.66,5.175,22809,4453,18356,0.755,3.866,7721,1.309,7.733,62,62,1006
1985,2212,554,2406,140642,140258,129,5.391,103,4.304,10016,3953,6063,2.818,7.141,9197,2421,6776,1.726,6.557,819,0.584,13.114,28,28,176
1985,2213,3708,4005,29719,29505,339,8.492,313,7.841,3667,1213,2454,4.111,12.429,3263,1190,2073,4.033,11.059,404,1.369,22.119,224,224,712
1985,2361,94218,94575,564104,543142,21510,23.341,16671,18.09,205247,82213,123034,15.137,37.789,163189,68317,94872,12.578,30.045,42058,7.743,60.091,11735,11736,50228
1985,2362,36269,36899,661473,634864,5919,16.269,4883,13.422,204658,48642,156016,7.662,32.237,152128,41312,110816,6.507,23.962,52530,8.274,47.925,3645,3650,30405
1985,2371,13067,13393,320900,311796,1723,12.938,1572,11.804,98183,40893,57290,13.115,31.49,79493,21028,58465,6.744,25.495,18690,5.994,50.99,1182,1188,14463
1985,2372,8979,9127,84862,76776,2653,30.686,1690,19.548,35739,17029,18710,22.18,46.55,19320,8758,10562,11.407,25.164,16419,21.386,50.328,1334,1334,6871
1985,2373,10081,10373,215814,211250,1274,12.425,1035,10.094,52522,9846,42676,4.661,24.863,43482,10451,33031,4.947,20.583,9040,4.279,41.166,773,777,7067
1985,2379,4739,4844,80870,89621,865,18.193,686,14.428,23212,9122,14090,10.178,25.9,41393,4535,36858,5.06,46.187,-18181,-20.287,51.801,507,507,3045
1985,2381,67629,68031,656244,624459,12342,18.568,9217,13.867,217016,63654,153362,10.193,34.753,153182,53911,99271,8.633,24.53,63834,10.222,49.061,6824,6827,42297
1985,2382,104811,106742,1110951,1074096,16909,16.242,11642,11.183,287983,74668,213315,6.952,26.812,214971,73014,141957,6.798,20.014,73012,6.798,40.028,8962,8968,54038
1985,2383,68741,69152,593063,564782,14209,21.096,10614,15.758,196854,61434,135420,10.877,34.855,140107,48762,91345,8.634,24.807,56747,10.048,49.615,7965,7967,38724
1985,2389,36445,36691,360962,346089,6666,18.674,4679,13.107,110139,32110,78029,9.278,31.824,80526,26119,54407,7.547,23.267,29613,8.556,46.535,3441,3441,18260
1985,3111,1301,1923,50307,51461,126,6.523,143,7.404,4949,1482,3467,2.88,9.617,7194,2731,4463,5.307,13.98,-2245,-4.363,19.234,91,92,853
1985,3112,517,864,68064,68620,48,5.501,65,7.45,6073,2350,3723,3.425,8.85,7337,2083,5254,3.036,10.692,-1264,-1.842,17.701,34,34,279
1985,3113,1514,1780,82787,84883,233,12.981,263,14.652,8389,2464,5925,2.903,9.883,12625,4607,8018,5.427,14.873,-4236,-4.99,19.766,126,187,1764
1985,3114,1215,1677,179526,177396,97,5.716,137,8.073,23893,1958,21935,1.104,13.469,19390,4774,14616,2.691,10.93,4503,2.538,21.861,88,88,1402
1985,3115,1748,2427,133641,133565,129,5.223,215,8.704,13475,2580,10895,1.932,10.089,13373,4874,8499,3.649,10.012,102,0.076,20.025,136,137,1951
1985,3116,4107,4681,328241,327842,341,7.187,469,9.884,38814,6917,31897,2.11,11.839,37870,15381,22489,4.692,11.551,944,0.288,23.103,340,343,8463
1985,3117,728,834,40292,42656,61,7.185,91,10.718,6835,1102,5733,2.583,16.024,11664,6408,5256,15.023,27.345,-4829,-11.321,32.047,54,54,1653
1985,3118,8932,10406,307786,306085,1441,13.893,1374,13.247,41131,11367,29764,3.714,13.438,37788,16549,21239,5.407,12.346,3343,1.092,24.691,1059,1077,10464
1985,3119,2060,2418,123574,124381,224,9.272,220,9.106,13854,3216,10638,2.586,11.138,15446,6680,8766,5.371,12.418,-1592,-1.28,22.277,147,147,2637
1985,3121,1952,2482,166418,168969,151,6.035,191,7.634,12364,2349,10015,1.39,7.317,17462,5195,12267,3.075,10.334,-5098,-3.017,14.635,135,136,2203
1985,3122,109,157,41170,41185,14,8.917,14,8.917,2931,605,2326,1.469,7.117,2810,191,2619,0.464,6.823,121,0.294,13.646,8,8,72
1985,3131,458,667,99777,104410,32,4.744,47,6.968,5548,1627,3921,1.558,5.314,14662,3196,11466,3.061,14.043,-9114,-8.729,10.627,28,28,1121
1985,3132,1683,2047,267647,283068,130,6.253,194,9.331,16431,5061,11370,1.788,5.805,47219,12966,34253,4.581,16.681,-30788,-10.877,11.609,138,140,2332
1985,3133,1628,1861,103925,107880,165,8.835,178,9.531,8897,3239,5658,3.002,8.247,16841,6531,10310,6.054,15.611,-7944,-7.364,16.494,132,132,2205
1985,3141,3896,4182,125846,125811,501,11.981,500,11.957,16626,4450,12176,3.537,13.215,16581,5046,11535,4.011,13.179,45,0.036,26.359,379,382,2649
1985,3149,3685,3817,123092,126875,541,14.273,488,12.874,18646,7656,10990,6.034,14.696,25942,11212,14730,8.837,20.447,-7296,-5.751,29.393,394,396,6639
1985,3151,1348,1463,138861,143746,128,8.669,155,10.498,13658,3619,10039,2.518,9.501,23265,10222,13043,7.111,16.185,-9607,-6.683,19.003,121,122,4518
1985,3152,11718,13184,822633,860005,1761,13.24,1994,14.992,103901,36413,67488,4.234,12.081,177617,67071,110546,7.799,20.653,-73716,-8.572,24.163,1668,1681,43275
1985,3159,1915,2016,73444,75373,264,13.066,273,13.512,11027,3677,7350,4.878,14.63,14964,4871,10093,6.463,19.853,-3937,-5.223,29.26,238,239,3904
1985,3161,358,390,15840,16927,30,7.595,40,10.127,1474,268,1206,1.583,8.708,3697,1458,2239,8.614,21.841,-2223,-13.133,17.416,34,34,1018
1985,3162,453,634,102726,111391,32,4.773,105,15.66,9126,2998,6128,2.691,8.193,26602,9816,16786,8.812,23.882,-17476,-15.689,16.386,57,59,2892
1985,3169,1247,1297,44782,47315,137,10.51,150,11.507,5918,1905,4013,4.026,12.508,10990,2805,8185,5.928,23.227,-5072,-10.72,25.015,115,115,1642
1985,3211,4834,5315,134808,138196,523,9.747,624,11.63,16581,5023,11558,3.635,11.998,23337,7488,15849,5.418,16.887,-6756,-4.889,23.996,472,474,4431
1985,3212,1125,1363,85096,86202,144,10.702,109,8.101,9170,2804,6366,3.253,10.638,11291,4314,6977,5.005,13.098,-2121,-2.46,21.276,71,71,1640
1985,3219,8917,9651,278602,279501,1190,12.429,1036,10.821,43667,12514,31153,4.477,15.623,45676,18449,27227,6.601,16.342,-2009,-0.719,31.246,771,776,10800
1985,3221,240,561,198824,200846,18,3.155,37,6.486,11478,5166,6312,2.572,5.715,15214,8356,6858,4.16,7.575,-3736,-1.86,11.43,17,17,2055
1985,3222,3650,5184,394688,394022,302,5.818,316,6.087,36908,7882,29026,2,9.367,35785,12124,23661,3.077,9.082,1123,0.285,18.164,195,195,4128
1985,3231,37138,38750,749268,734680,4529,11.874,3314,8.688,109252,28500,80752,3.879,14.871,79480,33877,45603,4.611,10.818,29772,4.052,21.637,2626,2637,21761
1985,3241,1448,2325,201491,212736,185,7.931,200,8.574,13140,4173,8967,1.962,6.177,35917,16213,19704,7.621,16.883,-22777,-10.707,12.353,115,116,2901
1985,3251,1127,2234,237970,242421,173,7.742,174,7.787,18744,8104,10640,3.343,7.732,27273,16592,10681,6.844,11.25,-8529,-3.518,15.464,75,77,1475
1985,3252,374,614,135475,137230,53,8.696,44,7.219,7262,3751,3511,2.733,5.292,10875,4029,6846,2.936,7.925,-3613,-2.633,10.584,22,22,377
1985,3253,675,1016,46949,47065,74,7.171,106,10.271,4511,1429,3082,3.036,9.585,4725,1649,3076,3.504,10.039,-214,-0.455,19.169,60,60,581
1985,3254,1016,1249,160470,160884,116,9.265,122,9.744,13588,2419,11169,1.504,8.446,14360,3098,11262,1.926,8.926,-772,-0.48,16.892,80,80,1590
1985,3255,1663,2130,74162,73920,150,7.039,152,7.133,8574,2179,6395,2.948,11.599,8244,4077,4167,5.515,11.153,330,0.446,22.305,96,100,1594
1985,3256,2091,2334,119010,119216,202,8.683,187,8.038,12548,3001,9547,2.517,10.525,12941,5176,7765,4.342,10.855,-393,-0.33,21.051,131,131,1101
1985,3259,1806,2351,121106,121306,241,10.377,184,7.922,11512,3618,7894,2.983,9.49,11778,4597,7181,3.79,9.709,-266,-0.219,18.98,118,118,1318
1985,3261,10353,11991,580329,573537,1111,9.344,908,7.637,83517,19542,63975,3.407,14.562,69574,25641,43933,4.471,12.131,13943,2.431,24.261,651,659,13175
1985,3262,2008,2360,189183,187721,219,9.337,190,8.101,17855,2737,15118,1.458,9.511,14987,4239,10748,2.258,7.984,2868,1.528,15.967,138,138,1838
1985,3271,1327,1602,77186,78660,197,12.336,187,11.709,8238,2090,6148,2.657,10.473,11192,3625,7567,4.608,14.228,-2954,-3.755,20.946,135,135,1602
1985,3272,1563,1823,145104,149239,213,11.814,173,9.595,11065,3063,8002,2.052,7.414,19328,6596,12732,4.42,12.951,-8263,-5.537,14.829,123,123,900
1985,3273,6897,8954,185263,181576,660,7.341,733,8.153,33991,7901,26090,4.351,18.72,26704,9078,17626,5,14.707,7287,4.013,29.414,496,502,6076
1985,3274,233,327,17002,16788,21,6.269,37,11.045,1463,166,1297,0.989,8.715,1026,456,570,2.716,6.112,437,2.603,12.223,28,28,208
1985,3279,1864,2156,82432,82312,202,9.408,184,8.57,8487,2113,6374,2.567,10.311,8207,2029,6178,2.465,9.971,280,0.34,19.941,140,140,1304
1985,3311,267,307,154631,158569,44,14.79,25,8.403,8590,5460,3130,3.443,5.417,16352,968,15384,0.61,10.312,-7762,-4.895,10.834,18,18,225
1985,3312,496,664,60949,62818,42,6.231,62,9.199,4614,1805,2809,2.873,7.345,8395,2921,5474,4.65,13.364,-3781,-6.019,14.69,33,33,767
1985,3313,443,661,118489,121420,33,4.959,42,6.311,7951,2005,5946,1.651,6.548,14005,4405,9600,3.628,11.534,-6054,-4.986,13.097,20,20,719
1985,3314,722,880,84798,85663,79,8.906,93,10.485,8265,2033,6232,2.373,9.648,10065,4218,5847,4.924,11.75,-1800,-2.101,19.297,63,63,1366
1985,3315,2779,3074,220557,222837,172,5.544,229,7.381,21350,4172,17178,1.872,9.581,25847,10559,15288,4.738,11.599,-4497,-2.018,19.162,141,141,3433
1985,3321,3188,3400,144180,145492,199,5.847,206,6.053,14987,2147,12840,1.476,10.301,17595,6125,11470,4.21,12.093,-2608,-1.793,20.602,144,144,3177
1985,3322,1212,1324,83138,83739,116,8.755,118,8.906,6864,1482,5382,1.77,8.197,8033,2834,5199,3.384,9.593,-1169,-1.396,16.394,79,80,1121
1985,3323,9913,10720,336537,333346,895,8.332,939,8.741,54170,10427,43743,3.128,16.25,47534,16718,30816,5.015,14.26,6636,1.991,28.519,695,710,9937
1985,3324,1443,1793,127411,127272,104,5.771,122,6.77,11883,1343,10540,1.055,9.337,11466,3695,7771,2.903,9.009,417,0.328,18.018,75,75,1156
1985,3325,926,1003,77058,78152,81,8.112,72,7.211,5365,1015,4350,1.299,6.865,7506,2162,5344,2.766,9.604,-2141,-2.74,13.73,54,54,1182
1985,3326,1699,1904,68784,68948,204,10.883,145,7.735,8489,2148,6341,3.115,12.312,8777,3774,5003,5.474,12.73,-288,-0.418,24.625,105,105,2486
1985,3327,21644,21953,349106,339555,2326,10.746,1710,7.9,60259,12083,48176,3.558,17.746,41420,16921,24499,4.983,12.198,18839,5.548,24.397,1370,1371,11203
1985,3328,5487,5807,135280,132401,463,8.017,400,6.926,21503,5654,15849,4.27,16.241,15727,5533,10194,4.179,11.878,5776,4.363,23.757,314,315,3581
1985,3329,5654,6165,358112,355158,858,14.326,506,8.449,42645,9763,32882,2.749,12.007,37026,13919,23107,3.919,10.425,5619,1.582,20.85,339,340,4748
1985,3331,3040,3400,230046,235449,284,8.247,371,10.774,24480,5188,19292,2.203,10.397,35236,11192,24044,4.753,14.965,-10756,-4.568,20.794,241,241,3088
1985,3332,3731,3986,170808,169033,337,8.476,317,7.973,23510,5893,17617,3.486,13.909,19907,7559,12348,4.472,11.777,3603,2.132,23.554,227,228,3250
1985,3333,2064,2182,167070,168344,189,8.676,182,8.354,17773,2668,15105,1.585,10.558,20342,9571,10771,5.685,12.084,-2569,-1.526,21.115,120,121,1866
1985,3334,1747,1961,166849,167707,156,7.847,210,10.563,20575,3455,17120,2.06,12.268,22196,9130,13066,5.444,13.235,-1621,-0.967,24.537,150,150,3598
1985,3335,9624,10026,244401,237634,743,7.445,651,6.523,37292,6700,30592,2.819,15.693,23826,9572,14254,4.028,10.026,13466,5.667,20.053,502,502,4683
1985,3336,738,898,144349,146333,50,5.562,52,5.784,11099,3013,8086,2.059,7.585,15315,5044,10271,3.447,10.466,-4216,-2.881,15.17,30,30,540
1985,3339,5819,6382,320776,317620,452,7.043,523,8.15,41583,10945,30638,3.446,13.092,35416,14748,20668,4.643,11.15,6167,1.942,22.301,354,356,5460
1985,3341,1642,1840,361929,358370,275,15.068,245,13.425,54613,9610,45003,2.682,15.239,47038,12343,34695,3.444,13.126,7575,2.114,26.251,174,175,4400
1985,3342,1885,2094,289539,287527,219,10.547,184,8.861,43883,7207,36676,2.507,15.262,40388,14717,25671,5.118,14.047,3495,1.216,28.093,126,129,4830
1985,3343,376,402,46005,47167,42,10.219,60,14.599,4459,916,3543,1.942,9.454,6570,1775,4795,3.763,13.929,-2111,-4.476,18.907,45,45,1004
1985,3344,4545,5136,549896,542028,766,15.34,481,9.633,83327,21420,61907,3.952,15.373,67625,21826,45799,4.027,12.476,15702,2.897,24.953,342,345,7527
1985,3345,4190,4763,675080,661977,518,11.059,360,7.686,83174,18652,64522,2.818,12.564,57024,22343,34681,3.375,8.614,26150,3.95,17.228,214,215,4970
1985,3346,636,659,20248,19481,122,18.871,97,15.004,5003,3183,1820,16.339,25.682,3559,989,2570,5.077,18.27,1444,7.413,36.539,71,71,556
1985,3351,1188,1314,85107,84312,122,9.327,110,8.41,10789,2154,8635,2.555,12.797,9141,3012,6129,3.572,10.842,1648,1.955,21.684,82,83,1567
1985,3352,344,444,117781,122547,36,8.108,36,8.108,6584,1132,5452,0.924,5.373,15937,3087,12850,2.519,13.005,-9353,-7.632,10.745,21,21,199
1985,3353,2005,2509,246915,250057,186,7.422,180,7.183,25970,6577,19393,2.63,10.386,31980,10179,21801,4.071,12.789,-6010,-2.403,20.771,109,110,2425
1985,3359,2037,2381,210702,209503,289,12.401,188,8.067,23887,5848,18039,2.791,11.402,21287,6869,14418,3.279,10.161,2600,1.241,20.321,121,122,2122
1985,3361,208,264,281952,271155,47,18.54,26,10.256,65809,41943,23866,15.468,24.27,43014,35031,7983,12.919,15.863,22795,8.407,31.727,16,16,68
1985,3362,1772,1960,116048,117242,240,12.381,197,10.162,17333,3444,13889,2.938,14.784,19597,5470,14127,4.666,16.715,-2264,-1.931,29.568,147,148,3196
1985,3363,3791,4506,661650,658699,460,10.317,365,8.187,61433,13367,48066,2.029,9.326,56196,15347,40849,2.33,8.531,5237,0.795,17.063,252,257,5613
1985,3364,1264,1522,716555,693141,151,10.053,111,7.39,83779,22460,61319,3.24,12.087,36740,19976,16764,2.882,5.301,47039,6.786,10.601,75,75,1705
1985,3365,169,194,31195,31324,10,5.025,20,10.05,2510,273,2237,0.872,8.013,2807,618,2189,1.973,8.961,-297,-0.948,16.026,7,8,144
1985,3366,1142,1233,161393,161983,165,13.541,136,11.161,18358,2707,15651,1.671,11.333,19508,4168,15340,2.573,12.043,-1150,-0.71,22.667,94,95,1461
1985,3369,442,453,38656,38711,71,15.778,65,14.444,4779,533,4246,1.377,12.345,5114,1950,3164,5.037,13.211,-335,-0.865,24.691,49,49,723
1985,3371,12441,13038,382111,379420,1941,15.142,1503,11.725,55661,15470,40191,4.077,14.67,50463,20159,30304,5.313,13.3,5198,1.37,26.6,1201,1210,13159
1985,3372,2635,2773,144291,139988,354,13.053,232,8.555,22416,3966,18450,2.833,16.013,13771,4502,9269,3.216,9.837,8645,6.176,19.675,187,188,2943
1985,3379,1088,1221,41327,41303,123,10.161,102,8.426,5847,1900,3947,4.6,14.157,5821,2341,3480,5.668,14.094,26,0.063,28.187,87,88,1626
1985,3391,9940,10436,232392,232842,1222,11.744,1160,11.148,25821,6292,19529,2.702,11.09,26460,10271,16189,4.411,11.364,-639,-0.274,22.179,886,892,6676
1985,3399,14874,15448,401499,409293,1975,12.868,1776,11.571,56818,16398,40420,4.006,13.882,72373,28506,43867,6.965,17.682,-15555,-3.8,27.764,1393,1399,14894
1985,4231,22501,27538,312592,311349,2693,9.682,3245,11.667,48343,13700,34643,4.4,15.527,45882,21775,24107,6.994,14.737,2461,0.79,29.473,2304,2376,14453
1985,4232,7961,9069,106517,105335,1170,12.983,1056,11.718,19284,4894,14390,4.646,18.307,17094,8049,9045,7.641,16.228,2190,2.079,32.456,795,803,5567
1985,4233,7664,9423,119318,118271,1182,12.652,1021,10.929,20874,6182,14692,5.227,17.649,18859,8395,10464,7.098,15.946,2015,1.704,31.891,769,777,5868
1985,4234,22843,31134,552339,530873,4781,15.639,3654,11.953,121608,43058,78550,8.111,22.907,79613,41581,38032,7.833,14.997,41995,7.911,29.993,2348,2404,14950
1985,4235,6534,8816,131964,129494,953,10.843,899,10.229,21664,6169,15495,4.764,16.73,16771,7476,9295,5.773,12.951,4893,3.779,25.902,532,550,4047
1985,4236,15030,21911,316523,309968,2804,12.929,2357,10.868,68016,26133,41883,8.431,21.943,55249,25829,29420,8.333,17.824,12767,4.119,35.648,1493,1545,12708
1985,4237,10861,14242,158702,156069,1339,9.453,1184,8.359,24651,6692,17959,4.288,15.795,19321,9246,10075,5.924,12.38,5330,3.415,24.76,848,868,6259
1985,4238,46578,60505,641227,637140,5476,9.04,5618,9.274,98642,27449,71193,4.308,15.482,90440,36594,53846,5.743,14.195,8202,1.287,28.389,3762,3862,23085
1985,4239,22899,24376,225676,223104,3942,16.411,3231,13.451,45927,15734,30193,7.052,20.585,40864,17609,23255,7.893,18.316,5063,2.269,36.632,2519,2538,13056
1985,4241,8022,10660,156233,150106,1091,10.359,835,7.928,29588,11427,18161,7.613,19.711,17030,6197,10833,4.128,11.345,12558,8.366,22.691,586,589,3718
1985,4242,2738,3491,95134,96466,488,14.053,451,12.988,13040,3713,9327,3.849,13.518,15843,6455,9388,6.692,16.423,-2803,-2.906,27.036,333,334,4386
1985,4243,11094,11989,134334,133080,1877,15.735,1757,14.729,30644,10776,19868,8.097,23.027,28260,10850,17410,8.153,21.235,2384,1.791,42.471,1393,1410,7769
1985,4244,27082,33148,610869,608201,3670,11.038,3873,11.648,100967,27238,73729,4.478,16.601,95073,41519,53554,6.827,15.632,5894,0.969,31.264,2882,2938,24556
1985,4245,7851,10795,95455,97364,602,5.458,1071,9.71,13251,4010,9241,4.119,13.61,17125,6862,10263,7.048,17.589,-3874,-3.979,27.22,712,760,4742
1985,4246,7051,10355,118918,118576,1082,10.541,901,8.778,20961,5306,15655,4.475,17.677,19978,5200,14778,4.385,16.848,983,0.829,33.697,537,551,2746
1985,4247,11045,14362,149044,149032,853,5.816,1461,9.962,24986,5865,19121,3.935,16.766,25054,11646,13408,7.814,16.811,-68,-0.046,33.531,946,974,6884
1985,4248,4458,5554,138777,139643,312,5.55,448,7.969,13629,3316,10313,2.375,9.76,15379,4869,10510,3.487,11.013,-1750,-1.253,19.52,328,334,3374
1985,4249,19803,23826,257116,253533,3179,13.363,3107,13.06,47772,15183,32589,5.989,18.843,40795,18604,22191,7.338,16.091,6977,2.752,32.181,2225,2265,12299
1985,4251,29681,32341,308414,304200,3774,11.787,3128,9.77,55983,17205,38778,5.656,18.403,47486,18004,29482,5.918,15.61,8497,2.793,31.22,2185,2194,11084
1985,4411,37581,38684,884105,860919,4240,10.994,4007,10.39,136614,40755,95859,4.734,15.868,90106,41117,48989,4.776,10.466,46508,5.402,20.933,3244,3265,32338
1985,4412,11161,11603,81981,80672,1396,12.065,1331,11.503,17501,6029,11472,7.474,21.694,14906,6435,8471,7.977,18.477,2595,3.217,36.955,1074,1092,5435
1985,4413,47689,68215,470989,467712,7152,10.464,7421,10.857,89618,35217,54401,7.53,19.161,81658,43613,38045,9.325,17.459,7960,1.702,34.918,3518,3666,15884
1985,4421,21817,26668,218323,214731,3149,11.823,3082,11.571,41515,15150,26365,7.055,19.334,34556,16726,17830,7.789,16.093,6959,3.241,32.185,2321,2422,12223
1985,4422,20330,24534,143145,139299,3806,15.706,3204,13.222,33228,14781,18447,10.611,23.854,25506,11813,13693,8.48,18.31,7722,5.543,36.621,2446,2528,8890
1985,4431,23921,31700,210374,203546,5123,16.062,5512,17.282,54747,23004,31743,11.302,26.897,40928,23748,17180,11.667,20.107,13819,6.789,40.215,3770,3978,17219
1985,4441,55882,70948,711589,695846,6474,9.132,6358,8.969,123144,41168,81976,5.916,17.697,92005,38110,53895,5.477,13.222,31139,4.475,26.444,4734,4844,25224
1985,4442,14814,17874,127958,124852,2020,11.381,1770,9.972,25229,7998,17231,6.406,20.207,19064,7611,11453,6.096,15.269,6165,4.938,30.539,1298,1312,5539
1985,4451,64691,107683,2038612,1996218,11424,10.533,12981,11.968,342887,147226,195661,7.375,17.177,257746,123080,134666,6.166,12.912,85141,4.265,25.823,8789,9046,55829
1985,4452,22873,27677,178558,179701,3983,14.118,5053,17.911,40703,17121,23582,9.528,22.65,43186,22037,21149,12.263,24.032,-2483,-1.382,45.301,3622,3985,16793
1985,4453,28419,33665,169033,168736,3686,10.854,4273,12.583,33171,13442,19729,7.966,19.659,32507,13885,18622,8.229,19.265,664,0.394,38.53,3309,3385,10546
1985,4461,45061,66064,620232,606306,6819,10.429,5462,8.354,106169,41464,64705,6.839,17.511,77681,33705,43976,5.559,12.812,28488,4.699,25.624,3824,3944,22237
1985,4471,92444,124583,817386,802180,14690,11.644,17844,14.144,188089,79174,108915,9.87,23.447,157431,82365,75066,10.268,19.625,30658,3.822,39.251,12343,12742,54190
1985,4481,55389,96034,837473,810019,11396,11.806,12378,12.824,190942,73050,117892,9.018,23.573,136477,61245,75232,7.561,16.849,54465,6.724,33.697,8406,8915,38539
1985,4482,12047,36491,196656,195969,4109,11.33,3661,10.095,40602,19614,20988,10.009,20.719,39706,13560,26146,6.919,20.261,896,0.457,40.523,1768,1937,7212
1985,4483,18298,25897,151530,149640,3082,11.94,2911,11.278,29085,12310,16775,8.226,19.437,25172,11088,14084,7.41,16.822,3913,2.615,33.644,1900,2266,8370
1985,4511,31726,40377,265327,265387,5925,14.306,8005,19.328,58465,26171,32294,9.861,22.03,57204,32720,24484,12.329,21.555,1261,0.475,43.11,4597,4779,15754
1985,4512,7882,11762,79988,78656,1514,12.843,1567,13.293,16384,5755,10629,7.317,20.83,14001,6399,7602,8.135,17.8,2383,3.03,35.601,1037,1104,3936
1985,4522,420,6728,1136756,1118755,248,3.697,208,3.101,94972,29932,65040,2.675,8.489,60683,11460,49223,1.024,5.424,34289,3.065,10.848,28,33,1165
1985,4523,12618,27168,801133,784595,2736,10.01,3063,11.207,108346,42084,66262,5.364,13.809,76548,35797,40751,4.562,9.756,31798,4.053,19.513,1834,1876,10267
1985,4531,22405,23766,119909,115959,3547,15.086,3038,12.921,28418,10493,17925,9.049,24.507,20491,9605,10886,8.283,17.671,7927,6.836,35.342,2439,2468,7742
1985,4532,26681,32710,216329,209406,5608,17.456,4442,13.826,49392,21652,27740,10.34,23.587,35638,16978,18660,8.108,17.019,13754,6.568,34.037,3389,3485,12244
1985,4533,9377,11255,55975,54284,1676,14.877,1697,15.064,12906,5252,7654,9.675,23.775,9654,4845,4809,8.925,17.784,3252,5.991,35.568,1346,1357,3845
1985,4539,26737,32073,154515,151978,4816,14.911,5265,16.302,39392,16734,22658,11.011,25.92,34424,17322,17102,11.398,22.651,4968,3.269,45.301,3841,3938,13240
1985,4541,5948,7491,98038,97152,982,13.057,1042,13.855,18172,6508,11664,6.699,18.705,16754,9206,7548,9.476,17.245,1418,1.46,34.49,792,796,3922
1985,4542,3984,5107,78818,78775,508,9.709,758,14.488,13303,3051,10252,3.873,16.887,13081,6701,6380,8.507,16.606,222,0.282,33.211,441,485,3000
1985,4543,16128,21775,204511,200193,2033,9.296,2223,10.165,40750,11087,29663,5.538,20.355,32050,13584,18466,6.785,16.01,8700,4.346,32.019,1638,1661,8880
1985,4811,1032,2882,319921,305630,316,11.034,280,9.777,51851,4849,47002,1.587,16.965,23252,6212,17040,2.033,7.608,28599,9.357,15.216,153,153,4484
1985,4812,480,784,13947,12498,188,25.354,103,13.891,4134,1373,2761,10.986,33.077,1163,432,731,3.457,9.305,2971,23.772,18.611,82,82,349
1985,4831,375,622,32506,32435,68,10.906,71,11.387,5362,926,4436,2.855,16.532,5349,1006,4343,3.102,16.491,13,0.04,32.983,50,50,727
1985,4832,383,448,15078,15106,57,12.925,43,9.751,2544,630,1914,4.171,16.842,2623,358,2265,2.37,17.365,-79,-0.523,33.683,32,32,266
1985,4841,21150,26396,520992,513341,4752,18.038,4648,17.643,95243,28647,66596,5.581,18.554,80278,34408,45870,6.703,15.638,14965,2.915,31.277,3458,3491,18398
1985,4842,44127,48015,596007,581460,8129,17.164,6823,14.406,122152,38667,83485,6.65,21.008,93672,36855,56817,6.338,16.11,28480,4.898,32.22,5186,5201,23897
1985,4851,389,408,30943,30835,47,11.534,46,11.288,2386,543,1843,1.761,7.738,2070,1056,1014,3.425,6.713,316,1.025,13.427,35,35,782
1985,4852,350,660,22949,23704,37,5.514,59,8.793,2182,260,1922,1.097,9.205,3697,1068,2629,4.506,15.597,-1515,-6.391,18.41,22,22,436
1985,4853,5127,5187,56524,54778,963,18.53,983,18.915,13336,5131,8205,9.367,24.346,9955,4652,5303,8.493,18.174,3381,6.172,36.347,813,813,3960
1985,4854,3355,3556,96400,95157,292,8.159,338,9.444,11800,2479,9321,2.605,12.401,9156,4192,4964,4.405,9.622,2644,2.779,19.244,272,272,2681
1985,4855,614,650,13060,13387,119,18.814,84,13.281,2417,827,1590,6.178,18.056,3155,1655,1500,12.363,23.569,-738,-5.513,36.111,61,61,525
1985,4859,973,1001,19808,20169,193,19.214,200,19.91,3615,1102,2513,5.464,17.924,4319,2212,2107,10.968,21.415,-704,-3.491,35.848,155,155,1459
1985,4861,73,301,10715,11106,10,3.247,24,7.792,454,128,326,1.153,4.088,1248,337,911,3.035,11.238,-794,-7.15,8.176,4,5,137
1985,4862,250,1368,59588,58860,151,11.281,92,6.873,5882,2835,3047,4.817,9.993,4518,1482,3036,2.518,7.676,1364,2.317,15.352,22,22,297
1985,4869,64,344,7621,7517,17,4.964,14,4.088,817,79,738,1.051,10.869,581,55,526,0.732,7.729,236,3.14,15.458,4,4,27
1985,4871,215,218,3284,3031,53,25.604,31,14.976,1011,363,648,11.978,33.361,499,301,198,9.932,16.466,512,16.895,32.932,25,25,219
1985,4872,682,690,8829,8590,134,19.691,115,16.899,2043,738,1305,8.592,23.785,1569,531,1038,6.182,18.266,474,5.518,36.533,93,93,478
1985,4879,63,83,1900,2043,25,32.68,12,15.686,733,201,532,9.841,35.887,919,61,858,2.987,44.994,-186,-9.106,71.775,8,8,12
1985,4881,2088,2684,64680,63556,440,16.619,367,13.862,14294,5811,8483,9.143,22.491,11765,6002,5763,9.444,18.511,2529,3.979,37.023,263,263,1790
1985,4882,342,440,10950,10904,58,13.122,62,14.027,2103,626,1477,5.741,19.287,1979,1050,929,9.629,18.149,124,1.137,36.299,42,42,675
1985,4883,2076,2501,97422,103893,297,11.675,383,15.055,20390,4942,15448,4.757,19.626,33333,13250,20083,12.754,32.084,-12943,-12.458,39.252,281,288,5578
1985,4884,1496,2038,30965,31747,293,13.714,490,22.935,5259,1336,3923,4.208,16.566,6820,2964,3856,9.336,21.483,-1561,-4.917,33.131,356,363,1566
1985,4885,5557,7528,92982,90421,1316,18.016,869,11.897,20852,7178,13674,7.938,23.061,15583,6995,8588,7.736,17.234,5269,5.827,34.468,614,625,4691
1985,4889,387,392,4358,4509,94,24.704,71,18.66,1146,482,664,10.691,25.419,1501,918,583,20.362,33.293,-355,-7.874,50.837,59,59,365
1985,4921,1348,2262,90692,86312,514,23.78,313,14.481,17015,4155,12860,4.814,19.713,8304,1968,6336,2.28,9.621,8711,10.093,19.242,233,233,1482
1985,4922,1528,1573,11233,9914,616,43.734,287,20.376,4916,3307,1609,33.357,49.586,2272,1605,667,16.189,22.917,2644,26.669,45.834,235,235,1303
1985,4931,6234,9733,396795,387904,858,8.849,784,8.086,63725,16955,46770,4.371,16.428,46211,15253,30958,3.932,11.913,17514,4.515,23.826,345,356,3682
1985,5111,13798,15816,652473,640046,1811,11.551,1536,9.797,72808,17556,55252,2.743,11.375,47585,20197,27388,3.156,7.435,25223,3.941,14.869,1190,1203,10360
1985,5112,6863,8043,154471,152249,1145,13.882,1555,18.853,35581,7050,28531,4.631,23.37,31236,15043,16193,9.881,20.516,4345,2.854,41.033,1070,1081,7210
1985,5121,9423,14426,216456,215316,2306,16.079,2138,14.907,72311,37254,35057,17.302,33.584,72914,44446,28468,20.642,33.864,-603,-0.28,67.167,1327,1391,15008
1985,5122,1987,1992,13149,12508,521,27.392,341,17.928,4408,2040,2368,16.31,35.243,3150,1727,1423,13.808,25.185,1258,10.058,50.37,263,263,1169
1985,5151,6292,7431,229274,227799,955,12.972,817,11.098,33438,16183,17255,7.104,14.679,30638,15376,15262,6.75,13.45,2800,1.229,26.899,644,654,10754
1985,5152,9,9,54,49,5,62.5,3,37.5,18,14,4,28.571,36.735,9,8,1,16.327,18.367,9,18.367,36.735,3,3,8
1985,5173,3034,16413,919126,938943,2412,15.328,1058,6.723,160070,71855,88215,7.653,17.048,201456,19735,181721,2.102,21.456,-41386,-4.408,34.096,410,421,4240
1985,5174,721,1405,66051,62470,236,17.353,146,10.735,17890,7340,10550,11.75,28.638,10818,3737,7081,5.982,17.317,7072,11.321,34.635,68,68,1916
1985,5179,1325,2706,64067,64797,499,18.862,378,14.288,16135,8201,7934,12.656,24.901,17669,4845,12824,7.477,27.268,-1534,-2.367,49.802,247,247,2190
1985,5182,5903,7859,256484,245907,1279,16.393,1165,14.932,64944,24265,40679,9.868,26.41,42756,22908,19848,9.316,17.387,22188,9.023,34.774,684,698,8439
1985,5191,2372,2809,34614,32773,380,13.891,233,8.518,7594,2091,5503,6.38,23.172,3897,2050,1847,6.255,11.891,3697,11.281,23.782,181,181,1123
1985,5211,42,81,24895,24832,6,7.547,3,3.774,867,244,623,0.983,3.491,733,221,512,0.89,2.952,134,0.54,5.904,(D),(D),(D)
1985,5221,20237,70648,1953786,1929620,4164,5.938,3129,4.462,248677,61602,187075,3.192,12.887,200084,54158,145926,2.807,10.369,48593,2.518,20.738,1009,1096,19945
1985,5222,21921,39714,405332,396367,3839,9.715,3445,8.718,82935,30972,51963,7.814,20.924,64947,27277,37670,6.882,16.386,17988,4.538,32.771,1764,1784,10571
1985,5223,3831,4343,50905,49183,1110,26.47,811,19.339,15331,6658,8673,13.537,31.172,11676,6088,5588,12.378,23.74,3655,7.432,47.48,640,641,4116
1985,5231,6200,12506,290671,288032,2194,18.005,1553,12.745,50743,17738,33005,6.158,17.617,45767,12554,33213,4.359,15.89,4976,1.728,31.779,997,1010,6603
1985,5232,119,134,6747,6756,16,11.722,21,15.385,749,127,622,1.88,11.087,736,422,314,6.247,10.895,13,0.192,21.79,16,16,45
1985,5239,14102,14539,261939,245043,3147,21.434,3433,23.382,82561,22827,59734,9.316,33.693,51217,32450,18767,13.243,20.901,31344,12.791,41.803,2816,2816,25816
1985,5241,6553,30883,1291615,1271252,2859,9.246,2937,9.498,185098,49384,135714,3.885,14.56,145652,43937,101715,3.456,11.457,39446,3.103,22.915,520,528,6262
1985,5242,96594,101455,753434,727862,13625,13.453,13277,13.109,190236,64593,125643,8.874,26.136,137961,76610,61351,10.525,18.954,52275,7.182,37.909,10243,10264,57829
1985,5259,704,920,9608,9085,115,12.749,79,8.758,2526,955,1571,10.512,27.804,1413,713,700,7.848,15.553,1113,12.251,31.106,53,53,432
1985,5311,96271,98823,518068,508420,15077,15.232,15396,15.554,130108,62837,67271,12.359,25.591,110217,58362,51855,11.479,21.678,19891,3.912,43.357,12639,12662,45734
1985,5312,35873,37534,218243,208589,7251,19.751,5608,15.275,61721,26115,35606,12.52,29.59,42616,18182,24434,8.717,20.431,19105,9.159,40.861,4361,4364,13820
1985,5313,22521,23473,246410,234735,4734,20.652,3633,15.849,65775,25588,40187,10.901,28.021,42400,19766,22634,8.421,18.063,23375,9.958,36.126,2887,2890,14148
1985,5321,5791,9322,122530,116257,1408,15.294,1177,12.784,30109,10282,19827,8.844,25.899,17622,7691,9931,6.616,15.158,12487,10.741,30.316,716,744,3944
1985,5322,13917,16996,143431,135810,5241,33.618,2429,15.581,45920,22995,22925,16.932,33.812,31032,15578,15454,11.47,22.85,14888,10.962,45.699,1592,1617,8705
1985,5323,3260,4043,31792,31083,876,22.777,482,12.533,8250,3728,4522,11.994,26.542,6914,2711,4203,8.722,22.244,1336,4.298,44.487,296,296,1215
1985,5324,6163,7488,97235,85678,1459,20.49,724,10.168,36766,22335,14431,26.069,42.912,14786,5430,9356,6.338,17.258,21980,25.654,34.515,445,451,2490
1985,5331,889,929,11054,10999,160,17.372,144,15.635,2648,878,1770,7.983,24.076,2545,1086,1459,9.874,23.14,103,0.936,46.279,119,119,814
1985,5411,123723,127413,738832,718373,15538,12.286,13649,10.792,140467,47284,93183,6.582,19.553,98800,46720,52080,6.504,13.753,41667,5.8,27.507,10307,10375,36176
1985,5412,56549,59476,451359,433107,10291,17.705,7589,13.056,98608,38247,60361,8.831,22.768,61757,30446,31311,7.03,14.259,36851,8.509,28.518,5632,5692,23606
1985,5413,53028,57990,767589,738292,9972,17.686,6756,11.983,171311,49298,122013,6.677,23.204,112793,40848,71945,5.533,15.278,58518,7.926,30.555,4946,4982,26457
1985,5414,13195,13403,94693,92336,2664,20.464,1894,14.549,24575,9172,15403,9.933,26.615,19785,8964,10821,9.708,21.427,4790,5.188,42.855,1526,1529,6348
1985,5415,10182,11354,112777,97890,4418,43.42,2060,20.246,48857,30496,18361,31.153,49.91,19199,10935,8264,11.171,19.613,29658,30.297,39.226,1595,1598,6365
1985,5416,35444,36682,298044,285210,9931,28.476,6317,18.113,102288,45339,56949,15.897,35.864,76300,35567,40733,12.47,26.752,25988,9.112,53.504,4964,4982,27357
1985,5417,6139,7423,427261,421838,1130,15.454,908,12.418,58544,17116,41428,4.057,13.878,47396,11946,35450,2.832,11.236,11148,2.643,22.471,586,590,3864
1985,5418,24202,26470,342789,330466,4692,18.176,3380,13.094,79232,26273,52959,7.95,23.976,54217,24872,29345,7.526,16.406,25015,7.57,32.812,2671,2692,18885
1985,5419,28772,32026,216779,211103,4374,13.899,3260,10.359,50712,17622,33090,8.348,24.022,39412,13687,25725,6.484,18.67,11300,5.353,37.339,2493,2508,10610
1985,5511,23750,43760,3006883,2934277,4107,9.398,3985,9.119,543176,140253,402923,4.78,18.511,400625,124999,275626,4.26,13.653,142551,4.858,27.307,1000,1012,12718
1985,5611,9937,10483,162822,150936,2290,22.469,1708,16.758,51989,19335,32654,12.81,34.445,27975,13045,14930,8.643,18.534,24014,15.91,37.069,1356,1360,8835
1985,5612,193,230,20064,15679,91,45.05,35,17.327,9934,2648,7286,16.889,63.359,1526,999,527,6.372,9.733,8408,53.626,19.466,26,26,744
1985,5613,13007,17226,931045,830587,3486,21.086,2098,12.691,339969,83229,256740,10.021,40.931,138473,37872,100601,4.56,16.672,201496,24.259,33.343,1557,1582,25407
1985,5614,18625,20992,225343,217763,3506,16.99,2794,13.539,51070,18005,33065,8.268,23.452,35689,14424,21265,6.624,16.389,15381,7.063,32.778,2215,2228,9908
1985,5615,21350,24832,195983,188259,3726,15.368,2551,10.522,44418,14368,30050,7.632,23.594,28767,13508,15259,7.175,15.281,15651,8.314,30.561,1904,1972,10332
1985,5616,11014,13444,427492,415463,2304,17.459,1810,13.715,103019,25613,77406,6.165,24.796,79600,26198,53402,6.306,19.159,23419,5.637,38.319,1375,1377,14388
1985,5617,63873,66981,846538,806547,15864,24.492,11444,17.668,239510,82233,157277,10.196,29.696,159633,64488,95145,7.996,19.792,79877,9.904,39.584,9051,9075,46343
1985,5619,12136,13025,180304,172685,2413,19.022,1733,13.662,46001,14050,31951,8.136,26.639,31042,12050,18992,6.978,17.976,14959,8.663,35.952,1312,1323,8454
1985,5621,3797,3926,87830,86466,442,10.992,632,15.717,13069,2413,10656,2.791,15.115,10622,5307,5315,6.138,12.285,2447,2.83,24.569,539,540,3864
1985,5622,1973,2545,51140,48551,283,11.159,265,10.45,11769,3907,7862,8.047,24.24,6660,2822,3838,5.812,13.718,5109,10.523,27.435,196,196,1747
1985,5629,4530,4798,43569,41978,753,15.863,651,13.714,11667,3574,8093,8.514,27.793,8457,3510,4947,8.362,20.146,3210,7.647,40.293,504,504,2812
1985,6111,13119,13531,380424,374390,693,5.144,575,4.268,40473,6634,33839,1.772,10.81,28314,7405,20909,1.978,7.563,12159,3.248,15.125,446,452,6090
1985,6112,421,529,37378,36373,41,7.787,36,6.838,4988,692,4296,1.903,13.713,3012,340,2672,0.935,8.281,1976,5.433,16.562,24,25,169
1985,6113,2018,2360,924737,920964,85,3.604,82,3.477,89594,1626,87968,0.177,9.728,82225,15786,66439,1.714,8.928,7369,0.8,17.856,57,58,12789
1985,6114,2010,2329,37677,35715,472,20.834,345,15.228,9449,3494,5955,9.783,26.457,5598,2296,3302,6.429,15.674,3851,10.783,31.349,278,278,1418
1985,6115,3178,3657,45524,43494,590,16.471,440,12.284,10460,3654,6806,8.401,24.049,6462,2637,3825,6.063,14.857,3998,9.192,29.714,317,320,1833
1985,6116,10746,11253,97804,96892,2166,19.318,2085,18.595,23859,9247,14612,9.544,24.624,22030,9616,12414,9.925,22.737,1829,1.888,45.474,1643,1656,7323
1985,6117,1423,1451,14381,18462,303,21.528,216,15.346,3472,1579,1893,8.553,18.806,11103,10333,770,55.969,60.14,-7631,-41.334,37.612,158,158,845
1985,6211,181205,187239,1117562,1091012,15119,8.108,13576,7.281,204178,65326,138852,5.988,18.715,151330,57824,93506,5.3,13.871,52848,4.844,27.741,11054,11160,45821
1985,6212,95559,97727,461876,451160,6602,6.794,5493,5.653,79149,23266,55883,5.157,17.543,58046,19978,38068,4.428,12.866,21103,4.677,25.732,4295,4368,16051
1985,6213,44121,45928,159780,152534,6901,15.414,4586,10.243,41986,18964,23022,12.433,27.526,27503,13722,13781,8.996,18.031,14483,9.495,36.062,3449,3512,11074
1985,6214,5857,7598,129322,123409,1294,17.65,761,10.38,30598,13140,17458,10.648,24.794,18994,8192,10802,6.638,15.391,11604,9.403,30.782,526,532,5228
1985,6215,4349,5302,68718,69022,780,14.825,699,13.285,14284,4873,9411,7.06,20.695,14585,9166,5419,13.28,21.131,-301,-0.436,41.39,467,493,4703
1985,6216,4336,5718,224716,208927,1264,23.364,648,11.978,67118,23072,44046,11.043,32.125,35231,14485,20746,6.933,16.863,31887,15.262,33.726,423,435,7140
1985,6219,4222,4860,88166,85354,1058,22.993,541,11.757,24349,11588,12761,13.576,28.527,18500,7749,10751,9.079,21.675,5849,6.853,43.349,365,375,4471
1985,6221,3609,4909,3054203,3054429,232,4.728,228,4.646,302271,169056,133215,5.535,9.896,301066,82012,219054,2.685,9.857,1205,0.039,19.713,157,159,60788
1985,6222,390,570,369803,312818,74,13.479,32,5.829,159590,113401,46189,36.251,51.017,45277,29336,15941,9.378,14.474,114313,36.543,28.948,20,20,1044
1985,6223,187,222,47605,46904,14,6.25,18,8.036,4114,1842,2272,3.927,8.771,2811,1199,1612,2.556,5.993,1303,2.778,11.986,8,9,796
1985,6231,8300,12515,1022589,1000897,1030,8.272,903,7.252,143902,58405,85497,5.835,14.377,100562,49314,51248,4.927,10.047,43340,4.33,20.094,634,658,37161
1985,6232,4394,6001,137485,130361,789,13.615,377,6.506,26836,9873,16963,7.574,20.586,12522,4670,7852,3.582,9.606,14314,10.98,19.211,291,292,3363
1985,6233,7403,8514,229766,226264,1240,14.872,888,10.65,36286,15167,21119,6.703,16.037,29220,14864,14356,6.569,12.914,7066,3.123,25.828,633,636,10624
1985,6239,2812,3434,81791,79444,355,10.528,231,6.851,12855,3813,9042,4.8,16.181,8104,3449,4655,4.341,10.201,4751,5.98,20.402,165,166,2625
1985,6241,14277,19261,278040,271091,2051,10.81,1476,7.779,46651,11510,35141,4.246,17.209,32285,11678,20607,4.308,11.909,14366,5.299,23.819,971,987,8317
1985,6242,4083,4817,43178,41402,535,11.356,323,6.856,9286,3443,5843,8.316,22.429,5781,3159,2622,7.63,13.963,3505,8.466,27.927,203,204,2407
1985,6243,3936,5634,245767,238141,543,9.778,381,6.861,47056,7571,39485,3.179,19.76,32004,8113,23891,3.407,13.439,15052,6.321,26.878,235,238,5107
1985,6244,30476,35832,323988,310215,5359,15.302,3739,10.676,70902,28433,42469,9.166,22.856,43241,18909,24332,6.095,13.939,27661,8.917,27.878,2978,3006,14437
1985,7111,4885,4927,68639,66725,862,17.441,893,18.068,18493,4931,13562,7.39,27.715,14652,5057,9595,7.579,21.959,3841,5.756,43.918,690,692,4019
1985,7112,2139,2245,66483,64789,398,17.784,384,17.158,19487,5328,14159,8.224,30.078,16086,6332,9754,9.773,24.828,3401,5.249,49.657,314,315,4475
1985,7113,2170,2211,32878,31972,433,19.862,371,17.018,11095,3483,7612,10.894,34.703,9151,3117,6034,9.749,28.622,1944,6.08,57.245,277,277,2382
1985,7114,1008,1026,10375,10671,214,20.97,203,19.892,3487,1373,2114,12.867,32.679,4164,1931,2233,18.097,39.023,-677,-6.345,65.358,149,149,1529
1985,7115,9554,9588,47738,44548,3289,37.303,1747,19.814,20969,12108,8861,27.18,47.071,14473,5769,8704,12.95,32.489,6496,14.582,64.978,1342,1342,4653
1985,7121,2224,2376,38881,37649,238,10.219,144,6.183,5691,972,4719,2.582,15.116,3229,843,2386,2.239,8.577,2462,6.539,17.153,97,97,477
1985,7131,1666,2126,55372,56641,298,13.233,550,24.423,10043,1497,8546,2.643,17.731,12444,2900,9544,5.12,21.97,-2401,-4.239,35.462,434,447,1898
1985,7132,673,699,20768,19676,127,18.326,115,16.595,4589,2368,2221,12.035,23.323,2257,916,1341,4.655,11.471,2332,11.852,22.942,95,95,749
1985,7139,32582,34675,501639,490593,4810,13.961,4364,12.667,101261,36036,65225,7.345,20.641,79229,30447,48782,6.206,16.15,22032,4.491,32.299,3348,3370,22156
1985,7211,28979,33551,1201505,1172701,4575,13.631,4600,13.705,246141,119613,126528,10.2,20.989,189015,89880,99135,7.664,16.118,57126,4.871,32.236,3417,3459,59180
1985,7212,3677,3942,24457,23087,545,13.894,506,12.9,7434,3147,4287,13.631,32.201,4760,1732,3028,7.502,20.618,2674,11.583,41.236,366,370,1268
1985,7213,4495,4603,24166,23414,310,6.629,457,9.772,5015,2374,2641,10.139,21.419,3568,1472,2096,6.287,15.239,1447,6.18,30.478,334,334,1085
1985,7223,16739,25839,480482,485067,4521,17.249,5263,20.08,128604,60592,68012,12.491,26.513,135218,84650,50568,17.451,27.876,-6614,-1.364,53.025,2679,2787,25301
1985,7224,54945,55689,320842,322605,8297,14.555,10926,19.167,86831,45341,41490,14.055,26.916,90338,46910,43428,14.541,28.003,-3507,-1.087,53.831,8907,8940,38196
1985,7225,195233,254036,4635201,4519948,43752,17.367,39525,15.689,1123120,601288,521832,13.303,24.848,889926,433368,456558,9.588,19.689,233194,5.159,39.378,30195,30971,288551
1985,8111,102176,106849,534500,514452,18303,17.44,14497,13.814,136116,61081,75035,11.873,26.458,96264,47253,49011,9.185,18.712,39852,7.747,37.424,11472,11570,37581
1985,8112,9902,11193,80073,76896,1684,15.16,1515,13.638,19477,7544,11933,9.811,25.329,13198,5601,7597,7.284,17.163,6279,8.166,34.327,1156,1167,3696
1985,8113,18598,19494,146266,141849,3045,15.855,2468,12.85,33772,12424,21348,8.759,23.808,24972,11921,13051,8.404,17.605,8800,6.204,35.209,1895,1900,8270
1985,8114,23704,25160,152804,150076,4318,17.302,3911,15.671,31968,12954,19014,8.632,21.301,26485,13050,13435,8.696,17.648,5483,3.653,35.296,2961,2974,9021
1985,8121,80135,89282,471437,463879,13061,14.553,13997,15.596,106530,50080,56450,10.796,22.965,91446,45576,45870,9.825,19.713,15084,3.252,39.427,11295,11456,36120
1985,8122,17278,19982,116975,116251,1446,7.218,1551,7.742,17384,5441,11943,4.68,14.954,15977,5269,10708,4.532,13.744,1407,1.21,27.487,1059,1083,3990
1985,8123,32292,38131,344944,341694,4727,12.358,4966,12.983,58228,21333,36895,6.243,17.041,51744,27244,24500,7.973,15.143,6484,1.898,30.287,3844,3969,20977
1985,8129,13602,20701,213394,208853,3926,19.305,3198,15.725,55326,20195,35131,9.669,26.49,45951,20272,25679,9.706,22.002,9375,4.489,44.003,2010,2093,12170
1985,8131,120337,120438,944828,921513,11430,9.71,5977,5.078,144561,31413,113148,3.409,15.687,98919,20059,78860,2.177,10.734,45642,4.953,21.469,3047,3047,7659
1985,8132,7553,8622,119924,117875,842,9.864,670,7.849,19694,4030,15664,3.419,16.708,15549,6800,8749,5.769,13.191,4145,3.516,26.382,490,496,5500
1985,8133,7098,8167,92090,90492,856,10.545,757,9.326,17520,4383,13137,4.844,19.361,14596,5419,9177,5.988,16.13,2924,3.231,32.259,523,536,3993
1985,8134,28057,29446,255955,253600,2051,6.875,2824,9.466,37280,9225,28055,3.638,14.7,32344,8932,23412,3.522,12.754,4936,1.946,25.508,1699,1701,5872
1985,8139,54738,56943,452945,446367,4693,8.209,5138,8.988,87251,21331,65920,4.779,19.547,73885,25859,48026,5.793,16.553,13366,2.994,33.105,3527,3535,19890
1986,1131,232,239,3224,3197,52,22.318,40,17.167,797,272,525,8.509,24.934,753,268,485,8.384,23.557,44,1.377,47.114,34,34,171
1986,1132,92,107,1491,1400,14,13.146,13,12.207,355,130,225,9.286,25.357,168,55,113,3.929,12,187,13.357,24,9,9,48
1986,1133,10380,10466,86351,87617,1483,13.921,1857,17.432,20002,6572,13430,7.501,22.829,22447,8875,13572,10.129,25.62,-2445,-2.791,45.658,1335,1336,5572
1986,1141,1131,1141,7133,7263,187,16.003,242,20.71,2249,941,1308,12.956,30.965,2463,1155,1308,15.903,33.912,-214,-2.946,61.93,187,187,687
1986,1142,123,123,528,515,20,15.873,26,20.635,148,62,86,12.051,28.766,125,65,60,12.634,24.295,23,4.47,48.591,23,23,54
1986,1151,3945,4335,52861,53855,601,13.877,593,13.692,14650,5196,9454,9.648,27.203,16730,5631,11099,10.456,31.065,-2080,-3.862,54.406,398,398,3315
1986,1152,1848,1865,13641,13459,324,17.642,267,14.539,2864,1122,1742,8.337,21.28,2496,865,1631,6.427,18.546,368,2.734,37.092,197,197,620
1986,1153,778,789,9511,9293,150,19.072,145,18.436,3076,1076,2000,11.579,33.1,2663,1274,1389,13.709,28.656,413,4.444,57.312,106,106,833
1986,2111,7829,9607,151098,157214,1087,11.123,1418,14.51,24158,7473,16685,4.753,15.366,36584,10485,26099,6.669,23.27,-12426,-7.904,30.733,981,991,4741
1986,2121,2564,3188,167956,170466,487,14.973,616,18.939,27966,8699,19267,5.103,16.406,32958,13267,19691,7.783,19.334,-4992,-2.928,32.811,411,412,4920
1986,2122,457,598,35147,37237,91,14.749,129,20.908,5332,1887,3445,5.068,14.319,9609,2304,7305,6.187,25.805,-4277,-11.486,28.638,83,83,984
1986,2123,3535,5043,102818,103301,437,8.674,427,8.476,14725,4152,10573,4.019,14.255,15789,4710,11079,4.56,15.285,-1064,-1.03,28.509,266,269,1936
1986,2131,10202,11714,227565,255316,1344,11.035,2275,18.679,38254,15347,22907,6.011,14.983,93423,23088,70335,9.043,36.591,-55169,-21.608,29.966,1671,1685,14308
1986,2211,1640,5905,601624,597802,293,5.014,170,2.909,40386,13387,26999,2.239,6.756,32105,2594,29511,0.434,5.371,8281,1.385,10.741,58,58,775
1986,2212,573,2443,140701,141659,123,5.054,104,4.274,7115,1472,5643,1.039,5.023,8775,2093,6682,1.477,6.194,-1660,-1.172,10.045,35,35,216
1986,2213,3811,4099,31549,30667,362,8.945,258,6.375,4687,1955,2732,6.375,15.284,2884,1226,1658,3.998,9.404,1803,5.879,18.809,172,172,631
1986,2361,99294,99626,601424,583069,22099,22.763,17014,17.525,209332,84641,124691,14.516,35.902,172760,70832,101928,12.148,29.629,36572,6.272,59.259,12134,12142,52970
1986,2362,37139,37798,693623,677530,5864,15.699,4973,13.314,194569,44305,150264,6.539,28.717,162054,40245,121809,5.94,23.918,32515,4.799,47.837,3714,3716,27554
1986,2371,13103,13423,301734,310625,1555,11.596,1528,11.395,61441,12529,48912,4.033,19.78,78477,16040,62437,5.164,25.264,-17036,-5.484,39.56,1114,1114,8913
1986,2372,9627,9763,88244,86963,2556,27.069,1915,20.281,31179,15609,15570,17.949,35.853,28392,11787,16605,13.554,32.648,2787,3.205,65.297,1498,1501,8880
1986,2373,10316,10608,232267,224409,1283,12.22,1065,10.144,63691,13020,50671,5.802,28.382,47505,9618,37887,4.286,21.169,16186,7.213,42.338,757,759,6121
1986,2379,4833,4933,83776,82590,862,17.646,766,15.681,23709,8331,15378,10.087,28.707,21771,5531,16240,6.697,26.36,1938,2.347,52.721,544,544,2831
1986,2381,70707,71099,695970,675653,12555,18.055,9432,13.564,215789,66031,149758,9.773,31.938,174974,54698,120276,8.096,25.897,40815,6.041,51.794,6920,6931,42227
1986,2382,109387,111065,1148720,1126737,16451,15.113,12030,11.051,272573,70050,202523,6.217,24.191,228311,69999,158312,6.213,20.263,44262,3.928,40.526,9027,9041,48843
1986,2383,72338,72753,625278,609026,14556,20.515,10955,15.44,192953,61292,131661,10.064,31.682,160754,54344,106410,8.923,26.395,32199,5.287,52.791,8027,8031,41683
1986,2389,37587,37819,349642,342498,6286,16.886,5100,13.7,101382,31406,69976,9.17,29.601,86845,25946,60899,7.576,25.356,14537,4.244,50.713,3750,3750,18804
1986,3111,1262,1874,49418,49767,97,5.124,135,7.132,5602,1959,3643,3.936,11.257,6301,1770,4531,3.557,12.661,-699,-1.405,22.513,77,77,839
1986,3112,499,850,65964,66374,41,4.804,48,5.624,4386,822,3564,1.238,6.608,5329,618,4711,0.931,8.029,-943,-1.421,13.216,26,26,198
1986,3113,1532,1828,79903,81044,274,15.235,215,11.954,8293,2291,6002,2.827,10.233,10568,2504,8064,3.09,13.04,-2275,-2.807,20.465,155,155,1101
1986,3114,1191,1657,178442,178620,120,7.212,134,8.053,20212,3765,16447,2.108,11.316,20663,4286,16377,2.4,11.568,-451,-0.252,22.631,92,93,2254
1986,3115,1653,2315,131284,132013,139,5.894,226,9.582,14628,4855,9773,3.678,11.081,16151,7450,8701,5.643,12.234,-1523,-1.154,22.162,146,147,1996
1986,3116,3965,4530,333277,327439,323,7.026,457,9.941,40769,9380,31389,2.865,12.451,28992,10024,18968,3.061,8.854,11777,3.597,17.708,329,330,4245
1986,3117,722,814,39051,39265,74,9.035,84,10.256,5829,1445,4384,3.68,14.845,6159,1328,4831,3.382,15.686,-330,-0.84,29.691,47,50,726
1986,3118,8967,10460,294802,300944,1443,13.83,1390,13.322,39154,13501,25653,4.486,13.01,50805,16609,34196,5.519,16.882,-11651,-3.871,26.021,1024,1048,8416
1986,3119,2056,2414,124646,123579,228,9.451,225,9.326,15106,2716,12390,2.198,12.224,13124,3987,9137,3.226,10.62,1982,1.604,21.24,170,170,2279
1986,3121,1898,2403,159391,161178,179,7.4,211,8.723,16417,4405,12012,2.733,10.186,20191,7543,12648,4.68,12.527,-3774,-2.342,20.371,134,136,2456
1986,3122,110,150,37550,39262,4,2.589,13,8.414,1753,16,1737,0.041,4.465,5189,1714,3475,4.366,13.216,-3436,-8.751,8.93,5,5,199
1986,3131,424,636,98783,98817,33,5.097,56,8.649,9831,2606,7225,2.637,9.949,9891,3302,6589,3.342,10.009,-60,-0.061,19.897,30,30,1129
1986,3132,1623,1978,251112,257417,142,7.077,199,9.918,19214,3850,15364,1.496,7.464,32143,10039,22104,3.9,12.487,-12929,-5.023,14.928,145,146,2076
1986,3133,1589,1837,100780,101534,152,8.265,156,8.483,11473,2441,9032,2.404,11.3,12864,4739,8125,4.667,12.67,-1391,-1.37,22.599,104,106,1307
1986,3141,3856,4144,123770,124035,519,12.486,544,13.088,16153,3880,12273,3.128,13.023,16478,5751,10727,4.637,13.285,-325,-0.262,26.046,425,436,3150
1986,3149,3630,3768,120082,120630,506,13.376,536,14.169,20547,6066,14481,5.029,17.033,21793,10109,11684,8.38,18.066,-1246,-1.033,34.066,446,446,6964
1986,3151,1333,1448,139891,138170,126,8.672,136,9.36,16121,2674,13447,1.935,11.668,12680,4395,8285,3.181,9.177,3441,2.49,18.354,112,112,2675
1986,3152,11409,12812,796115,803341,1821,14.038,2140,16.498,131852,42624,89228,5.306,16.413,145475,62777,82698,7.814,18.109,-13623,-1.696,32.826,1748,1756,38965
1986,3159,1833,1922,67980,69982,229,11.684,305,15.561,9221,2074,7147,2.964,13.176,13013,4453,8560,6.363,18.595,-3792,-5.419,26.352,260,260,3105
1986,3161,333,364,14294,14827,34,9.103,53,14.19,2203,1026,1177,6.92,14.859,3251,1820,1431,12.275,21.927,-1048,-7.068,29.717,44,46,1541
1986,3162,407,565,87184,93531,33,5.584,85,14.382,6730,1399,5331,1.496,7.196,19391,7747,11644,8.283,20.732,-12661,-13.537,14.391,51,53,1894
1986,3169,1150,1200,40409,42215,86,6.905,177,14.211,4882,1329,3553,3.148,11.565,8466,2788,5678,6.604,20.055,-3584,-8.49,23.129,142,142,1614
1986,3211,4624,5111,133112,133159,483,9.285,665,12.784,18160,5464,12696,4.103,13.638,18239,6217,12022,4.669,13.697,-79,-0.059,27.276,495,496,3753
1986,3212,1152,1400,87452,85986,157,11.373,118,8.548,11706,4430,7276,5.152,13.614,8688,3481,5207,4.048,10.104,3018,3.51,20.208,79,79,1315
1986,3219,8962,9675,281576,278733,1114,11.533,1082,11.202,49340,14985,34355,5.376,17.702,43616,16859,26757,6.048,15.648,5724,2.054,31.296,811,815,7911
1986,3221,226,545,194593,195788,17,3.088,28,5.086,10908,4338,6570,2.216,5.571,13475,4971,8504,2.539,6.882,-2567,-1.311,11.143,14,14,294
1986,3222,3618,5195,396369,394260,338,6.537,289,5.589,38428,8468,29960,2.148,9.747,34018,9528,24490,2.417,8.628,4410,1.119,17.257,202,205,4957
1986,3231,38094,39735,760199,751256,4601,11.732,3569,9.1,102638,27844,74794,3.706,13.662,84724,29101,55623,3.874,11.278,17914,2.385,22.555,2846,2854,20856
1986,3241,1406,2308,177430,187868,211,9.138,213,9.225,9818,1913,7905,1.018,5.226,30434,5459,24975,2.906,16.2,-20616,-10.974,10.452,119,119,1541
1986,3251,1109,2213,227683,232458,157,7.088,161,7.269,17905,5341,12564,2.298,7.702,27418,8744,18674,3.762,11.795,-9513,-4.092,15.405,74,75,929
1986,3252,381,623,126274,130877,48,7.811,31,5.045,5563,1988,3575,1.519,4.251,14605,1619,12986,1.237,11.159,-9042,-6.909,8.501,13,13,137
1986,3253,664,991,44112,45525,67,6.663,96,9.547,4060,1124,2936,2.469,8.918,6869,1769,5100,3.886,15.089,-2809,-6.17,17.837,49,50,312
1986,3254,1028,1270,157739,158016,137,10.895,112,8.907,17925,5541,12384,3.507,11.344,18335,9027,9308,5.713,11.603,-410,-0.259,22.688,74,74,4249
1986,3255,1651,2131,75829,75398,152,7.16,136,6.406,9076,2779,6297,3.686,12.038,8158,1728,6430,2.292,10.82,918,1.218,21.64,88,88,595
1986,3256,2073,2313,116348,117124,196,8.448,210,9.052,10759,3356,7403,2.865,9.186,12264,2463,9801,2.103,10.471,-1505,-1.285,18.372,156,156,1837
1986,3259,1804,2371,120688,120574,234,9.924,208,8.821,10149,3579,6570,2.968,8.417,9882,3280,6602,2.72,8.196,267,0.221,16.392,108,113,1524
1986,3261,10273,11971,591521,583317,1068,8.929,1049,8.77,87831,23980,63851,4.111,15.057,71366,21143,50223,3.625,12.235,16465,2.823,24.469,776,781,12107
1986,3262,1966,2329,180105,183929,187,8.015,195,8.358,13603,3426,10177,1.863,7.396,21347,8030,13317,4.366,11.606,-7744,-4.21,14.792,146,146,1535
1986,3271,1324,1601,73988,75366,190,11.853,194,12.102,7393,1572,5821,2.086,9.809,10273,3344,6929,4.437,13.631,-2880,-3.821,19.619,147,147,1513
1986,3272,1559,1815,134364,138877,211,11.613,215,11.833,12096,2605,9491,1.876,8.71,20845,3533,17312,2.544,15.01,-8749,-6.3,17.42,156,157,1666
1986,3273,6766,8941,187321,185910,663,7.417,658,7.361,30729,7426,23303,3.994,16.529,28020,7042,20978,3.788,15.072,2709,1.457,30.144,455,476,4903
1986,3274,230,324,17424,17274,25,7.657,30,9.188,1378,212,1166,1.227,7.978,1083,229,854,1.326,6.27,295,1.708,12.539,24,24,103
1986,3279,1867,2151,80933,81509,189,8.778,193,8.964,8363,1913,6450,2.347,10.26,9544,2576,6968,3.16,11.709,-1181,-1.449,20.52,138,140,1597
1986,3311,280,316,137323,141859,40,12.862,30,9.646,3906,2029,1877,1.43,2.753,13144,899,12245,0.634,9.266,-9238,-6.512,5.507,19,19,91
1986,3312,511,671,56568,58265,50,7.496,42,6.297,4298,817,3481,1.402,7.377,7880,2284,5596,3.92,13.525,-3582,-6.148,14.753,24,24,475
1986,3313,433,645,111447,114605,39,6,49,7.538,7525,2803,4722,2.446,6.566,13996,4514,9482,3.939,12.212,-6471,-5.646,13.132,27,27,2131
1986,3314,698,850,76422,80516,69,7.972,100,11.554,5091,1738,3353,2.159,6.323,13337,4672,8665,5.803,16.564,-8246,-10.241,12.646,65,65,1496
1986,3315,2665,2927,212265,213786,164,5.511,262,8.804,24227,8209,16018,3.84,11.332,27415,9215,18200,4.31,12.824,-3188,-1.491,22.665,176,179,3719
1986,3321,3177,3380,135007,138696,198,5.845,213,6.288,12852,3322,9530,2.395,9.266,20359,6178,14181,4.454,14.679,-7507,-5.413,18.533,136,136,2702
1986,3322,1187,1304,80958,81705,100,7.645,108,8.257,7641,2597,5044,3.179,9.352,8899,2713,6186,3.321,10.892,-1258,-1.54,18.704,81,81,1800
1986,3323,9767,10542,332156,332697,849,8.005,977,9.212,51758,10485,41273,3.152,15.557,52829,15691,37138,4.716,15.879,-1071,-0.322,31.114,703,706,8201
1986,3324,1432,1771,123183,124235,134,7.56,137,7.729,14263,3543,10720,2.852,11.481,16863,4014,12849,3.231,13.574,-2600,-2.093,22.961,85,87,946
1986,3325,916,997,74996,75222,68,6.844,61,6.14,6196,1751,4445,2.328,8.237,6720,1150,5570,1.529,8.934,-524,-0.697,16.474,49,49,915
1986,3326,1613,1814,66136,66891,134,7.296,179,9.747,8262,2286,5976,3.418,12.352,9728,3040,6688,4.545,14.543,-1466,-2.192,24.703,131,131,1629
1986,3327,21771,22069,341838,343915,2081,9.45,1984,9.01,46426,10808,35618,3.143,13.499,50695,14832,35863,4.313,14.741,-4269,-1.241,26.999,1562,1563,9780
1986,3328,5451,5780,147457,141368,463,8.008,467,8.077,32035,6315,25720,4.467,22.661,20322,5274,15048,3.731,14.375,11713,8.285,28.75,359,361,3933
1986,3329,5655,6176,355694,356177,661,10.751,605,9.841,37891,10478,27413,2.942,10.638,39012,9536,29476,2.677,10.953,-1121,-0.315,21.277,449,449,5477
1986,3331,2884,3210,206113,216332,254,7.725,410,12.47,18450,6320,12130,2.921,8.529,38956,12374,26582,5.72,18.008,-20506,-9.479,17.057,256,259,5287
1986,3332,3720,3972,158519,163467,315,7.941,305,7.688,15655,4581,11074,2.802,9.577,25379,6645,18734,4.065,15.525,-9724,-5.949,19.154,207,207,2337
1986,3333,2079,2191,169092,171240,213,9.793,181,8.322,18371,4712,13659,2.752,10.728,22881,7566,15315,4.418,13.362,-4510,-2.634,21.456,119,119,1856
1986,3334,1699,1924,160190,161366,186,9.6,213,10.994,18235,5965,12270,3.697,11.3,20665,6948,13717,4.306,12.806,-2430,-1.506,22.601,155,155,3193
1986,3335,9615,10008,233848,238245,697,6.967,690,6.897,27510,7252,20258,3.044,11.547,36428,9676,26752,4.061,15.29,-8918,-3.743,23.094,523,523,4324
1986,3336,732,884,132763,137816,47,5.275,61,6.846,6226,1610,4616,1.168,4.518,16444,1711,14733,1.242,11.932,-10218,-7.414,9.035,36,36,371
1986,3339,5804,6357,312684,314785,483,7.594,489,7.689,33715,8091,25624,2.57,10.711,38037,10098,27939,3.208,12.084,-4322,-1.373,21.421,351,351,4285
1986,3341,1604,1769,311535,333247,238,13.285,283,15.797,28813,6172,22641,1.852,8.646,71070,19576,51494,5.874,21.327,-42257,-12.68,17.292,200,202,4332
1986,3342,1799,2015,273761,280656,171,8.356,234,11.434,33015,15434,17581,5.499,11.764,47008,14084,32924,5.018,16.749,-13993,-4.986,23.527,167,167,2451
1986,3343,367,391,41619,41817,42,10.701,45,11.465,3973,563,3410,1.346,9.501,4329,590,3739,1.411,10.352,-356,-0.851,19.002,32,32,349
1986,3344,4486,5115,503707,525234,612,11.981,598,11.707,46871,15497,31374,2.95,8.924,89986,14999,74987,2.856,17.133,-43115,-8.209,17.848,457,457,6452
1986,3345,4218,4806,662511,661549,438,9.172,377,7.894,65283,14070,51213,2.127,9.868,63329,18948,44381,2.864,9.573,1954,0.295,19.146,236,236,3247
1986,3346,623,647,22512,21286,90,13.857,95,14.627,5765,1230,4535,5.779,27.084,3280,1434,1846,6.737,15.41,2485,11.675,30.819,67,67,246
1986,3351,1196,1320,85446,85062,114,8.636,114,8.636,9376,1711,7665,2.011,11.023,8712,2288,6424,2.69,10.242,664,0.781,20.484,75,75,570
1986,3352,334,436,117543,117204,28,6.385,33,7.526,8915,1101,7814,0.939,7.606,8289,1934,6355,1.65,7.072,626,0.534,14.145,20,21,530
1986,3353,2027,2533,238135,242808,187,7.412,167,6.619,18200,3395,14805,1.398,7.496,27300,7020,20280,2.891,11.243,-9100,-3.748,14.991,92,92,2216
1986,3359,2053,2408,207506,208589,259,10.844,220,9.211,21084,6967,14117,3.34,10.108,23001,5386,17615,2.582,11.027,-1917,-0.919,20.216,144,144,1848
1986,3361,207,264,282855,282316,29,10.964,30,11.342,25598,5836,19762,2.067,9.067,23716,1643,22073,0.582,8.401,1882,0.667,16.801,24,24,1025
1986,3362,1776,1974,112223,113084,218,11.12,191,9.742,15430,5380,10050,4.758,13.645,17127,3837,13290,3.393,15.145,-1697,-1.501,27.29,142,143,1928
1986,3363,3727,4497,646032,651006,450,10.042,418,9.328,54317,18268,36049,2.806,8.344,63892,19440,44452,2.986,9.814,-9575,-1.471,16.687,312,312,7682
1986,3364,1256,1528,735234,711237,133,8.718,128,8.391,97856,36399,61457,5.118,13.759,50748,37037,13711,5.207,7.135,47108,6.623,14.27,85,85,1820
1986,3365,164,186,27364,29228,13,6.86,20,10.554,2008,381,1627,1.304,6.87,5601,1645,3956,5.628,19.163,-3593,-12.293,13.74,10,10,316
1986,3366,1135,1221,157385,158957,151,12.387,147,12.059,19714,3246,16468,2.042,12.402,23282,3942,19340,2.48,14.647,-3568,-2.245,24.804,101,101,1167
1986,3369,454,466,34464,36046,62,13.522,47,10.251,2318,455,1863,1.262,6.431,5578,2129,3449,5.906,15.475,-3260,-9.044,12.861,34,34,234
1986,3371,12674,13292,376623,377049,1983,15.074,1710,12.998,54017,17174,36843,4.555,14.326,55071,20529,34542,5.445,14.606,-1054,-0.28,28.653,1343,1347,12264
1986,3372,2647,2786,141876,141788,298,10.731,280,10.083,18268,4558,13710,3.215,12.884,18008,5166,12842,3.643,12.701,260,0.183,25.401,233,233,3749
1986,3379,1066,1205,41326,41462,100,8.244,116,9.563,4574,696,3878,1.679,11.032,4788,2277,2511,5.492,11.548,-214,-0.516,22.064,92,92,1084
1986,3391,10139,10631,233118,232213,1296,12.311,1088,10.335,31106,10511,20595,4.526,13.395,28991,10355,18636,4.459,12.485,2115,0.911,24.969,791,793,4286
1986,3399,14772,15328,392951,392959,1938,12.661,1895,12.38,60235,16701,43534,4.25,15.329,60434,21814,38620,5.551,15.379,-199,-0.051,30.657,1472,1480,12712
1986,4231,22208,27322,309631,311298,2890,10.543,3071,11.203,48842,16929,31913,5.438,15.69,52254,19994,32260,6.423,16.786,-3412,-1.096,31.38,2115,2183,11982
1986,4232,8040,9199,107326,106613,1225,13.417,1088,11.916,19673,6386,13287,5.99,18.453,18169,6555,11614,6.148,17.042,1504,1.411,34.084,820,825,4424
1986,4233,7742,9579,122581,120741,1223,12.877,1060,11.161,23542,8214,15328,6.803,19.498,19702,7444,12258,6.165,16.318,3840,3.18,32.635,758,765,4495
1986,4234,23874,32873,576404,566098,5074,15.801,3553,11.064,101828,39172,62656,6.92,17.988,81169,29993,51176,5.298,14.338,20659,3.649,28.677,2240,2337,14135
1986,4235,6663,8884,130378,131506,917,10.357,857,9.679,18295,6210,12085,4.722,13.912,20469,6950,13519,5.285,15.565,-2174,-1.653,27.824,475,480,3108
1986,4236,15408,22614,321974,320814,2818,12.633,2203,9.876,57879,21058,36821,6.564,18.041,55365,21715,33650,6.769,17.258,2514,0.784,34.515,1393,1422,10125
1986,4237,10889,14492,159682,158976,1412,9.831,1153,8.028,24599,8058,16541,5.069,15.473,23147,8304,14843,5.223,14.56,1452,0.913,29.12,820,834,5282
1986,4238,46683,60791,639313,642049,5869,9.666,5721,9.422,97178,30843,66335,4.804,15.136,102384,36551,65833,5.693,15.946,-5206,-0.811,30.271,3668,3745,19562
1986,4239,23629,25178,233459,230492,4096,16.503,3378,13.611,49568,17776,31792,7.712,21.505,43621,16601,27020,7.202,18.925,5947,2.58,37.85,2573,2595,11259
1986,4241,8235,10886,157522,156723,1116,10.362,885,8.217,22814,6424,16390,4.099,14.557,21384,6226,15158,3.973,13.644,1430,0.912,27.289,612,624,3902
1986,4242,2845,3622,98947,97087,559,15.709,432,12.14,17295,3643,13652,3.752,17.814,13428,5366,8062,5.527,13.831,3867,3.983,27.662,309,319,1851
1986,4243,11259,12162,138852,137277,1939,16.059,1763,14.602,32034,10195,21839,7.427,23.335,28635,11803,16832,8.598,20.859,3399,2.476,41.719,1376,1386,6872
1986,4244,27181,33299,632860,623252,3902,11.737,3796,11.418,109954,32426,77528,5.203,17.642,90942,34061,56881,5.465,14.592,19012,3.05,29.183,2779,2800,17817
1986,4245,7466,10351,89504,92420,670,6.335,1120,10.59,12507,3674,8833,3.975,13.533,18165,6904,11261,7.47,19.655,-5658,-6.122,27.066,700,728,4046
1986,4246,7210,10477,120456,119823,1141,10.95,1028,9.865,19741,5591,14150,4.666,16.475,18392,6832,11560,5.702,15.349,1349,1.126,30.699,570,574,3151
1986,4247,10759,14035,147454,148054,943,6.648,1244,8.77,24883,6425,18458,4.34,16.807,25770,8168,17602,5.517,17.406,-887,-0.599,33.613,779,812,4824
1986,4248,4292,5380,138442,138052,322,5.907,465,8.53,15827,3555,12272,2.575,11.465,15044,5069,9975,3.672,10.897,783,0.567,21.795,342,350,2893
1986,4249,20091,24100,262443,259338,3309,13.806,3044,12.701,50324,17909,32415,6.906,19.405,44137,16615,27522,6.407,17.019,6187,2.386,34.038,2153,2182,10469
1986,4251,30471,33176,313352,311199,3993,12.188,3167,9.666,56293,20638,35655,6.632,18.089,52101,17625,34476,5.664,16.742,4192,1.347,33.484,2172,2180,10638
1986,4411,37985,39255,940786,912439,4501,11.554,3906,10.026,149787,49759,100028,5.453,16.416,93510,33726,59784,3.696,10.248,56277,6.168,20.497,3147,3161,27564
1986,4412,11241,11757,84077,83085,1509,12.916,1362,11.657,17940,6860,11080,8.257,21.592,15881,6038,9843,7.267,19.114,2059,2.478,38.229,1103,1110,5065
1986,4413,48904,71191,492383,482339,8105,11.618,5245,7.519,98673,45110,53563,9.352,20.457,78506,25291,53215,5.243,16.276,20167,4.181,32.552,3503,3631,15268
1986,4421,21828,27320,226967,222785,3560,13.184,2923,10.825,45795,18547,27248,8.325,20.556,37308,13918,23390,6.247,16.746,8487,3.81,33.492,2161,2244,9654
1986,4422,21077,25842,151512,147340,4126,16.377,2831,11.237,37749,17553,20196,11.913,25.62,29666,10820,18846,7.344,20.134,8083,5.486,40.269,2031,2096,7517
1986,4431,23252,31269,216259,213047,4820,15.335,5145,16.369,53696,24885,28811,11.681,25.204,47745,22553,25192,10.586,22.411,5951,2.793,44.821,3546,3729,14956
1986,4441,56104,71816,739479,726135,6719,9.409,5903,8.267,129840,49897,79943,6.872,17.881,103758,35008,68750,4.821,14.289,26082,3.592,28.578,4234,4337,20788
1986,4442,15101,18274,131498,130035,2175,12.026,1799,9.947,25947,10361,15586,7.968,19.954,22875,7778,15097,5.981,17.591,3072,2.362,35.183,1218,1231,4915
1986,4451,64481,107407,2137649,2087768,11965,11.127,12205,11.351,371745,159980,211765,7.663,17.806,272828,107073,165755,5.129,13.068,98917,4.738,26.136,8003,8278,49508
1986,4452,22637,27684,178179,179552,4327,15.617,4372,15.78,41913,20078,21835,11.182,23.343,44501,19257,25244,10.725,24.785,-2588,-1.441,46.686,3288,3365,14134
1986,4453,27976,33234,165166,168244,3708,11.086,4136,12.365,32400,13471,18929,8.007,19.258,38596,14722,23874,8.75,22.94,-6196,-3.683,38.515,3175,3246,11322
1986,4461,45538,68430,637064,629957,7848,11.669,5499,8.176,112183,53033,59150,8.419,17.808,97566,33642,63924,5.34,15.488,14617,2.32,30.975,3846,3928,22214
1986,4471,90278,124780,835208,826361,16132,12.942,15870,12.732,193014,90010,103004,10.892,23.357,175621,76852,98769,9.3,21.252,17393,2.105,42.505,10850,11148,48768
1986,4481,55368,98447,889910,863298,13616,14.007,11136,11.456,204214,86102,118112,9.974,23.655,149525,56828,92697,6.583,17.32,54689,6.335,34.64,7187,7733,30410
1986,4482,11784,36621,198228,197705,4285,11.718,4180,11.431,43383,20577,22806,10.408,21.943,42615,16641,25974,8.417,21.555,768,0.388,43.11,1670,1889,7635
1986,4483,18786,27461,156662,154000,4134,15.491,2586,9.69,34480,17940,16540,11.649,22.39,29507,10253,19254,6.658,19.16,4973,3.229,38.321,1732,1802,7008
1986,4511,31956,41219,280738,273607,6283,15.405,5415,13.277,65623,29152,36471,10.655,23.984,51677,20581,31096,7.522,18.887,13946,5.097,37.775,3904,4023,12813
1986,4512,8051,12216,81773,80414,1740,14.513,1287,10.734,18115,7717,10398,9.597,22.527,15366,5303,10063,6.595,19.109,2749,3.419,38.217,884,907,2931
1986,4522,401,6795,1134935,1136329,305,4.501,269,3.969,113381,42460,70921,3.737,9.978,115445,20828,94617,1.833,10.159,-2064,-0.182,19.956,28,30,653
1986,4523,12376,27410,833678,818707,2947,10.795,2727,9.989,129499,63579,65920,7.766,15.818,101070,30621,70449,3.74,12.345,28429,3.472,24.69,1655,1700,8641
1986,4531,22893,24326,125858,122779,3585,14.929,2960,12.326,28799,11061,17738,9.009,23.456,22491,9445,13046,7.693,18.318,6308,5.138,36.637,2240,2280,7201
1986,4532,28053,34545,226878,221631,6283,18.677,4475,13.302,53057,25443,27614,11.48,23.939,42491,17424,25067,7.862,19.172,10566,4.767,38.344,3242,3360,12010
1986,4533,9414,11373,56351,55857,1767,15.641,1616,14.304,13215,6002,7213,10.745,23.659,12102,4510,7592,8.074,21.666,1113,1.993,43.332,1270,1278,3522
1986,4539,26613,32068,157922,156127,4888,15.251,4852,15.139,39936,17845,22091,11.43,25.579,36475,16746,19729,10.726,23.362,3461,2.217,46.725,3461,3599,12021
1986,4541,5354,6592,92098,94910,806,11.465,1682,23.926,16573,5370,11203,5.658,17.462,22931,11433,11498,12.046,24.161,-6358,-6.699,34.924,1129,1133,3783
1986,4542,3987,5017,73218,75848,578,11.418,668,13.196,11789,3589,8200,4.732,15.543,17380,6975,10405,9.196,22.914,-5591,-7.371,31.086,408,409,2123
1986,4543,16062,21744,205120,204576,2167,9.963,2181,10.027,36866,11514,25352,5.628,18.021,35688,13195,22493,6.45,17.445,1178,0.576,34.89,1563,1578,7127
1986,4811,1042,3011,338883,329593,388,13.17,258,8.758,51459,8783,42676,2.665,15.613,33504,11434,22070,3.469,10.165,17955,5.448,20.331,132,133,4226
1986,4812,486,817,15333,14603,150,18.727,118,14.732,4056,1860,2196,12.738,27.776,2602,1686,916,11.546,17.819,1454,9.957,35.638,79,79,1312
1986,4831,363,641,31092,31744,83,13.217,57,9.076,4804,2114,2690,6.66,15.134,6100,779,5321,2.454,19.216,-1296,-4.083,30.267,36,36,281
1986,4832,372,432,13287,14088,37,8.477,46,10.538,2155,1219,936,8.653,15.297,3781,1048,2733,7.439,26.839,-1626,-11.542,30.594,30,30,472
1986,4841,20749,26318,531204,525440,4593,17.431,4655,17.667,97122,32742,64380,6.231,18.484,85189,30634,54555,5.83,16.213,11933,2.271,32.426,3569,3623,19678
1986,4842,45360,49451,597530,596786,8517,17.477,7081,14.53,116520,42027,74493,7.042,19.525,115510,37343,78167,6.257,19.355,1010,0.169,38.711,5325,5380,26536
1986,4851,389,409,32473,31689,47,11.52,45,11.029,3104,1163,1941,3.67,9.795,1568,728,840,2.297,4.948,1536,4.847,9.896,36,36,634
1986,4852,349,637,21826,22819,33,5.073,60,9.224,2579,280,2299,1.227,11.302,4481,1541,2940,6.753,19.637,-1902,-8.335,22.604,31,31,199
1986,4853,5048,5106,56089,56471,930,18.093,998,19.416,11455,4436,7019,7.855,20.285,12193,5488,6705,9.718,21.592,-738,-1.307,40.569,836,837,4943
1986,4854,3340,3576,98540,97227,350,9.815,330,9.254,16611,5144,11467,5.291,17.085,14058,4400,9658,4.526,14.459,2553,2.626,28.918,259,259,3258
1986,4855,628,680,14326,13878,129,19.355,102,15.304,3774,1716,2058,12.365,27.194,2793,1461,1332,10.527,20.125,981,7.069,40.251,68,68,555
1986,4859,961,996,20975,20387,195,19.52,201,20.12,4649,1877,2772,9.207,22.804,3425,1742,1683,8.545,16.8,1224,6.004,33.6,161,162,1482
1986,4861,69,292,10113,10413,15,5.059,24,8.094,985,107,878,1.028,9.459,1586,773,813,7.423,15.231,-601,-5.772,18.919,3,3,21
1986,4862,252,1353,57337,58444,60,4.409,76,5.584,2850,1024,1826,1.752,4.876,5104,1022,4082,1.749,8.733,-2254,-3.857,9.753,28,28,202
1986,4869,65,347,9024,8313,26,7.514,24,6.936,2448,788,1660,9.479,29.448,998,301,697,3.621,12.005,1450,17.443,24.011,11,11,75
1986,4871,212,215,3599,3445,45,20.737,49,22.581,917,401,516,11.642,26.622,622,362,260,10.51,18.058,295,8.564,36.116,38,38,259
1986,4872,713,723,9068,8989,148,20.889,119,16.796,1929,566,1363,6.297,21.46,1731,693,1038,7.709,19.257,198,2.203,38.514,91,91,463
1986,4879,48,68,1753,1824,7,9.333,21,28,219,20,199,1.096,12.007,333,333,0,18.257,18.257,-114,-6.25,24.013,15,15,48
1986,4881,2075,2691,68528,66669,373,13.858,374,13.896,12166,4164,8002,6.246,18.248,8267,3229,5038,4.843,12.4,3899,5.848,24.8,258,258,1362
1986,4882,358,476,11227,11006,103,22.44,69,15.033,2351,1006,1345,9.14,21.361,1824,649,1175,5.897,16.573,527,4.788,33.146,41,43,487
1986,4883,2052,2452,88493,92664,311,12.535,369,14.873,16414,4456,11958,4.809,17.713,24375,6589,17786,7.111,26.305,-7961,-8.591,35.427,246,248,3525
1986,4884,1264,1750,30189,30736,225,11.943,493,26.168,5217,1063,4154,3.459,16.974,6188,2319,3869,7.545,20.133,-971,-3.159,33.948,363,368,1484
1986,4885,5922,7968,100482,96808,1465,18.884,1045,13.47,24388,9793,14595,10.116,25.192,16805,6017,10788,6.215,17.359,7583,7.833,34.718,713,763,4617
1986,4889,427,432,5145,4751,109,26.585,65,15.854,1604,668,936,14.062,33.765,795,410,385,8.631,16.735,809,17.03,33.47,55,55,299
1986,4921,1402,2431,101043,95955,516,22,345,14.709,22833,8297,14536,8.647,23.796,12798,5632,7166,5.869,13.338,10035,10.458,26.675,231,231,2079
1986,4922,1917,2000,17176,14211,750,41.958,325,18.182,8103,5352,2751,37.661,57.019,2236,1041,1195,7.325,15.734,5867,41.285,31.469,271,271,842
1986,4931,6370,9898,398480,397648,994,10.126,831,8.465,63298,19306,43992,4.855,15.918,61995,16075,45920,4.043,15.59,1303,0.328,31.181,327,331,3055
1986,5111,13951,16040,671440,660569,1965,12.342,1727,10.847,79618,23652,55966,3.581,12.053,58015,19827,38188,3.002,8.783,21603,3.27,17.565,1354,1359,12482
1986,5112,6368,7405,159392,159440,923,11.964,1542,19.988,33512,8524,24988,5.346,21.019,33789,16321,17468,10.236,21.192,-277,-0.174,42.037,1027,1039,6290
1986,5121,9486,14406,233294,225215,2316,16.057,2351,16.3,62331,19730,42601,8.761,27.676,46890,16837,30053,7.476,20.82,15441,6.856,41.64,1318,1380,7449
1986,5122,2087,2096,14308,13759,516,25.214,417,20.376,4525,1841,2684,13.381,32.889,3423,1668,1755,12.123,24.879,1102,8.01,49.758,340,340,1320
1986,5151,6368,7534,236869,234360,1013,13.553,894,11.961,43014,19212,23802,8.198,18.354,38832,14554,24278,6.21,16.569,4182,1.784,33.139,679,690,9835
1986,5152,12,13,65,60,5,43.478,(D),(D),23,19,4,31.667,38.333,11,(D),9,(D),18.333,12,20,36.667,(D),(D),(D)
1986,5173,3203,17038,898346,908601,1815,10.849,1198,7.161,119562,33330,86232,3.668,13.159,141357,19288,122069,2.123,15.558,-21795,-2.399,26.318,436,438,4685
1986,5174,744,1476,70746,68159,225,15.647,149,10.362,16147,5659,10488,8.303,23.69,11252,5409,5843,7.936,16.509,4895,7.182,33.017,69,69,1165
1986,5179,1343,2819,66682,65232,504,18.274,382,13.851,14674,6324,8350,9.695,22.495,12119,3786,8333,5.804,18.578,2555,3.917,37.157,221,221,1392
1986,5182,5970,7842,255025,254923,1213,15.453,1228,15.644,52667,19281,33386,7.563,20.66,52394,24272,28122,9.521,20.553,273,0.107,41.106,611,617,4401
1986,5191,2391,2855,37097,35522,346,12.235,292,10.325,9623,4831,4792,13.6,27.09,6038,1966,4072,5.535,16.998,3585,10.092,33.996,209,209,1575
1986,5211,46,83,25760,25328,7,8.537,5,6.098,1479,298,1181,1.177,5.84,595,202,393,0.798,2.349,884,3.49,4.698,(D),(D),(D)
1986,5221,19768,72984,2014267,1983924,5206,7.248,2886,4.018,292661,92348,200313,4.655,14.752,231890,51109,180781,2.576,11.688,60771,3.063,23.377,939,988,16792
1986,5222,21591,39952,456325,433278,4102,10.299,3860,9.691,112180,37937,74243,8.756,25.891,66115,32133,33982,7.416,15.259,46065,10.632,30.519,1935,2078,15378
1986,5223,4123,4679,56350,53210,1194,26.492,850,18.86,17908,7243,10665,13.612,33.656,11774,5852,5922,10.998,22.128,6134,11.528,44.255,649,649,3802
1986,5231,6337,12855,329385,310243,1809,14.267,1459,11.506,72853,15766,57087,5.082,23.483,35828,13844,21984,4.462,11.548,37025,11.934,23.097,889,892,6031
1986,5232,113,126,6711,6689,13,10,21,16.154,524,206,318,3.08,7.834,451,157,294,2.347,6.742,73,1.091,13.485,12,12,56
1986,5239,14823,15326,237145,236827,3281,21.927,2555,17.075,58075,20750,37325,8.762,24.522,58112,27245,30867,11.504,24.538,-37,-0.016,49.044,1949,1953,21793
1986,5241,6602,30815,1354333,1323891,2128,6.892,2251,7.29,173963,32481,141482,2.453,13.14,111755,35766,75989,2.702,8.441,62208,4.699,16.883,485,490,5959
1986,5242,99076,103989,803786,777949,13617,13.264,10961,10.677,185447,70266,115181,9.032,23.838,132950,52131,80819,6.701,17.09,52497,6.748,34.18,8072,8082,34816
1986,5259,753,957,10201,9913,117,12.48,78,8.32,2310,642,1668,6.477,23.304,1660,494,1166,4.984,16.747,650,6.557,33.493,39,39,256
1986,5311,95630,98897,528296,522227,14699,14.885,14411,14.593,126180,56942,69238,10.904,24.162,113131,54811,58320,10.496,21.663,13049,2.499,43.326,11539,11573,40412
1986,5312,37381,39254,228225,223719,7203,18.74,5566,14.481,60542,25626,34916,11.455,27.062,51425,19728,31697,8.818,22.986,9117,4.075,45.973,4253,4260,14705
1986,5313,23496,24548,267545,255980,4707,19.595,3654,15.211,70139,23872,46267,9.326,27.4,46719,19125,27594,7.471,18.251,23420,9.149,36.502,2836,2848,13166
1986,5321,5846,9572,141170,132074,1477,15.624,1240,13.117,39770,10634,29136,8.052,30.112,21279,9483,11796,7.18,16.111,18491,14,32.223,764,809,5519
1986,5322,17497,21113,160514,149438,6741,35.43,2567,13.492,54597,30115,24482,20.152,36.535,32419,15326,17093,10.256,21.694,22178,14.841,43.388,1737,1768,9657
1986,5323,3574,4496,33101,31782,959,22.504,490,11.498,9216,4374,4842,13.763,28.998,6560,2434,4126,7.659,20.641,2656,8.357,41.282,332,333,1636
1986,5324,6907,8391,97836,96091,1751,22.068,838,10.561,23073,9653,13420,10.046,24.012,19717,8532,11185,8.879,20.519,3356,3.493,41.038,568,571,5628
1986,5331,871,911,10933,10730,151,16.494,160,17.477,3327,1440,1887,13.42,31.007,2865,1519,1347,14.152,26.701,462,4.306,53.402,125,126,977
1986,5411,126727,130790,798672,769114,15856,12.283,12446,9.642,159507,52742,106765,6.858,20.739,99389,39115,60274,5.086,12.923,60118,7.817,25.845,9222,9267,30558
1986,5412,59637,62739,489132,470101,10382,16.984,7161,11.715,104185,42150,62035,8.966,22.162,66116,26445,39671,5.625,14.064,38069,8.098,28.128,5237,5298,20228
1986,5413,55705,61122,804176,786755,10174,17.083,7043,11.826,170269,56275,113994,7.153,21.642,136102,37235,98867,4.733,17.299,34167,4.343,34.598,5062,5094,23149
1986,5414,13817,14042,98284,96083,2683,19.57,2018,14.72,24114,10638,13476,11.072,25.097,19944,7921,12023,8.244,20.757,4170,4.34,41.514,1611,1612,6247
1986,5415,12615,13931,140100,125649,5111,40.696,2367,18.847,53511,30308,23203,24.121,42.588,24327,10563,13764,8.407,19.361,29184,23.227,38.722,1826,1830,7208
1986,5416,37845,39146,317699,306396,9694,25.603,7127,18.823,107361,48365,58996,15.785,35.04,84063,40403,43660,13.187,27.436,23298,7.604,54.872,5511,5523,29184
1986,5417,6449,7833,443037,435133,1275,16.695,883,11.562,57947,12421,45526,2.855,13.317,41629,12692,28937,2.917,9.567,16318,3.75,19.134,591,595,4788
1986,5418,25482,27792,352382,347696,4914,18.104,3615,13.319,73107,27107,46000,7.796,21.026,63330,27183,36147,7.818,18.214,9777,2.812,36.428,2775,2784,18792
1986,5419,29766,33202,229354,222720,4424,13.57,3223,9.886,52306,19065,33241,8.56,23.485,39289,14704,24585,6.602,17.641,13017,5.845,35.281,2433,2445,10037
1986,5511,24448,44734,3077117,3045080,5009,11.323,4018,9.083,542370,172998,369372,5.681,17.811,476767,114112,362655,3.747,15.657,65603,2.154,31.314,908,963,10344
1986,5611,10765,11373,187738,175407,2474,22.618,1604,14.664,55629,22762,32867,12.977,31.714,31013,10978,20035,6.259,17.681,24616,14.034,35.361,1209,1214,8162
1986,5612,226,283,25313,22707,97,37.817,44,17.154,7864,4471,3393,19.69,34.633,2610,794,1816,3.497,11.495,5254,23.139,22.989,31,31,298
1986,5613,14184,18931,1031779,979664,3978,22.012,2260,12.506,306186,96523,209663,9.853,31.254,202788,46064,156724,4.702,20.7,103398,10.554,41.4,1572,1595,23495
1986,5614,19474,22064,246484,236298,3852,17.894,2778,12.905,58923,22161,36762,9.378,24.936,38825,15860,22965,6.712,16.431,20098,8.505,32.861,2089,2101,9682
1986,5615,22413,26189,203642,199365,4127,16.184,2751,10.788,44924,17282,27642,8.669,22.534,36040,13645,22395,6.844,18.077,8884,4.456,36.155,2010,2046,9491
1986,5616,11452,14038,455949,441697,2420,17.621,1811,13.187,99360,30426,68934,6.888,22.495,71173,26482,44691,5.996,16.114,28187,6.382,32.227,1364,1370,18009
1986,5617,68779,72024,909823,879047,16833,24.226,11753,16.915,243448,85408,158040,9.716,27.695,181147,65496,115651,7.451,20.607,62301,7.087,41.214,9140,9154,47565
1986,5619,12712,13689,192201,186424,2441,18.276,1775,13.29,46807,14702,32105,7.886,25.108,34956,10330,24626,5.541,18.751,11851,6.357,37.502,1332,1333,7240
1986,5621,3445,3562,88230,87740,328,8.789,668,17.899,13767,2328,11439,2.653,15.691,12791,5774,7017,6.581,14.578,976,1.112,29.157,557,560,4220
1986,5622,1993,2575,55868,53951,272,10.58,264,10.268,9996,2610,7386,4.838,18.528,6159,2424,3735,4.493,11.416,3837,7.112,22.832,181,182,1308
1986,5629,4626,4882,46430,45095,739,15.278,649,13.417,11540,3528,8012,7.824,25.591,9001,3962,5039,8.786,19.96,2539,5.63,39.921,486,486,2541
1986,6111,13077,13555,392946,386644,662,4.887,642,4.74,41430,7168,34262,1.854,10.715,29162,6644,22518,1.718,7.542,12268,3.173,15.085,494,496,4869
1986,6112,434,565,38810,38128,61,11.121,28,5.105,5430,1247,4183,3.271,14.242,3895,781,3114,2.048,10.216,1535,4.026,20.431,16,17,696
1986,6113,2008,2314,941674,937785,80,3.427,121,5.183,78982,2396,76586,0.255,8.422,71391,5669,65722,0.605,7.613,7591,0.809,15.225,46,46,1887
1986,6114,2139,2513,43124,40458,547,22.608,360,14.879,11508,4147,7361,10.25,28.445,6222,2857,3365,7.062,15.379,5286,13.066,30.758,283,287,2194
1986,6115,3315,3907,49697,47535,666,17.598,421,11.124,12426,4178,8248,8.789,26.141,8147,2940,5207,6.185,17.139,4279,9.002,34.278,285,292,1983
1986,6116,11056,11585,103044,100425,2260,19.795,1924,16.852,25072,9987,15085,9.945,24.966,19878,8145,11733,8.111,19.794,5194,5.172,39.588,1544,1565,6498
1986,6117,1518,1546,15093,14738,319,21.302,222,14.825,3587,1462,2125,9.92,24.338,2927,961,1966,6.521,19.86,660,4.478,39.72,180,181,693
1986,6211,183011,190303,1182018,1151810,16069,8.511,13085,6.93,225945,76729,149216,6.662,19.617,165605,53875,111730,4.677,14.378,60340,5.239,28.756,10412,10470,40976
1986,6212,96765,99205,478966,470440,6627,6.731,5139,5.219,79580,23524,56056,5,16.916,62055,18020,44035,3.83,13.191,17525,3.725,26.382,4003,4044,14581
1986,6213,46601,48621,172673,166835,7144,15.116,4427,9.367,43909,19628,24281,11.765,26.319,32115,14871,17244,8.914,19.25,11794,7.069,38.499,3280,3319,10724
1986,6214,6343,8501,145746,139733,1613,19.98,757,9.377,35883,15946,19937,11.412,25.68,24061,7677,16384,5.494,17.219,11822,8.46,34.439,468,481,4231
1986,6215,4629,5860,79323,74012,1153,20.648,601,10.763,20728,8013,12715,10.827,28.006,10135,5270,4865,7.12,13.694,10593,14.313,27.387,425,441,2970
1986,6216,4764,6318,264720,245794,1287,21.331,718,11.9,79000,26454,52546,10.763,32.141,40398,8448,31950,3.437,16.436,38602,15.705,32.871,470,476,4286
1986,6219,4646,5327,97116,92702,1076,21.15,597,11.735,25509,10148,15361,10.947,27.517,16702,6779,9923,7.313,18.017,8807,9.5,36.034,416,419,4616
1986,6221,3975,5226,3170822,3151308,231,4.433,202,3.876,286051,159793,126258,5.071,9.077,243921,44933,198988,1.426,7.74,42130,1.337,15.481,127,128,38543
1986,6222,379,580,345954,358457,74,13.144,40,7.105,25672,9120,16552,2.544,7.162,48507,3070,45437,0.856,13.532,-22835,-6.37,14.324,27,27,2477
1986,6223,185,225,55421,51737,27,12.245,18,8.163,9731,6722,3009,12.993,18.809,2383,846,1537,1.635,4.606,7348,14.203,9.212,8,8,621
1986,6231,8325,12896,1085487,1055095,1192,9.376,827,6.505,168324,78128,90196,7.405,15.953,106569,42729,63840,4.05,10.1,61755,5.853,20.201,555,578,30499
1986,6232,4652,6627,153832,145776,1089,17.249,462,7.318,33885,14157,19728,9.712,23.245,17809,5802,12007,3.98,12.217,16076,11.028,24.433,315,320,4254
1986,6233,7811,9020,240874,236553,1494,17.029,1001,11.409,41304,17850,23454,7.546,17.461,32729,16673,16056,7.048,13.836,8575,3.625,27.672,683,704,12173
1986,6239,2965,3651,87783,84675,466,13.166,243,6.865,15517,5834,9683,6.89,18.325,9164,2855,6309,3.372,10.823,6353,7.503,21.645,156,163,2005
1986,6241,15012,20357,294636,286638,2488,12.556,1403,7.081,53172,15470,37702,5.397,18.55,36874,10064,26810,3.511,12.864,16298,5.686,25.729,839,846,5340
1986,6242,4268,5056,45344,44268,589,11.934,348,7.051,8557,2890,5667,6.528,19.33,6394,2228,4166,5.033,14.444,2163,4.886,28.888,218,218,1540
1986,6243,4143,6039,254010,249796,783,13.427,368,6.311,42638,9936,32702,3.978,17.069,34466,4817,29649,1.928,13.798,8172,3.271,27.595,185,204,2136
1986,6244,31496,37281,343351,333554,5456,14.93,3983,10.899,74833,31541,43292,9.456,22.435,55491,21241,34250,6.368,16.636,19342,5.799,33.273,2990,3036,14762
1986,7111,4943,4993,69991,69353,828,16.689,765,15.419,17928,5029,12899,7.251,25.851,16572,4150,12422,5.984,23.895,1356,1.955,47.791,565,565,3041
1986,7112,2209,2313,66870,66997,434,19.048,365,16.019,14848,3572,11276,5.332,22.162,15078,3129,11949,4.67,22.505,-230,-0.343,44.324,285,287,1755
1986,7113,2201,2242,35317,34192,395,17.741,364,16.349,9370,2168,7202,6.341,27.404,7013,2681,4332,7.841,20.511,2357,6.894,41.022,264,264,1530
1986,7114,1052,1069,10976,10685,216,20.591,176,16.778,3548,1526,2022,14.282,33.207,2947,1090,1857,10.202,27.582,601,5.625,55.164,135,135,955
1986,7115,10061,10094,52618,50122,2967,30.175,2444,24.856,23039,10326,12713,20.602,45.966,18399,9278,9121,18.511,36.709,4640,9.258,73.418,1859,1859,6971
1986,7121,2309,2464,41459,40196,242,9.988,160,6.603,5355,1189,4166,2.958,13.322,2803,458,2345,1.139,6.973,2552,6.349,13.947,109,109,301
1986,7131,1633,2187,59835,57500,430,19.94,369,17.111,10969,3766,7203,6.55,19.077,6230,2846,3384,4.95,10.835,4739,8.242,21.67,266,268,1561
1986,7132,703,728,20842,20818,142,19.93,111,15.579,3170,1443,1727,6.932,15.227,3120,1220,1900,5.86,14.987,50,0.24,29.974,88,88,779
1986,7139,33526,35997,525800,513856,5396,15.261,4117,11.644,110049,46186,63863,8.988,21.416,86223,31225,54998,6.077,16.78,23826,4.637,33.559,3057,3089,22673
1986,7211,29342,34238,1278078,1241152,5023,14.796,4443,13.088,273972,138087,135885,11.126,22.074,199094,85531,113563,6.891,16.041,74878,6.033,32.082,3206,3255,55173
1986,7212,3698,3975,24947,24680,510,12.9,467,11.812,6349,2080,4269,8.428,25.726,5804,2006,3798,8.128,23.517,545,2.208,47.035,330,331,1256
1986,7213,4307,4419,24801,24554,294,6.541,446,9.922,4450,1051,3399,4.28,18.124,4013,1783,2230,7.262,16.344,437,1.78,32.688,315,317,1413
1986,7223,17022,27272,525586,504599,5791,21.804,4366,16.439,157941,102043,55898,20.223,31.3,118657,51786,66871,10.263,23.515,39284,7.785,47.03,2493,2524,21865
1986,7224,53473,54231,318005,319084,8499,15.476,9874,17.979,88481,48957,39524,15.343,27.73,90383,44709,45674,14.012,28.326,-1902,-0.596,55.459,7939,7958,36984
1986,7225,199218,262383,4901526,4771409,47134,18.251,38871,15.052,1217017,698560,518457,14.641,25.506,954779,423153,531626,8.869,20.01,262238,5.496,40.021,28691,29431,286767
1986,8111,105477,110824,560504,547678,18895,17.358,14960,13.743,137966,69506,68460,12.691,25.191,112383,50205,62178,9.167,20.52,25583,4.671,41.04,11568,11647,40063
1986,8112,10186,11674,89664,84925,1906,16.679,1413,12.365,23642,11785,11857,13.877,27.839,14196,4828,9368,5.685,16.716,9446,11.123,33.432,1071,1072,3201
1986,8113,19205,20153,150006,148456,2976,15.008,2328,11.74,30895,11615,19280,7.824,20.811,27893,9948,17945,6.701,18.789,3002,2.022,37.578,1732,1738,7011
1986,8114,24197,25639,156369,154433,4274,16.824,3804,14.974,33205,12737,20468,8.248,21.501,29167,11321,17846,7.331,18.887,4038,2.615,37.773,2879,2881,8602
1986,8121,79995,89006,481771,476306,13540,15.196,13733,15.413,109504,56013,53491,11.76,22.99,98444,48395,50049,10.16,20.668,11060,2.322,41.336,10524,10714,37107
1986,8122,17223,20039,120130,118355,1576,7.879,1503,7.514,19192,5931,13261,5.011,16.216,15602,5491,10111,4.639,13.182,3590,3.033,26.365,1035,1057,3967
1986,8123,32661,38713,352234,348554,5384,14.018,4776,12.435,64665,28185,36480,8.086,18.552,57127,23841,33286,6.84,16.39,7538,2.163,32.779,3529,3665,16336
1986,8129,13904,21443,221781,217571,4242,20.134,3494,16.584,50037,20119,29918,9.247,22.998,42092,19346,22746,8.892,19.346,7945,3.652,38.693,2182,2278,11444
1986,8131,124228,124331,979091,961381,8110,6.626,4244,3.467,127953,23966,103987,2.493,13.309,92342,12276,80066,1.277,9.605,35611,3.704,19.21,2155,2155,6108
1986,8132,7920,9007,124954,122557,1039,11.785,657,7.452,20089,6590,13499,5.377,16.392,15187,4055,11132,3.309,12.392,4902,4,24.784,418,430,2368
1986,8133,7440,8526,97632,94801,997,11.944,639,7.655,17971,4500,13471,4.747,18.957,12301,3977,8324,4.195,12.976,5670,5.981,25.951,399,412,2487
1986,8134,28452,29887,265508,261344,2302,7.754,1901,6.404,39316,9381,29935,3.59,15.044,31113,6699,24414,2.563,11.905,8203,3.139,23.81,1274,1274,4617
1986,8139,55555,57808,465380,459168,5053,8.807,4191,7.304,83076,24231,58845,5.277,18.093,70578,18058,52520,3.933,15.371,12498,2.722,30.742,2881,2886,11989
1987,1131,219,230,3259,3296,43,18.777,41,17.904,620,194,426,5.887,18.814,695,262,433,7.95,21.089,-75,-2.276,37.627,33,33,242
1987,1132,89,104,1567,1481,21,21.212,11,11.111,440,121,319,8.173,29.72,266,36,230,2.432,17.967,174,11.753,35.934,8,8,32
1987,1133,10536,10616,85636,85405,1658,15.717,1524,14.447,22063,7614,14449,8.915,25.834,21339,7454,13885,8.728,24.986,724,0.848,49.972,1130,1130,5174
1987,1141,1093,1098,7486,7161,199,17.993,215,19.439,2894,978,1916,13.657,40.413,2223,1061,1162,14.816,31.043,671,9.37,62.086,160,160,799
1987,1142,124,124,829,801,31,26.05,21,17.647,165,105,60,13.109,20.599,112,54,58,6.742,13.983,53,6.617,27.965,15,15,32
1987,1151,3709,4104,48931,49867,621,15.169,601,14.68,14513,5212,9301,10.452,29.103,16372,8143,8229,16.329,32.831,-1859,-3.728,58.207,410,411,4050
1987,1152,1910,1927,13896,13175,374,20.091,243,13.054,3808,2000,1808,15.181,28.904,2309,685,1624,5.199,17.526,1499,11.378,35.053,181,181,514
1987,1153,765,774,9884,9723,168,22.047,144,18.898,2884,1171,1713,12.044,29.663,2518,1017,1501,10.46,25.899,366,3.764,51.797,105,105,742
1987,2111,7294,8938,130551,142274,913,9.714,1835,19.523,19643,7450,12193,5.236,13.807,43090,15338,27752,10.781,30.287,-23447,-16.48,27.613,1199,1211,5455
1987,2121,2315,2896,147723,158307,501,16.866,650,21.882,23537,12509,11028,7.902,14.868,44387,20421,23966,12.9,28.039,-20850,-13.171,29.736,427,429,6683
1987,2122,482,614,35541,35713,140,22.951,132,21.639,8009,2702,5307,7.566,22.426,8544,2528,6016,7.079,23.924,-535,-1.498,44.853,63,64,249
1987,2123,3528,5009,102450,103052,470,9.335,522,10.367,16094,4534,11560,4.4,15.617,17285,5785,11500,5.614,16.773,-1191,-1.156,31.235,271,276,2322
1987,2131,8324,9768,160056,190625,1254,11.813,2949,27.78,30336,14211,16125,7.455,15.914,91272,31207,60065,16.371,47.881,-60936,-31.967,31.828,2058,2068,16609
1987,2211,1655,5958,603136,602534,208,3.511,142,2.397,32917,9722,23195,1.614,5.463,31930,3317,28613,0.551,5.299,987,0.164,10.599,62,62,552
1987,2212,574,2423,140169,139797,133,5.486,136,5.609,8719,2403,6316,1.719,6.237,8089,3158,4931,2.259,5.786,630,0.451,11.572,47,49,365
1987,2213,3716,3994,31087,30623,327,8.225,290,7.295,4060,1709,2351,5.581,13.258,3140,1264,1876,4.128,10.254,920,3.004,20.508,202,202,659
1987,2361,104494,104871,617591,595949,23955,23.58,17390,17.118,220297,91880,128417,15.417,36.966,176650,75651,100999,12.694,29.642,43647,7.324,59.284,12637,12641,56214
1987,2362,38321,39045,696025,695060,5928,15.333,5162,13.352,188269,48079,140190,6.917,27.087,187087,57148,129939,8.222,26.917,1182,0.17,53.833,3797,3798,32921
1987,2371,13511,13791,306060,301921,1528,11.061,1575,11.401,74164,13328,60836,4.414,24.564,65779,23644,42135,7.831,21.787,8385,2.777,43.574,1142,1143,11911
1987,2372,9731,9889,75391,75233,2842,29.54,2306,23.968,28969,15865,13104,21.088,38.506,28479,15964,12515,21.22,37.855,490,0.651,75.709,1851,1854,12211
1987,2373,9641,10002,252423,252463,1237,12.437,1126,11.321,61872,10875,50997,4.308,24.507,62749,15036,47713,5.956,24.855,-877,-0.347,49.015,848,848,7837
1987,2379,5190,5263,86802,86366,946,18.282,769,14.861,24704,7851,16853,9.09,28.604,24363,9869,14494,11.427,28.209,341,0.395,56.418,581,581,3747
1987,2381,75367,75818,727273,714570,13401,18.147,9460,12.81,216075,68054,148021,9.524,30.238,190962,57419,133543,8.035,26.724,25113,3.514,53.448,7120,7124,44297
1987,2382,113824,115792,1204415,1182427,17119,15.076,12634,11.126,285862,84552,201310,7.151,24.176,241522,71740,169782,6.067,20.426,44340,3.75,40.852,9663,9671,52928
1987,2383,77694,78112,659308,638519,16676,22.101,11359,15.054,208803,70896,137907,11.103,32.701,167123,54203,112920,8.489,26.174,41680,6.528,52.347,8499,8499,40848
1987,2389,39478,39705,340838,336146,6982,17.993,5182,13.354,98552,30487,68065,9.07,29.318,89182,28554,60628,8.495,26.531,9370,2.787,53.062,3783,3783,20238
1987,3111,1218,1822,48309,48440,107,5.841,127,6.932,5786,1919,3867,3.962,11.945,6070,1843,4227,3.805,12.531,-284,-0.586,23.889,75,78,660
1987,3112,474,818,64843,65551,46,5.61,50,6.098,4269,846,3423,1.291,6.512,5672,902,4770,1.376,8.653,-1403,-2.14,13.025,27,27,420
1987,3113,1550,1844,83152,82618,255,13.9,236,12.865,12034,2571,9463,3.112,14.566,10846,2512,8334,3.041,13.128,1188,1.438,26.256,139,140,1033
1987,3114,1136,1577,169000,167553,117,7.391,129,8.149,22030,4022,18008,2.4,13.148,18949,3752,15197,2.239,11.309,3081,1.839,22.619,90,92,1348
1987,3115,1559,2217,133790,133369,116,5.14,196,8.684,15190,3284,11906,2.462,11.389,14277,5840,8437,4.379,10.705,913,0.685,21.41,127,128,2285
1987,3116,3761,4337,333674,333462,295,6.664,474,10.708,39760,8155,31605,2.446,11.923,38970,13227,25743,3.967,11.687,790,0.237,23.373,353,354,5738
1987,3117,674,777,42424,41316,56,7.066,87,10.978,9042,2269,6773,5.492,21.885,6803,2229,4574,5.395,16.466,2239,5.419,32.932,61,61,934
1987,3118,9139,10659,303263,301125,1621,15.371,1394,13.219,42534,15407,27127,5.116,14.125,38065,16410,21655,5.45,12.641,4469,1.484,25.282,1039,1052,8217
1987,3119,1975,2340,128848,127032,216,9.201,231,9.84,17186,4491,12695,3.535,13.529,13496,4157,9339,3.272,10.624,3690,2.905,21.248,163,163,1821
1987,3121,1780,2253,145866,148811,219,9.624,264,11.602,14574,3862,10712,2.595,9.794,20095,8833,11262,5.936,13.504,-5521,-3.71,19.587,185,188,4792
1987,3122,96,133,33954,35231,7,5.109,15,10.949,1688,611,1077,1.734,4.791,4153,703,3450,1.995,11.788,-2465,-6.997,9.582,9,9,30
1987,3131,390,606,111265,109019,31,4.988,62,9.976,12940,2027,10913,1.859,11.87,8378,4115,4263,3.775,7.685,4562,4.185,15.37,37,38,1135
1987,3132,1620,1930,239933,242576,156,7.982,205,10.489,25191,6328,18863,2.609,10.385,30820,18452,12368,7.607,12.705,-5629,-2.321,20.77,121,125,3206
1987,3133,1467,1737,101161,100986,150,8.542,188,10.706,11320,2226,9094,2.204,11.209,10952,4497,6455,4.453,10.845,368,0.364,21.69,131,131,1755
1987,3141,3743,4042,123974,124092,454,11.137,523,12.83,18779,4270,14509,3.441,15.133,19294,9596,9698,7.733,15.548,-515,-0.415,30.266,404,406,3411
1987,3149,3518,3641,111100,111703,478,13.046,524,14.301,18025,4865,13160,4.355,16.137,19147,8330,10817,7.457,17.141,-1122,-1.004,32.273,432,432,5935
1987,3151,1271,1379,136071,134242,153,11.067,160,11.573,19669,7509,12160,5.594,14.652,16050,5485,10565,4.086,11.956,3619,2.696,23.912,121,121,2559
1987,3152,11431,12786,790076,799716,2003,15.651,2027,15.838,127361,42757,84604,5.347,15.926,148017,62986,85031,7.876,18.509,-20656,-2.583,31.852,1637,1657,38631
1987,3159,1653,1730,61412,62059,198,11.074,314,17.562,9764,1855,7909,2.989,15.733,11046,4503,6543,7.256,17.799,-1282,-2.066,31.467,270,272,3274
1987,3161,322,352,15368,15135,17,4.683,39,10.744,2144,538,1606,3.555,14.166,1652,577,1075,3.812,10.915,492,3.251,21.83,29,29,312
1987,3162,383,516,78878,82452,35,6.5,80,14.856,6576,913,5663,1.107,7.976,13883,5565,8318,6.749,16.838,-7307,-8.862,15.951,49,50,979
1987,3169,1122,1168,36101,37117,123,10.437,144,12.219,5414,1355,4059,3.651,14.586,7610,3489,4121,9.4,20.503,-2196,-5.916,29.173,98,99,1780
1987,3211,4531,5017,139562,136687,486,9.565,614,12.084,21922,6502,15420,4.757,16.038,15876,7530,8346,5.509,11.615,6046,4.423,23.23,431,434,4154
1987,3212,1257,1557,102381,99938,152,9.851,124,8.036,13061,3364,9697,3.366,13.069,8285,2862,5423,2.864,8.29,4776,4.779,16.58,79,79,1205
1987,3219,8953,9594,276091,274173,1253,13.175,1086,11.419,49230,12386,36844,4.518,17.956,45283,23365,21918,8.522,16.516,3947,1.44,33.032,800,806,13095
1987,3221,208,520,188040,188590,18,3.452,21,4.027,8300,2722,5578,1.443,4.401,9337,3046,6291,1.615,4.951,-1037,-0.55,8.802,10,10,1044
1987,3222,3575,5120,383489,383049,310,6.044,328,6.395,34575,8439,26136,2.203,9.026,33842,10076,23766,2.63,8.835,733,0.191,17.67,217,218,4460
1987,3231,39948,41700,796664,788367,5072,12.374,3648,8.9,107569,31202,76367,3.958,13.645,90986,31130,59856,3.949,11.541,16583,2.103,23.082,2885,2888,21394
1987,3241,1326,2194,146958,157629,192,8.625,256,11.5,12654,3258,9396,2.067,8.028,33246,17750,15496,11.261,21.091,-20592,-13.064,16.055,114,117,1548
1987,3251,1074,2171,216608,224571,160,7.268,221,10.039,10088,2549,7539,1.135,4.492,26004,12505,13499,5.568,11.579,-15916,-7.087,8.984,70,70,772
1987,3252,348,595,124857,125752,54,9.122,48,8.108,9178,1976,7202,1.571,7.298,11087,4388,6699,3.489,8.817,-1909,-1.518,14.597,23,24,994
1987,3253,633,919,42112,43763,50,5.244,119,12.48,3463,1005,2458,2.296,7.913,6785,2815,3970,6.432,15.504,-3322,-7.591,15.826,50,50,700
1987,3254,1028,1268,157182,158585,116,9.084,134,10.493,15753,2995,12758,1.889,9.934,18207,7096,11111,4.475,11.481,-2454,-1.547,19.867,71,71,1083
1987,3255,1612,2108,75596,76430,133,6.26,166,7.814,8256,2271,5985,2.971,10.802,9984,2623,7361,3.432,13.063,-1728,-2.261,21.604,107,107,1229
1987,3256,2024,2266,112351,112577,201,8.781,247,10.791,13504,4668,8836,4.146,11.995,13946,2949,10997,2.62,12.388,-442,-0.393,23.991,183,184,1615
1987,3259,2033,2597,127533,131013,215,8.198,266,10.143,10674,2415,8259,1.843,8.147,17324,5188,12136,3.96,13.223,-6650,-5.076,16.295,133,133,1026
1987,3261,9607,11392,613926,604251,1090,9.587,1045,9.191,90559,25995,64564,4.302,14.987,71088,23922,47166,3.959,11.765,19471,3.222,23.529,716,722,11220
1987,3262,2053,2490,188504,188352,264,10.747,197,8.02,18245,7580,10665,4.024,9.687,18372,4980,13392,2.644,9.754,-127,-0.067,19.373,120,123,2009
1987,3271,1374,1651,78567,77426,208,12.625,201,12.2,10895,2119,8776,2.737,14.072,8495,3112,5383,4.019,10.972,2400,3.1,21.944,137,137,1135
1987,3272,1599,1859,139500,138828,203,10.949,193,10.41,13037,2165,10872,1.559,9.391,11991,3741,8250,2.695,8.637,1046,0.753,17.275,124,124,1315
1987,3273,6702,8946,189474,189108,700,7.794,770,8.574,32819,9473,23346,5.009,17.355,32362,11249,21113,5.948,17.113,457,0.242,34.226,450,463,5158
1987,3274,237,333,17372,17887,39,11.729,38,11.429,1259,435,824,2.432,7.039,2342,1264,1078,7.067,13.094,-1083,-6.055,14.078,26,26,159
1987,3279,1852,2142,75053,76812,232,10.859,221,10.344,7848,2547,5301,3.316,10.217,11481,3568,7913,4.645,14.947,-3633,-4.73,20.434,148,149,1558
1987,3311,294,341,135656,137037,61,18.712,31,9.509,11298,8936,2362,6.521,8.244,15067,1859,13208,1.357,10.995,-3769,-2.75,16.489,18,18,1068
1987,3312,510,691,58989,60068,66,9.628,55,8.023,6031,2935,3096,4.886,10.04,8242,3236,5006,5.387,13.721,-2211,-3.681,20.081,23,23,644
1987,3313,423,603,102187,106305,29,4.659,68,10.924,6139,1510,4629,1.42,5.775,14471,6517,7954,6.131,13.613,-8332,-7.838,11.55,18,21,1447
1987,3314,729,885,78344,79529,97,10.967,96,10.854,6262,2291,3971,2.881,7.874,8867,3272,5595,4.114,11.149,-2605,-3.276,15.748,49,50,442
1987,3315,2494,2749,201646,207729,175,6.269,260,9.314,18525,5942,12583,2.86,8.918,30575,7952,22623,3.828,14.719,-12050,-5.801,17.836,178,180,4136
1987,3321,3266,3462,134550,136928,242,6.994,238,6.879,15071,4117,10954,3.007,11.007,19863,6626,13237,4.839,14.506,-4792,-3.5,22.013,156,156,2826
1987,3322,1252,1380,76762,77380,92,6.65,99,7.156,6990,1565,5425,2.022,9.033,8111,2072,6039,2.678,10.482,-1121,-1.449,18.067,65,65,646
1987,3323,9986,10775,330517,336867,893,8.265,953,8.82,44986,13285,31701,3.944,13.354,57509,18430,39079,5.471,17.072,-12523,-3.717,26.709,680,696,9506
1987,3324,1474,1808,113807,117891,123,6.831,108,5.998,11347,2699,8648,2.289,9.625,19153,5333,13820,4.524,16.246,-7806,-6.621,19.25,63,63,940
1987,3325,911,992,71888,74294,63,6.319,73,7.322,4653,911,3742,1.226,6.263,9635,2894,6741,3.895,12.969,-4982,-6.706,12.526,47,49,1276
1987,3326,1528,1730,62502,63043,120,6.843,167,9.524,7871,2094,5777,3.322,12.485,9004,3318,5686,5.263,14.282,-1133,-1.797,24.97,117,117,1791
1987,3327,20886,21152,302203,305243,2338,11.114,2108,10.02,40816,12618,28198,4.134,13.372,46976,14817,32159,4.854,15.39,-6160,-2.018,26.743,1587,1592,10593
1987,3328,5444,5784,149337,147609,415,7.128,491,8.434,22739,4069,18670,2.757,15.405,19366,5692,13674,3.856,13.12,3373,2.285,26.24,379,379,3969
1987,3329,6214,6712,346768,352845,719,10.758,662,9.905,34539,10079,24460,2.856,9.789,46577,14451,32126,4.096,13.2,-12038,-3.412,19.577,451,454,5276
1987,3331,2861,3128,186410,194750,262,8.191,403,12.6,22935,5800,17135,2.978,11.777,39986,13994,25992,7.186,20.532,-17051,-8.755,23.553,223,223,2367
1987,3332,3966,4205,157960,162070,321,7.625,331,7.862,17362,4900,12462,3.023,10.713,25298,5521,19777,3.407,15.609,-7936,-4.897,21.425,236,236,2311
1987,3333,2161,2276,150498,154987,189,8.315,183,8.051,12614,4034,8580,2.603,8.139,21348,5443,15905,3.512,13.774,-8734,-5.635,16.277,107,107,1893
1987,3334,1625,1863,159496,161093,128,6.719,212,11.129,14794,2134,12660,1.325,9.184,18269,6988,11281,4.338,11.341,-3475,-2.157,18.367,157,160,2345
1987,3335,9222,9572,211077,216967,648,6.725,774,8.033,23310,6792,16518,3.13,10.744,35158,9596,25562,4.423,16.204,-11848,-5.461,21.487,572,573,4182
1987,3336,749,895,127365,130592,46,5.049,78,8.562,10077,5151,4926,3.944,7.716,16666,5006,11660,3.833,12.762,-6589,-5.046,15.433,39,40,805
1987,3339,5283,5859,303607,313646,491,8.343,543,9.227,26909,8636,18273,2.753,8.579,46734,13478,33256,4.297,14.9,-19825,-6.321,17.159,368,370,4864
1987,3341,1496,1630,276007,286369,265,16.188,279,17.043,26362,6295,20067,2.198,9.206,47402,17336,30066,6.054,16.553,-21040,-7.347,18.411,196,196,3164
1987,3342,1360,1544,241012,255262,164,10.363,241,15.229,22173,7503,14670,2.939,8.686,51320,21376,29944,8.374,20.105,-29147,-11.418,17.373,154,160,4791
1987,3343,360,380,29663,30038,37,9.61,47,12.208,3377,636,2741,2.117,11.242,4085,2517,1568,8.379,13.599,-708,-2.357,22.485,30,30,234
1987,3344,4373,4965,514757,520560,593,11.873,652,13.054,57080,17031,40049,3.272,10.965,69240,28000,41240,5.379,13.301,-12160,-2.336,21.93,417,421,5525
1987,3345,4384,5011,675854,681266,497,9.99,425,8.543,53158,16426,36732,2.411,7.803,64571,19563,45008,2.872,9.478,-11413,-1.675,15.606,262,264,6867
1987,3346,705,744,42659,41195,137,18.897,99,13.655,7179,1700,5479,4.127,17.427,4244,720,3524,1.748,10.302,2935,7.125,20.604,75,75,502
1987,3351,1163,1291,85134,85995,98,7.433,153,11.604,8752,2086,6666,2.426,10.177,10525,3146,7379,3.658,12.239,-1773,-2.062,20.355,100,100,1232
1987,3352,307,394,112139,112642,27,6.667,49,12.099,10578,1444,9134,1.282,9.391,11688,7184,4504,6.378,10.376,-1110,-0.985,18.782,26,26,555
1987,3353,2096,2573,230548,236107,203,7.905,193,7.516,19540,5801,13739,2.457,8.276,31137,9656,21481,4.09,13.188,-11597,-4.912,16.552,85,85,1533
1987,3359,2206,2546,191149,195807,262,10.35,233,9.204,18352,6198,12154,3.165,9.372,27783,8826,18957,4.507,14.189,-9431,-4.816,18.745,137,138,1641
1987,3361,224,280,247069,256002,48,17.486,37,13.479,22612,5377,17235,2.1,8.833,41220,12325,28895,4.814,16.101,-18608,-7.269,17.666,27,27,166
1987,3362,1849,2043,119731,117307,233,11.447,218,10.71,17788,4245,13543,3.619,15.164,13071,5142,7929,4.383,11.143,4717,4.021,22.285,163,165,2145
1987,3363,3808,4627,659074,667797,392,8.469,395,8.534,51338,14692,36646,2.2,7.688,69645,13181,56464,1.974,10.429,-18307,-2.741,15.375,284,284,4723
1987,3364,1372,1659,689210,682490,130,7.829,133,8.01,68874,21356,47518,3.129,10.092,53744,13117,40627,1.922,7.875,15130,2.217,15.749,96,97,1502
1987,3365,163,185,24382,26426,14,7.467,19,10.133,1887,468,1419,1.771,7.141,5930,801,5129,3.031,22.44,-4043,-15.3,14.282,10,10,59
1987,3366,1210,1293,155058,156983,160,12.529,128,10.023,18022,3211,14811,2.045,11.48,22316,3781,18535,2.409,14.216,-4294,-2.735,22.961,84,84,959
1987,3369,465,479,30330,30510,63,13.139,64,13.347,3046,767,2279,2.514,9.984,3390,1515,1875,4.966,11.111,-344,-1.127,19.967,55,55,592
1987,3371,12978,13636,390445,384495,1961,14.516,1707,12.636,59048,16096,42952,4.186,15.357,47491,19649,27842,5.11,12.352,11557,3.006,24.703,1329,1332,13036
1987,3372,2848,3007,151368,151055,325,10.893,278,9.318,20000,5335,14665,3.532,13.24,19341,6589,12752,4.362,12.804,659,0.436,25.608,218,218,3306
1987,3379,1061,1212,41483,41026,115,9.532,104,8.62,5898,2613,3285,6.369,14.376,5062,1377,3685,3.356,12.339,836,2.038,24.677,83,83,1174
1987,3391,10417,10939,234872,232694,1264,11.602,1175,10.785,33953,9898,24055,4.254,14.591,29377,11999,17378,5.157,12.625,4576,1.967,25.25,861,865,4652
1987,3399,14967,15498,390220,388599,2072,13.48,1817,11.821,60626,16257,44369,4.183,15.601,57085,20860,36225,5.368,14.69,3541,0.911,29.38,1388,1390,10903
1987,4231,22090,27213,310675,311940,2934,10.673,3489,12.692,53754,18425,35329,5.907,17.232,56238,22879,33359,7.334,18.028,-2484,-0.796,34.464,2171,2240,13043
1987,4232,8263,9451,114628,112737,1330,14.162,1211,12.895,22918,7816,15102,6.933,20.329,19206,7988,11218,7.086,17.036,3712,3.293,34.072,860,869,4291
1987,4233,8311,10569,139484,135656,1441,13.813,1167,11.187,29816,10522,19294,7.756,21.979,22626,8966,13660,6.609,16.679,7190,5.3,33.358,777,787,5025
1987,4234,24899,34463,605099,597231,5193,15.311,4099,12.086,123262,59567,63695,9.974,20.639,105224,48580,56644,8.134,17.619,18038,3.02,35.237,2296,2392,16023
1987,4235,6890,9070,130459,134376,994,10.889,1111,12.171,20125,7370,12755,5.485,14.977,27703,9990,17713,7.434,20.616,-7578,-5.639,29.953,571,589,4037
1987,4236,15480,22407,311404,317382,2618,11.642,2781,12.366,59516,19261,40255,6.069,18.752,71751,30146,41605,9.498,22.607,-12235,-3.855,37.504,1448,1503,9558
1987,4237,11077,14936,163150,163319,1398,9.403,1262,8.488,24909,7094,17815,4.344,15.252,25286,8647,16639,5.295,15.483,-377,-0.231,30.504,786,810,5402
1987,4238,47211,61172,638415,639259,5918,9.625,6543,10.642,106977,34248,72729,5.357,16.735,108731,39760,68971,6.22,17.009,-1754,-0.274,33.469,3732,3825,19577
1987,4239,24311,25862,240074,237158,4175,16.294,3696,14.425,53139,18946,34193,7.989,22.407,47522,20363,27159,8.586,20.038,5617,2.368,40.076,2769,2793,13550
1987,4241,8367,11123,166409,161000,1169,10.603,973,8.825,30738,6436,24302,3.998,19.092,20085,8176,11909,5.078,12.475,10653,6.617,24.95,603,607,3578
1987,4242,2935,3835,105710,103130,593,15.64,506,13.346,20728,7670,13058,7.437,20.099,15449,6318,9131,6.126,14.98,5279,5.119,29.96,330,332,2264
1987,4243,11555,12450,150234,145723,2025,16.312,1954,15.74,37121,12809,24312,8.79,25.474,28000,11975,16025,8.218,19.215,9121,6.259,38.429,1422,1440,7043
1987,4244,27462,33813,671652,664195,4202,12.45,4079,12.085,120790,37959,82831,5.715,18.186,105439,39798,65641,5.992,15.875,15351,2.311,31.749,2898,2945,22437
1987,4245,7235,10138,89561,89336,673,6.544,966,9.393,16051,4611,11440,5.161,17.967,15751,5273,10478,5.902,17.631,300,0.336,35.262,579,605,3386
1987,4246,7466,10718,125358,123612,1245,11.579,1314,12.22,25241,8840,16401,7.151,20.42,22040,9299,12741,7.523,17.83,3201,2.59,35.66,620,640,2744
1987,4247,9874,12905,143596,141827,1141,8.731,1469,11.24,29504,9361,20143,6.6,20.803,26044,9555,16489,6.737,18.363,3460,2.44,36.726,789,814,4911
1987,4248,4038,5157,141362,139149,368,6.995,576,10.948,20719,6863,13856,4.932,14.89,16309,7346,8963,5.279,11.721,4410,3.169,23.441,382,404,4603
1987,4249,20554,24952,284609,282021,3484,14.056,3154,12.724,55967,19082,36885,6.766,19.845,50350,20889,29461,7.407,17.853,5617,1.992,35.707,2106,2117,10356
1987,4251,30436,32849,306574,303576,4122,12.647,3608,11.07,61331,23119,38212,7.616,20.203,55385,21721,33664,7.155,18.244,5946,1.959,36.488,2244,2250,12596
1987,4411,38463,40100,982401,962436,5035,12.696,4149,10.462,156250,64306,91944,6.682,16.235,116256,46562,69694,4.838,12.079,39994,4.155,24.159,3314,3334,36933
1987,4412,11467,12058,90063,87467,1521,12.679,1398,11.653,21091,7624,13467,8.716,24.113,15947,6612,9335,7.559,18.232,5144,5.881,36.464,1086,1102,5098
1987,4413,50565,74375,521483,510346,8067,11.028,5614,7.675,106739,44659,62080,8.751,20.915,84511,26439,58072,5.181,16.56,22228,4.355,33.119,3523,3641,16519
1987,4421,21821,27663,235118,232078,3450,12.517,3251,11.795,48363,17670,30693,7.614,20.839,42478,16674,25804,7.185,18.303,5885,2.536,36.607,2120,2239,10429
1987,4422,22384,27756,168722,162674,4338,15.94,3256,11.964,44665,18581,26084,11.422,27.457,32336,14400,17936,8.852,19.878,12329,7.579,39.756,2173,2235,8233
1987,4431,20088,27306,191414,195929,4221,14.899,6270,22.132,47508,20797,26711,10.615,24.248,56627,32944,23683,16.814,28.902,-9119,-4.654,48.495,3852,4121,19632
1987,4441,55342,70935,759299,741366,6809,9.592,6917,9.744,148657,53559,95098,7.224,20.052,113684,50257,63427,6.779,15.334,34973,4.717,30.669,4569,4681,25534
1987,4442,15836,19302,143288,140995,2160,11.28,1855,9.687,28169,10034,18135,7.117,19.979,23659,7141,16518,5.065,16.78,4510,3.199,33.56,1321,1332,4900
1987,4451,63222,95413,2174887,2123756,12343,12.813,14180,14.72,395574,184269,211305,8.677,18.626,294557,136550,158007,6.43,13.87,101017,4.757,27.739,8169,8432,56257
1987,4452,22020,26100,167778,168198,4179,15.831,4774,18.085,42331,20466,21865,12.168,25.167,42922,22039,20883,13.103,25.519,-591,-0.351,50.335,3371,3459,14495
1987,4453,27338,32364,157522,160567,3599,10.977,4442,13.549,31860,12910,18950,8.04,19.842,37816,16302,21514,10.153,23.552,-5956,-3.709,39.684,3284,3334,11979
1987,4461,47312,73574,697276,673268,7432,10.193,6107,8.376,145623,53282,92341,7.914,21.629,96718,36977,59741,5.492,14.365,48905,7.264,28.731,3878,3987,20933
1987,4471,87420,135816,941478,923338,16502,12.197,15470,11.434,224098,97294,126804,10.537,24.27,187018,76683,110335,8.305,20.255,37080,4.016,40.509,10278,10498,47326
1987,4481,55170,101844,920343,907794,15800,15.754,12701,12.664,213759,110309,103450,12.151,23.547,188793,68905,119888,7.59,20.797,24966,2.75,41.594,7382,7884,31646
1987,4482,11330,36878,199991,200076,4262,11.583,4095,11.129,43097,19676,23421,9.834,21.54,42542,16810,25732,8.402,21.263,555,0.277,42.526,1746,2012,8062
1987,4483,18870,27935,171352,164003,3682,13.292,3212,11.596,45805,16180,29625,9.866,27.929,30193,13044,17149,7.954,18.41,15612,9.519,36.82,1985,2061,7627
1987,4511,32036,41621,293407,285476,6407,15.503,5820,14.083,71412,31426,39986,11.008,25.015,55091,24344,30747,8.528,19.298,16321,5.717,38.596,4015,4165,14713
1987,4512,8022,12240,82380,80937,1765,14.575,1505,12.428,17911,7493,10418,9.258,22.13,15263,6674,8589,8.246,18.858,2648,3.272,37.716,971,1005,4000
1987,4522,249,6409,1132597,1129110,395,6.193,333,5.221,116464,52093,64371,4.614,10.315,110147,22830,87317,2.022,9.755,6317,0.559,19.51,34,40,1629
1987,4523,11632,27079,835112,837509,2851,10.496,3020,11.118,105655,51146,54509,6.107,12.615,110768,41925,68843,5.006,13.226,-5113,-0.611,25.231,1646,1683,8703
1987,4531,22783,24268,123034,122857,3483,14.448,3162,13.116,26541,10670,15871,8.685,21.603,26269,10909,15360,8.879,21.382,272,0.221,42.764,2394,2417,8168
1987,4532,29270,36278,221876,222808,6372,17.96,4775,13.458,55389,24699,30690,11.085,24.86,56711,31710,25001,14.232,25.453,-1322,-0.593,49.719,3393,3455,13495
1987,4533,9002,11089,56972,56150,1826,16.614,1629,14.822,12471,5200,7271,9.261,22.21,10777,4607,6170,8.205,19.193,1694,3.017,38.387,1268,1272,3332
1987,4539,22979,26726,137932,136312,4819,17.846,5372,19.894,39681,18038,21643,13.233,29.111,36577,19863,16714,14.572,26.833,3104,2.277,53.667,3648,3847,13864
1987,4541,5351,6635,99309,95435,961,14.542,908,13.74,22693,7360,15333,7.712,23.778,14954,6740,8214,7.062,15.669,7739,8.109,31.339,684,688,3991
1987,4542,3871,4835,71560,72122,605,12.451,653,13.439,13076,4775,8301,6.621,18.13,14315,5543,8772,7.686,19.848,-1239,-1.718,36.261,415,417,2333
1987,4543,15991,21908,217301,212905,2082,9.455,2304,10.464,43505,12733,30772,5.981,20.434,35120,11945,23175,5.61,16.496,8385,3.938,32.991,1642,1659,7922
1987,4811,785,2708,353357,344150,318,11.269,546,19.348,54098,8023,46075,2.331,15.719,34241,19819,14422,5.759,9.949,19857,5.77,19.899,137,148,1915
1987,4812,424,800,17220,16365,147,18.41,144,18.034,5703,2763,2940,16.884,34.85,3959,1783,2176,10.896,24.193,1744,10.657,48.385,79,79,422
1987,4831,307,599,31263,31650,81,13.128,117,18.963,7800,3013,4787,9.52,24.645,8616,3103,5513,9.804,27.223,-816,-2.578,49.29,48,48,706
1987,4832,316,349,13675,13042,33,9.154,56,15.534,2946,276,2670,2.116,22.589,1710,509,1201,3.903,13.111,1236,9.477,26.223,37,37,255
1987,4841,19806,25576,520781,510602,4517,17.53,4900,19.016,107275,37890,69385,7.421,21.01,86892,40714,46178,7.974,17.018,20383,3.992,34.035,3486,3503,20528
1987,4842,48003,52327,552172,541870,9813,19.226,7239,14.183,128292,49062,79230,9.054,23.676,107776,43173,64603,7.967,19.89,20516,3.786,39.779,5320,5336,27379
1987,4851,362,383,35134,33639,37,9.61,41,10.649,4358,664,3694,1.974,12.955,1472,613,859,1.822,4.376,2886,8.579,8.752,35,35,602
1987,4852,333,623,20601,20986,71,11.297,82,13.047,3130,1035,2095,4.932,14.915,3931,1458,2473,6.947,18.732,-801,-3.817,29.829,42,42,629
1987,4853,4957,5013,55410,54878,925,18.404,951,18.922,12493,4655,7838,8.483,22.765,11266,5407,5859,9.853,20.529,1227,2.236,41.059,788,788,4418
1987,4854,3239,3526,101040,98653,351,9.98,333,9.468,18560,6360,12200,6.447,18.814,13576,6169,7407,6.253,13.761,4984,5.052,27.523,261,264,5188
1987,4855,697,757,17447,16661,129,17.468,92,12.458,4246,1623,2623,9.742,25.485,2620,956,1664,5.738,15.726,1626,9.76,31.452,76,76,783
1987,4859,974,1016,21238,21038,215,21.586,175,17.57,3882,1413,2469,6.716,18.452,3508,1723,1785,8.19,16.675,374,1.778,33.349,152,152,1534
1987,4861,65,293,9161,9664,30,10.274,28,9.589,1012,270,742,2.794,10.472,1943,713,1230,7.378,20.107,-931,-9.634,20.945,4,4,36
1987,4862,235,1325,58461,58311,59,4.41,85,6.353,6029,1059,4970,1.816,10.339,5730,1399,4331,2.399,9.827,299,0.513,19.653,29,29,288
1987,4869,63,342,7533,8485,14,4.006,29,8.298,485,187,298,2.204,5.716,2374,406,1968,4.785,27.98,-1889,-22.264,11.433,8,8,34
1987,4871,229,232,4534,4214,52,23.111,38,16.889,1395,273,1122,6.478,33.104,728,214,514,5.078,17.276,667,15.828,34.551,31,31,184
1987,4872,657,669,6726,6426,143,21.601,129,19.486,2210,874,1336,13.602,34.394,1650,798,852,12.419,25.679,560,8.715,51.358,96,96,530
1987,4879,51,75,1041,942,16,21.918,12,16.438,349,220,129,23.355,37.049,139,67,72,7.113,14.756,210,22.293,29.512,7,7,15
1987,4881,2134,2762,71148,70340,430,15.789,353,12.961,14262,5668,8594,8.058,20.276,12501,5254,7247,7.469,17.772,1761,2.504,35.544,246,246,2047
1987,4882,368,514,12693,12085,106,21.788,51,10.483,3131,1732,1399,14.332,25.909,1943,1096,847,9.069,16.078,1188,9.831,32.157,35,35,467
1987,4883,2042,2448,86872,88341,319,12.798,408,16.369,23130,6468,16662,7.322,26.183,25939,10024,15915,11.347,29.362,-2809,-3.18,52.365,273,277,6288
1987,4884,545,683,7508,9085,130,14.723,530,60.023,1655,899,756,9.896,18.218,4750,3516,1234,38.703,52.287,-3095,-34.069,36.436,403,412,2320
1987,4885,6510,8634,101630,99016,1577,18.849,1042,12.454,25311,10397,14914,10.5,25.563,20113,8700,11413,8.786,20.313,5198,5.25,40.626,688,754,5988
1987,4889,517,529,5925,5666,162,33.645,67,13.915,1738,680,1058,12.001,30.674,1228,469,759,8.277,21.673,510,9.001,43.346,56,56,429
1987,4921,1673,3100,296737,282809,664,22.207,444,14.849,64073,13146,50927,4.648,22.656,37955,16155,21800,5.712,13.421,26118,9.235,26.841,268,268,2978
1987,4922,3693,3924,53055,50356,870,23.895,304,8.349,13660,6035,7625,11.985,27.127,8291,1191,7100,2.365,16.465,5369,10.662,32.93,246,246,905
1987,4931,6172,9829,401601,400094,1162,11.95,952,9.79,72521,26821,45700,6.704,18.126,68880,28943,39937,7.234,17.216,3641,0.91,34.432,347,353,4007
1987,5111,13790,16054,674187,671569,1767,10.997,1794,11.165,73610,22556,51054,3.359,10.961,68167,29412,38755,4.38,10.15,5443,0.81,20.301,1364,1371,12005
1987,5112,2670,3050,63300,65745,647,18.269,1630,46.026,16522,6822,9700,10.377,25.131,21296,15676,5620,23.844,32.392,-4774,-7.261,50.261,1088,1099,7185
1987,5121,9668,14417,225279,231213,2401,16.647,2413,16.73,50834,19885,30949,8.6,21.986,61774,17376,44398,7.515,26.717,-10940,-4.732,43.972,1332,1392,7702
1987,5122,1851,1862,13894,13251,440,23.201,509,26.839,5125,1823,3302,13.757,38.676,3801,2332,1469,17.599,28.685,1324,9.992,57.369,425,425,1759
1987,5151,6075,7425,232974,235111,1265,17.104,1207,16.32,46166,28186,17980,11.988,19.636,49923,26209,23714,11.148,21.234,-3757,-1.598,39.272,938,973,18433
1987,5152,12,17,1304,844,8,53.333,4,26.667,968,388,580,45.999,114.76,25,22,3,2.608,2.964,943,111.796,5.928,3,3,17
1987,5173,3381,19291,914043,911205,3438,18.865,1305,7.161,225181,148940,76241,16.345,24.712,220152,35748,184404,3.923,24.161,5029,0.552,48.321,461,487,8036
1987,5174,683,1459,67745,68439,206,14.139,202,13.864,13930,7247,6683,10.589,20.354,15331,6521,8810,9.528,22.401,-1401,-2.047,40.708,122,130,3467
1987,5179,1331,3017,71556,71644,628,21.274,498,16.87,20201,13931,6270,19.445,28.197,20238,5077,15161,7.086,28.248,-37,-0.052,56.393,332,337,2769
1987,5182,5465,7166,242301,239011,1128,15.594,1263,17.46,55196,22181,33015,9.28,23.094,48554,22025,26529,9.215,20.315,6642,2.779,40.629,659,667,5745
1987,5191,2280,2741,36118,35947,317,11.523,337,12.25,4855,1819,3036,5.06,13.506,4532,2106,2426,5.859,12.608,323,0.899,25.215,254,255,1336
1987,5211,46,84,24588,24882,4,4.819,(D),(D),602,194,408,0.78,2.419,1169,(D),1147,(D),4.698,-567,-2.279,4.839,0,0,0
1987,5221,19093,73579,2031557,2022608,3793,5.178,3134,4.279,253918,67061,186857,3.316,12.554,234724,57381,177343,2.837,11.605,19194,0.949,23.21,939,1161,23344
1987,5222,21100,39818,514970,483162,4007,10.104,3688,9.299,129862,57695,72167,11.941,26.878,67774,32854,34920,6.8,14.027,62088,12.85,28.054,1781,1851,11985
1987,5223,4476,5012,62999,59954,1211,24.977,884,18.232,18223,6910,11313,11.526,30.395,12077,7102,4975,11.846,20.144,6146,10.251,40.288,669,672,5073
1987,5231,6620,13559,371306,351232,2052,15.543,1339,10.142,75350,19557,55793,5.568,21.453,34894,9201,25693,2.62,9.935,40456,11.518,19.87,909,915,5663
1987,5232,110,123,7012,6852,18,14.938,13,10.788,681,81,600,1.182,9.939,349,204,145,2.977,5.093,332,4.845,10.187,12,12,202
1987,5239,15378,15978,188819,174870,3898,25.209,2868,18.548,68751,32892,35859,18.809,39.315,40987,21512,19475,12.302,23.439,27764,15.877,46.877,2288,2290,13364
1987,5241,6758,33385,1363176,1356708,4670,14.513,2255,7.008,181575,44127,137448,3.253,13.384,165291,34592,130699,2.55,12.183,16284,1.2,24.366,509,520,5049
1987,5242,101237,106210,924693,881183,14188,13.529,11506,10.972,226815,91865,134950,10.425,25.74,139335,54616,84719,6.198,15.812,87480,9.928,31.625,8605,8622,35078
1987,5259,866,1082,12671,12185,165,15.789,91,8.708,3006,951,2055,7.805,24.67,1978,1039,939,8.527,16.233,1028,8.437,32.466,69,69,676
1987,5311,93355,96892,527390,525118,13841,14.176,15325,15.696,127006,58919,68087,11.22,24.186,122469,62400,60069,11.883,23.322,4537,0.864,46.644,12720,12758,47319
1987,5312,39129,41237,241239,235252,7907,19.614,6061,15.034,65718,29335,36383,12.47,27.935,53704,24486,29218,10.408,22.828,12014,5.107,45.657,4677,4689,17228
1987,5313,24599,25804,294064,281797,5127,20.303,4024,15.935,79594,32977,46617,11.702,28.245,54892,24642,30250,8.745,19.479,24702,8.766,38.959,3159,3172,18119
1987,5321,6132,10123,135131,139150,1763,17.6,1551,15.484,29709,14587,15122,10.483,21.35,38668,12461,26207,8.955,27.789,-8959,-6.438,42.701,865,925,5616
1987,5322,19165,23132,140509,137556,6902,32.23,3468,16.194,53102,29453,23649,21.412,38.604,47702,27868,19834,20.259,34.678,5400,3.926,69.356,2118,2159,12483
1987,5323,4258,5415,37209,37749,1004,18.926,784,14.779,9768,4343,5425,11.505,25.876,11099,5848,5251,15.492,29.402,-1331,-3.526,51.752,461,464,2647
1987,5324,7837,9698,106491,107703,1771,18.727,1289,13.63,25106,9730,15376,9.034,23.31,28196,12588,15608,11.688,26.179,-3090,-2.869,46.621,723,730,4279
1987,5331,802,839,11291,10576,175,20.833,177,21.071,3734,1879,1855,17.767,35.306,2307,1239,1068,11.715,21.814,1427,13.493,43.627,139,139,804
1987,5411,129536,133861,857052,827316,15938,12.051,12729,9.624,168722,55870,112852,6.753,20.394,108664,43152,65512,5.216,13.135,60058,7.259,26.269,9267,9325,32764
1987,5412,65340,69375,581694,566114,10965,16.186,7704,11.372,121267,42162,79105,7.448,21.421,89784,37505,52279,6.625,15.86,31483,5.561,31.719,5582,5625,25452
1987,5413,57608,63609,831173,821807,10395,16.643,8096,12.962,175363,59651,115712,7.259,21.339,156481,52781,103700,6.423,19.041,18882,2.298,38.082,5740,5772,26701
1987,5414,14405,14609,91089,89951,2709,18.839,2251,15.654,22784,9546,13238,10.613,25.329,20526,10054,10472,11.177,22.819,2258,2.51,45.638,1747,1751,7112
1987,5415,17751,20005,298837,275487,5206,27.623,2889,15.329,89824,35933,53891,13.043,32.606,42667,14425,28242,5.236,15.488,47157,17.118,30.976,2239,2243,9774
1987,5416,38388,39865,308935,301556,9996,25.578,8428,21.565,106485,47164,59321,15.64,35.312,91426,49973,41453,16.572,30.318,15059,4.994,60.636,6560,6570,34134
1987,5417,6488,7908,430703,430141,1386,17.899,1057,13.65,66456,20833,45623,4.843,15.45,65437,23552,41885,5.475,15.213,1019,0.237,30.426,607,610,4448
1987,5418,25108,27331,328092,324434,5036,18.763,4054,15.104,74494,27887,46607,8.596,22.961,66899,28863,38036,8.896,20.62,7595,2.341,41.24,3054,3092,19467
1987,5419,30903,34499,254939,249239,4366,12.854,3299,9.713,56342,19158,37184,7.687,22.606,44880,15652,29228,6.28,18.007,11462,4.599,36.014,2456,2459,10680
1987,5511,24506,44533,3035616,3059328,5360,12.048,5275,11.856,561966,173379,388587,5.667,18.369,611538,179801,431737,5.877,19.989,-49572,-1.62,36.738,983,1018,15236
1987,5611,12349,13005,209285,199156,3146,25.398,1910,15.419,64936,31982,32954,16.059,32.606,44728,14059,30669,7.059,22.459,20208,10.147,44.918,1411,1412,8827
1987,5612,356,480,58168,57172,67,14.378,39,8.369,11687,5753,5934,10.063,20.442,9035,825,8210,1.443,15.803,2652,4.639,31.607,31,31,449
1987,5613,15306,20829,1090463,1055014,4478,22.457,2700,13.541,356442,130452,225990,12.365,33.786,287652,72522,215130,6.874,27.265,68790,6.52,54.53,1777,1791,36061
1987,5614,20494,23308,255073,245685,4107,18.053,2990,13.143,63530,25687,37843,10.455,25.858,45008,15180,29828,6.179,18.319,18522,7.539,36.639,2204,2218,9504
1987,5615,22663,26606,202463,199782,3958,15.022,3443,13.067,49096,19781,29315,9.901,24.575,43481,19820,23661,9.921,21.764,5615,2.811,43.528,2472,2544,12341
1987,5616,11993,14688,444002,451309,2595,17.908,2200,15.182,103408,45635,57773,10.112,22.913,115551,59792,55759,13.249,25.604,-12143,-2.691,45.826,1486,1626,24983
1987,5617,73822,77209,966384,941327,17969,24.093,12714,17.047,253996,97020,156976,10.307,26.983,203722,77705,126017,8.255,21.642,50274,5.341,43.284,10030,10045,52810
1987,5619,13646,14646,197240,188940,2876,20.281,1945,13.716,54895,18715,36180,9.905,29.054,38574,16377,22197,8.668,20.416,16321,8.638,40.832,1418,1425,10428
1987,5621,2536,2582,28313,30381,248,8.89,663,23.768,5225,1318,3907,4.338,17.198,9503,7819,1684,25.736,31.279,-4278,-14.081,34.396,561,561,5725
1987,5622,1705,2363,59158,56103,356,15.405,252,10.904,12691,4078,8613,7.269,22.621,6501,2112,4389,3.765,11.588,6190,11.033,23.175,200,200,1563
1987,5629,4593,4857,46419,44612,815,17.073,648,13.575,12280,4622,7658,10.36,27.526,8604,3708,4896,8.312,19.286,3676,8.24,38.573,496,496,2319
1987,6111,13387,14355,428805,424203,636,4.439,578,4.035,42225,7499,34726,1.768,9.954,32945,6013,26932,1.417,7.766,9280,2.188,15.533,433,433,4157
1987,6112,473,667,51658,49670,104,16.391,39,6.147,10458,2521,7937,5.076,21.055,6621,3760,2861,7.57,13.33,3837,7.725,26.66,18,21,845
1987,6113,1990,2308,940329,926701,98,4.26,83,3.608,76438,2651,73787,0.286,8.248,48759,2880,45879,0.311,5.262,27679,2.987,10.523,51,51,1824
1987,6114,2244,2745,44351,42886,568,21.454,373,14.089,11025,5013,6012,11.689,25.708,7928,3861,4067,9.003,18.486,3097,7.221,36.972,271,275,2331
1987,6115,3723,4495,57868,54874,662,15.045,472,10.727,15856,4893,10963,8.917,28.895,9531,3261,6270,5.943,17.369,6325,11.526,34.738,333,340,2309
1987,6116,10812,11380,90077,87779,2158,19.082,2016,17.827,23639,9863,13776,11.236,26.93,19056,8685,10371,9.894,21.709,4583,5.221,43.418,1585,1596,6782
1987,6117,1570,1601,16275,15688,287,18.193,240,15.214,4129,2120,2009,13.514,26.32,2901,1364,1537,8.695,18.492,1228,7.828,36.985,180,180,1091
1987,6211,183239,191157,1241381,1204152,16236,8.526,14772,7.757,260009,83627,176382,6.945,21.593,185314,65496,119818,5.439,15.39,74695,6.203,30.779,11578,11656,48739
1987,6212,97419,99942,490618,483397,6244,6.269,5577,5.599,78501,21613,56888,4.471,16.239,64007,20067,43940,4.151,13.241,14494,2.998,26.482,4207,4241,15376
1987,6213,48848,51169,187380,179756,7177,14.365,4763,9.533,48570,20871,27699,11.611,27.02,33131,14879,18252,8.277,18.431,15439,8.589,36.862,3539,3566,11548
1987,6214,7099,10626,181588,174431,2022,20.098,891,8.856,47059,20643,26416,11.834,26.979,33027,11085,21942,6.355,18.934,14032,8.044,37.868,555,569,5634
1987,6215,4797,6120,86989,83557,984,16.351,780,12.961,22929,9888,13041,11.834,27.441,16254,7367,8887,8.817,19.453,6675,7.989,38.905,511,527,3499
1987,6216,4420,6230,292013,282697,1231,20.27,917,15.1,76762,26674,50088,9.436,27.154,58846,16499,42347,5.836,20.816,17916,6.338,41.632,615,617,6803
1987,6219,4927,5783,110108,108053,1132,20.166,793,14.127,27030,11666,15364,10.797,25.016,22955,12233,10722,11.321,21.244,4075,3.771,42.488,556,560,7521
1987,6221,4366,5748,3644764,3699001,629,11.332,234,4.216,564895,356451,208444,9.636,15.272,669037,56672,612365,1.532,18.087,-104142,-2.815,30.543,132,132,28401
1987,6222,527,817,282151,427752,268,38.368,31,4.438,149716,138808,10908,32.451,35.001,444010,1967,442043,0.46,103.801,-294294,-68.8,70.001,23,23,1275
1987,6223,217,261,97204,112475,62,26.216,13,5.497,28053,22576,5477,20.072,24.942,55928,1007,54921,0.895,49.725,-27875,-24.783,49.883,5,5,450
1987,6231,8098,13275,1119679,1100514,1532,11.762,1033,7.931,176661,94512,82149,8.588,16.053,139383,67491,71892,6.133,12.665,37278,3.387,25.331,660,693,45563
1987,6232,4867,7294,170649,163752,1030,14.601,551,7.811,35519,14569,20950,8.897,21.691,21791,7743,14048,4.729,13.307,13728,8.383,26.615,395,403,5639
1987,6233,8283,9678,252252,248108,1604,16.983,1138,12.049,50242,25216,25026,10.163,20.25,42000,23387,18613,9.426,16.928,8242,3.322,33.856,722,744,15415
1987,6239,3190,4027,102774,97832,503,12.833,288,7.348,20860,7934,12926,8.11,21.322,11069,3684,7385,3.766,11.314,9791,10.008,22.629,189,193,2551
1987,6241,15951,21367,306234,299134,2277,10.842,1548,7.371,52837,13576,39261,4.538,17.663,38974,10705,28269,3.579,13.029,13863,4.634,26.058,888,899,5464
1987,6242,4498,5294,50390,49421,525,10.044,391,7.48,9606,2154,7452,4.359,19.437,7634,2290,5344,4.634,15.447,1972,3.99,30.894,220,220,1237
1987,6243,4409,6470,260320,255973,718,11.395,380,6.031,47731,8018,39713,3.132,18.647,39765,5716,34049,2.233,15.535,7966,3.112,31.07,168,174,2472
1987,6244,31960,37895,349318,340839,5069,13.53,4208,11.232,72258,30120,42138,8.837,21.2,55349,21717,33632,6.372,16.239,16909,4.961,32.478,3199,3235,15370
1987,7111,5134,5185,72514,70388,923,18.038,787,15.38,22284,5701,16583,8.099,31.659,18286,4927,13359,7,25.979,3998,5.68,51.958,593,593,3528
1987,7112,2361,2487,72619,69612,487,20.062,368,15.16,19506,5712,13794,8.206,28.021,13357,3147,10210,4.521,19.188,6149,8.833,38.376,265,265,2131
1987,7113,2168,2219,32373,32797,429,19.788,327,15.083,9290,2580,6710,7.867,28.326,10129,2188,7941,6.671,30.884,-839,-2.558,56.652,250,250,1509
1987,7114,1074,1090,10791,11204,211,19.474,198,18.274,3195,1162,2033,10.371,28.517,3948,1350,2598,12.049,35.237,-753,-6.721,57.033,148,148,708
1987,7115,8805,8838,46178,46155,2545,28.12,2970,32.816,19677,9081,10596,19.675,42.633,19823,12180,7643,26.39,42.949,-146,-0.316,85.266,2378,2378,8879
1987,7121,2696,2888,53158,51804,239,8.389,161,5.651,6857,1315,5542,2.538,13.237,4142,718,3424,1.386,7.996,2715,5.241,15.991,109,109,523
1987,7131,1686,2281,61167,61859,345,15.222,316,13.942,8856,3322,5534,5.37,14.317,9869,2538,7331,4.103,15.954,-1013,-1.638,28.633,231,232,2027
1987,7132,615,641,22428,21109,115,17.983,112,17.514,4705,1602,3103,7.589,22.29,2055,1094,961,5.183,9.735,2650,12.554,19.471,91,91,942
1987,7139,35198,38523,575669,560546,6180,16.46,4225,11.253,127386,54949,72437,9.803,22.725,97396,35043,62353,6.252,17.375,29990,5.35,34.75,3146,3168,24616
1987,7211,29562,34725,1281986,1283659,5255,15.244,4748,13.774,250938,130206,120732,10.143,19.549,253744,116396,137348,9.068,19.767,-2806,-0.219,39.097,3382,3467,67497
1987,7212,3767,4023,25395,24937,536,13.32,538,13.37,7218,2563,4655,10.278,28.946,6280,2601,3679,10.43,25.184,938,3.762,50.368,347,348,1281
1987,7213,3784,3880,20997,20336,318,8.086,423,10.757,4563,1233,3330,6.063,22.439,3375,1615,1760,7.942,16.597,1188,5.842,33.193,280,280,1083
1987,7223,17663,31121,570921,551616,8315,28.445,4536,15.518,163276,101646,61630,18.427,29.6,124575,58714,65861,10.644,22.584,38701,7.016,45.167,2593,2614,28832
1987,7224,52275,53001,313799,311247,8806,16.522,9400,17.637,90682,50341,40341,16.174,29.135,85538,41986,43552,13.49,27.482,5144,1.653,54.965,7541,7577,33441
1987,7225,204571,273314,5198380,5066425,49246,18.33,39934,14.864,1303673,713187,590486,14.077,25.732,1042561,464843,577718,9.175,20.578,261112,5.154,41.156,29890,30578,311212
1987,8111,110585,116925,598933,583403,20252,17.664,15708,13.7,154300,77279,77021,13.246,26.448,122814,56047,66767,9.607,21.051,31486,5.397,42.103,12007,12091,43853
1987,8112,11001,13073,107584,107607,2106,16.443,1576,12.305,24366,11811,12555,10.976,22.644,24225,9019,15206,8.381,22.513,141,0.131,45.025,1103,1105,3454
1987,8113,19746,20732,150160,150945,2952,14.362,2597,12.635,30392,10736,19656,7.113,20.134,31797,11598,20199,7.684,21.065,-1405,-0.931,40.269,1851,1854,7866
1987,8114,25111,26678,158382,157020,4575,17.384,3854,14.644,33690,14806,18884,9.429,21.456,30987,12405,18582,7.9,19.734,2703,1.721,39.469,2908,2913,8554
1987,8121,75502,84129,427470,426362,12718,15.017,13845,16.347,101671,51872,49799,12.166,23.846,99931,51409,48522,12.058,23.438,1740,0.408,46.876,10869,10972,36872
1987,8122,17092,20132,124350,121974,1636,8.138,1577,7.845,22632,6432,16200,5.273,18.555,17890,6282,11608,5.15,14.667,4742,3.888,29.334,1088,1107,4652
1987,8123,33121,39457,362419,357722,5793,14.805,5137,13.128,72276,31923,40353,8.924,20.205,62537,27892,34645,7.797,17.482,9739,2.723,34.964,3717,3855,18946
1987,8129,12801,21146,191049,193421,4409,21.235,3643,17.546,46473,19043,27430,9.845,24.027,50819,25559,25260,13.214,26.274,-4346,-2.247,48.054,2211,2278,13976
1987,8131,126404,126486,1014548,1001155,7203,5.741,5144,4.1,126367,21380,104987,2.136,12.622,99710,16465,83245,1.645,9.96,26657,2.663,19.919,3053,3053,8350
1987,8132,8062,9160,127225,124025,975,10.831,659,7.321,21812,6008,15804,4.844,17.587,15485,4625,10860,3.729,12.485,6327,5.101,24.971,450,459,2883
1987,8133,7417,8530,94721,92723,968,11.54,684,8.155,17711,4884,12827,5.267,19.101,13652,3894,9758,4.2,14.724,4059,4.378,29.447,428,433,2160
1987,8134,29002,30439,263354,260285,2327,7.686,1999,6.603,38800,9246,29554,3.552,14.907,32669,7619,25050,2.927,12.551,6131,2.355,25.103,1353,1353,4984
1987,8139,56034,58316,463761,460381,5051,8.689,4675,8.043,81530,22604,58926,4.91,17.709,75009,20580,54429,4.47,16.293,6521,1.416,32.586,3228,3237,13664
1988,1131,221,231,3194,3102,44,19.298,38,16.667,813,348,465,11.22,26.213,612,357,255,11.511,19.732,201,6.481,39.465,28,28,300
1988,1132,96,111,1980,1946,21,19.355,16,14.747,471,184,287,9.455,24.203,426,154,272,7.914,21.891,45,2.312,43.782,10,10,69
1988,1133,10769,10848,89492,87806,1731,16.096,1544,14.357,22225,7853,14372,8.944,25.312,18822,7513,11309,8.556,21.436,3403,3.876,42.872,1159,1160,4899
1988,1141,1063,1072,7310,7225,205,18.946,225,20.795,3050,1343,1707,18.59,42.217,2886,1555,1331,21.524,39.947,164,2.27,79.895,166,166,821
1988,1142,128,128,961,901,28,22.222,24,19.048,250,118,132,13.097,27.747,131,81,50,8.99,14.539,119,13.208,29.079,22,22,67
1988,1151,3777,4082,52307,50433,624,15.264,636,15.558,18007,8052,9955,15.966,35.705,14224,6799,7425,13.481,28.204,3783,7.501,56.408,351,353,3496
1988,1152,1936,1949,13833,13824,326,16.839,300,15.496,2708,977,1731,7.068,19.59,2675,1144,1531,8.276,19.351,33,0.239,38.702,224,224,727
1988,1153,779,790,10805,10360,155,19.923,131,16.838,3661,1337,2324,12.906,35.34,2773,1281,1492,12.365,26.768,888,8.572,53.535,100,100,924
1988,2111,7155,8701,123537,127270,1030,11.678,1268,14.376,21278,6374,14904,5.008,16.719,28960,9875,19085,7.759,22.755,-7682,-6.036,33.438,805,816,3244
1988,2121,2237,2805,144569,148244,473,16.591,565,19.818,23816,11088,12728,7.48,16.065,31413,11957,19456,8.066,21.19,-7597,-5.125,32.131,409,412,6933
1988,2122,497,639,40271,37821,155,24.84,125,20.032,10014,2107,7907,5.571,26.477,5283,1408,3875,3.723,13.968,4731,12.509,27.937,85,85,480
1988,2123,3526,5057,104391,103473,467,9.262,437,8.667,16224,4024,12200,3.889,15.68,14306,5276,9030,5.099,13.826,1918,1.854,27.652,261,263,1742
1988,2131,8122,9288,161513,160700,1287,13.519,1751,18.393,47369,9958,37411,6.197,29.477,45648,22586,23062,14.055,28.406,1721,1.071,56.812,1077,1087,6397
1988,2211,1701,6007,598373,600369,304,5.083,251,4.197,33577,9089,24488,1.514,5.593,37802,11801,26001,1.966,6.296,-4225,-0.704,11.185,57,135,5130
1988,2212,615,2503,145898,143116,271,10.989,197,7.989,15279,7595,7684,5.307,10.676,10091,3867,6224,2.702,7.051,5188,3.625,14.102,29,29,122
1988,2213,3844,4107,32022,31483,378,9.338,260,6.423,4812,1826,2986,5.8,15.284,3725,1892,1833,6.01,11.832,1087,3.453,23.664,161,163,1139
1988,2361,107414,107802,636587,629725,22423,21.062,19741,18.543,204686,84675,120011,13.446,32.504,191412,80805,110607,12.832,30.396,13274,2.108,60.792,14620,14622,59771
1988,2362,38253,38963,707124,702738,5254,13.492,5209,13.377,189849,36876,152973,5.247,27.016,179654,48141,131513,6.85,25.565,10195,1.451,51.13,3937,3942,32820
1988,2371,13652,13934,303522,304372,1461,10.528,1348,9.714,62727,11711,51016,3.848,20.609,65135,13135,52000,4.315,21.4,-2408,-0.791,41.217,1011,1012,8245
1988,2372,9806,10029,78680,75996,2394,24.144,2167,21.855,30503,15499,15004,20.395,40.138,25316,12405,12911,16.323,33.312,5187,6.825,66.625,1742,1759,9915
1988,2373,9587,9983,265291,260801,1143,11.514,1031,10.386,59122,11609,47513,4.451,22.669,50060,10973,39087,4.207,19.195,9062,3.475,38.389,783,784,7153
1988,2379,5214,5274,80337,83527,811,15.295,868,16.37,19617,6137,13480,7.347,23.486,25961,5264,20697,6.302,31.081,-6344,-7.595,46.972,666,667,3658
1988,2381,76709,77159,742580,735974,12376,16.172,11110,14.518,210069,64923,145146,8.821,28.543,196688,60958,135730,8.283,26.725,13381,1.818,53.45,8403,8407,48003
1988,2382,116913,118911,1249410,1231547,16103,13.71,13188,11.228,270030,69682,200348,5.658,21.926,234726,67212,167514,5.458,19.059,35304,2.867,38.119,10138,10154,52058
1988,2383,79275,79711,667393,664151,15202,19.271,13552,17.179,193383,61646,131737,9.282,29.117,186473,62706,123767,9.442,28.077,6910,1.04,56.154,10372,10374,49403
1988,2389,40563,40796,351350,346095,6743,16.735,5738,14.241,98962,31318,67644,9.049,28.594,88576,30841,57735,8.911,25.593,10386,3.001,51.186,4372,4376,22811
1988,3111,1219,1816,48233,48439,124,6.795,142,7.781,6486,2805,3681,5.791,13.39,7025,3215,3810,6.637,14.503,-539,-1.113,26.78,77,79,1078
1988,3112,474,822,65459,65198,52,6.334,50,6.09,5126,1196,3930,1.834,7.862,4651,1601,3050,2.456,7.134,475,0.729,14.267,28,28,210
1988,3113,1570,1877,87033,85039,222,11.891,202,10.819,11774,2015,9759,2.37,13.845,7976,1913,6063,2.25,9.379,3798,4.466,18.758,131,131,798
1988,3114,1131,1563,169325,169356,130,8.283,143,9.111,25985,8642,17343,5.103,15.343,26112,10657,15455,6.293,15.418,-127,-0.075,30.687,76,77,1920
1988,3115,1506,2151,137183,136426,124,5.656,207,9.441,16917,5849,11068,4.287,12.4,15816,5787,10029,4.242,11.593,1101,0.807,23.186,131,131,1456
1988,3116,3719,4311,358964,349040,348,8.018,406,9.355,48236,13009,35227,3.727,13.82,28178,10198,17980,2.922,8.073,20058,5.747,16.146,309,309,4821
1988,3117,704,815,46368,44866,84,10.487,56,6.991,9664,2606,7058,5.808,21.54,6786,1260,5526,2.808,15.125,2878,6.415,30.25,40,40,784
1988,3118,9245,10754,310279,307882,1480,13.789,1438,13.398,45798,20126,25672,6.537,14.875,41893,16401,25492,5.327,13.607,3905,1.268,27.214,1054,1074,7900
1988,3119,2032,2399,132665,131499,270,11.349,230,9.668,18632,4657,13975,3.541,14.169,16153,5938,10215,4.516,12.284,2479,1.885,24.567,161,162,3403
1988,3121,1784,2290,150625,148733,227,9.956,207,9.079,21585,7757,13828,5.215,14.513,17428,4573,12855,3.075,11.718,4157,2.795,23.435,139,141,2258
1988,3122,94,130,35607,34690,8,6.084,11,8.365,4396,165,4231,0.476,12.672,2485,682,1803,1.966,7.164,1911,5.509,14.327,7,7,89
1988,3131,389,613,112786,111852,42,6.874,38,6.219,12800,5207,7593,4.655,11.444,11191,3076,8115,2.75,10.005,1609,1.439,20.01,24,24,672
1988,3132,1642,1972,258328,251176,178,9.072,158,8.053,30730,16401,14329,6.53,12.234,16955,5189,11766,2.066,6.75,13775,5.484,13.501,107,109,1874
1988,3133,1661,1955,107962,105917,256,13.675,90,4.808,15146,4948,10198,4.672,14.3,11027,2742,8285,2.589,10.411,4119,3.889,20.822,51,51,985
1988,3141,3731,4033,130191,127919,436,10.768,468,11.558,18854,7374,11480,5.765,14.739,14264,5164,9100,4.037,11.151,4590,3.588,22.302,345,359,3499
1988,3149,3683,3803,113730,112796,531,14.245,380,10.195,19870,7143,12727,6.333,17.616,17891,6421,11470,5.693,15.861,1979,1.755,31.723,298,300,4708
1988,3151,1265,1386,137091,138016,150,10.799,156,11.231,16700,6175,10525,4.474,12.1,18626,4712,13914,3.414,13.496,-1926,-1.395,24.2,132,133,3904
1988,3152,11440,12786,782595,792006,2047,15.95,2142,16.691,127565,47910,79655,6.049,16.107,145140,62924,82216,7.945,18.326,-17575,-2.219,32.213,1813,1818,38359
1988,3159,1724,1808,64092,63647,287,16.178,219,12.345,11806,5306,6500,8.337,18.549,10934,3958,6976,6.219,17.179,872,1.37,34.359,178,179,2922
1988,3161,336,364,15186,15136,31,8.659,19,5.307,2401,756,1645,4.995,15.863,2317,588,1729,3.885,15.308,84,0.555,30.617,9,9,79
1988,3162,395,526,83742,82187,44,8.373,43,8.183,11612,2516,9096,3.061,14.129,8394,2787,5607,3.391,10.213,3218,3.915,20.427,27,27,849
1988,3169,1118,1166,37374,37025,128,10.903,144,12.266,6782,2108,4674,5.694,18.318,5945,3034,2911,8.195,16.057,837,2.261,32.114,110,110,796
1988,3211,4632,5138,146691,144426,549,10.782,457,8.975,23198,8585,14613,5.944,16.062,18658,8801,9857,6.094,12.919,4540,3.143,25.838,323,324,3332
1988,3212,1306,1609,106360,105104,173,10.857,142,8.911,13012,5206,7806,4.953,12.38,10418,4090,6328,3.891,9.912,2594,2.468,19.824,100,106,2177
1988,3219,9156,9816,286985,283206,1224,12.587,1041,10.705,47985,16124,31861,5.693,16.943,40450,14586,25864,5.15,14.283,7535,2.661,28.566,809,812,7949
1988,3221,227,543,191050,190320,25,4.625,20,3.7,8958,2795,6163,1.469,4.707,7395,1678,5717,0.882,3.886,1563,0.821,7.771,10,11,438
1988,3222,3624,5205,397752,393274,324,6.245,291,5.609,40045,11048,28997,2.809,10.182,31439,9211,22228,2.342,7.994,8606,2.188,15.988,203,205,4516
1988,3231,41023,42859,831445,818715,4926,11.635,3883,9.172,115675,33853,81822,4.135,14.129,90132,33494,56638,4.091,11.009,25543,3.12,22.018,3135,3140,22117
1988,3241,1315,2189,151050,150064,193,8.841,181,8.291,15654,5402,10252,3.6,10.432,13279,5031,8248,3.353,8.849,2375,1.583,17.698,97,100,2381
1988,3251,1137,2265,229943,224397,204,9.171,123,5.529,31431,8097,23334,3.608,14.007,20811,9134,11677,4.07,9.274,10620,4.733,18.548,42,42,1038
1988,3252,360,629,132873,128783,62,10.09,33,5.37,14102,7793,6309,6.051,10.95,6130,1472,4658,1.143,4.76,7972,6.19,9.52,19,19,431
1988,3253,619,891,41623,41997,64,7.06,95,10.48,4306,1461,2845,3.479,10.253,5062,1904,3158,4.534,12.053,-756,-1.8,20.506,47,50,470
1988,3254,1067,1310,165698,163294,128,9.884,98,7.568,18080,4821,13259,2.952,11.072,13452,4733,8719,2.898,8.238,4628,2.834,16.476,63,64,1796
1988,3255,1620,2122,77302,76457,140,6.602,137,6.461,9004,2366,6638,3.095,11.777,7336,2790,4546,3.649,9.595,1668,2.182,19.19,83,83,1015
1988,3256,2030,2275,116997,115644,205,9.007,207,9.095,15573,3766,11807,3.257,13.466,13089,5602,7487,4.844,11.318,2484,2.148,22.637,146,147,1788
1988,3259,2137,2755,137773,133983,331,12.332,189,7.042,19618,7565,12053,5.646,14.642,12216,2112,10104,1.576,9.118,7402,5.525,18.235,113,115,1196
1988,3261,9816,11686,656927,638974,1093,9.448,858,7.417,102022,27010,75012,4.227,15.967,66640,19172,47468,3,10.429,35382,5.537,20.858,626,631,10453
1988,3262,2086,2518,193008,191481,229,9.12,215,8.562,20191,4745,15446,2.478,10.545,17074,8423,8651,4.399,8.917,3117,1.628,17.834,141,144,1935
1988,3271,1387,1675,83676,81841,201,12.032,192,11.494,12701,3165,9536,3.867,15.519,8681,3287,5394,4.016,10.607,4020,4.912,21.214,141,141,1053
1988,3272,1684,1937,144073,142865,238,12.484,177,9.284,15741,3288,12453,2.301,11.018,13411,5547,7864,3.883,9.387,2330,1.631,18.774,131,131,2526
1988,3273,6662,9050,189947,190263,719,7.976,647,7.178,31840,10518,21322,5.528,16.735,32154,9423,22731,4.953,16.9,-314,-0.165,33.47,437,444,5285
1988,3274,242,335,17766,17612,37,10.963,42,12.444,1942,841,1101,4.775,11.027,1681,596,1085,3.384,9.545,261,1.482,19.09,24,24,310
1988,3279,1888,2175,78478,76893,216,10.009,182,8.434,11495,3158,8337,4.107,14.949,8457,3703,4754,4.816,10.998,3038,3.951,21.997,124,124,1531
1988,3311,306,358,163431,154377,47,13.277,39,11.017,24718,10271,14447,6.653,16.012,6028,1028,5000,0.666,3.905,18690,12.107,7.809,27,27,415
1988,3312,522,702,64248,62334,59,8.429,55,7.857,9088,2503,6585,4.015,14.58,5140,2437,2703,3.91,8.246,3948,6.334,16.492,30,32,619
1988,3313,433,600,102593,102489,44,7.309,48,7.973,10346,3527,6819,3.441,10.095,9809,5360,4449,5.23,9.571,537,0.524,19.142,17,17,303
1988,3314,758,910,81714,80579,92,10.205,75,8.319,10588,4924,5664,6.111,13.14,8336,4125,4211,5.119,10.345,2252,2.795,20.69,43,44,1004
1988,3315,2527,2785,212897,208899,203,7.317,182,6.56,28650,6255,22395,2.994,13.715,21060,9011,12049,4.314,10.081,7590,3.633,20.163,132,134,3545
1988,3321,3294,3491,143353,139512,228,6.546,212,6.087,20559,5448,15111,3.905,14.736,12896,4863,8033,3.486,9.244,7663,5.493,18.487,156,156,2618
1988,3322,1275,1402,77882,77711,110,7.902,90,6.466,8208,1824,6384,2.347,10.562,7982,2276,5706,2.929,10.271,226,0.291,20.543,67,67,1115
1988,3323,10066,10886,339049,336268,904,8.318,869,7.996,52040,13812,38228,4.107,15.476,46211,14960,31251,4.449,13.742,5829,1.733,27.485,638,642,7910
1988,3324,1471,1815,116955,115861,142,7.824,142,7.824,15295,4206,11089,3.63,13.201,13167,3552,9615,3.066,11.365,2128,1.837,22.729,91,91,1314
1988,3325,949,1045,75790,74212,103,10.068,59,5.767,9182,3953,5229,5.327,12.373,6150,1193,4957,1.608,8.287,3032,4.086,16.574,37,37,520
1988,3326,1621,1822,68358,66314,178,9.966,106,5.935,10189,2483,7706,3.744,15.365,5998,2146,3852,3.236,9.045,4191,6.32,18.09,73,73,1087
1988,3327,21274,21553,328270,316902,2181,10.198,1846,8.632,57666,14299,43367,4.512,18.197,34825,13495,21330,4.258,10.989,22841,7.208,21.978,1446,1446,9635
1988,3328,5469,5813,137295,143750,413,7.113,400,6.889,21199,3724,17475,2.591,14.747,33108,7227,25881,5.027,23.032,-11909,-8.285,29.494,305,305,4247
1988,3329,6435,6920,362597,356531,793,11.583,646,9.435,44572,9116,35456,2.557,12.502,32512,12239,20273,3.433,9.119,12060,3.383,18.238,476,477,5228
1988,3331,2902,3161,199000,193735,276,8.72,284,8.973,35739,8829,26910,4.557,18.447,24775,10288,14487,5.31,12.788,10964,5.659,25.576,195,195,1825
1988,3332,4080,4320,167037,164260,385,8.987,313,7.306,24703,5764,18939,3.509,15.039,19101,8593,10508,5.231,11.629,5602,3.41,23.257,238,238,3917
1988,3333,2216,2350,157861,155913,226,9.716,178,7.653,22288,7813,14475,5.011,14.295,18362,7995,10367,5.128,11.777,3926,2.518,23.554,127,127,1902
1988,3334,1639,1887,165395,163960,166,8.785,171,9.05,21012,5738,15274,3.5,12.815,17851,7193,10658,4.387,10.887,3161,1.928,21.775,115,115,2825
1988,3335,9243,9577,219630,216009,621,6.479,638,6.656,30608,6923,23685,3.205,14.17,23508,7382,16126,3.417,10.883,7100,3.287,21.766,477,479,2860
1988,3336,749,893,128376,128498,51,5.698,55,6.145,14513,3698,10815,2.878,11.294,14596,4933,9663,3.839,11.359,-83,-0.065,22.589,33,33,3497
1988,3339,5384,5967,320350,314486,456,7.675,404,6.8,44690,12165,32525,3.868,14.21,33225,13463,19762,4.281,10.565,11465,3.646,21.13,280,283,3555
1988,3341,1597,1738,272243,274068,299,17.588,223,13.118,40019,9385,30634,3.424,14.602,43358,15583,27775,5.686,15.82,-3339,-1.218,29.204,156,159,3126
1988,3342,1472,1662,248622,245293,198,12.291,96,5.959,34842,11510,23332,4.692,14.204,28051,8226,19825,3.354,11.436,6791,2.769,22.871,55,55,1998
1988,3343,379,400,31652,31915,58,14.777,43,10.955,4026,1394,2632,4.368,12.615,4317,785,3532,2.46,13.527,-291,-0.912,25.23,30,30,524
1988,3344,4614,5226,529377,524589,736,14.375,524,10.234,69470,18916,50554,3.606,13.243,60180,20537,39643,3.915,11.472,9290,1.771,22.944,374,375,5280
1988,3345,4476,5125,678517,680939,554,10.869,498,9.77,63169,23276,39893,3.418,9.277,68489,23717,44772,3.483,10.058,-5320,-0.781,18.553,340,345,5948
1988,3346,743,786,56860,49652,139,18.075,105,13.654,19094,4772,14322,9.611,38.456,5150,1948,3202,3.923,10.372,13944,28.084,20.745,75,75,661
1988,3351,1172,1299,85788,85782,113,8.716,108,8.33,7764,1516,6248,1.767,9.051,7661,2128,5533,2.481,8.931,103,0.12,17.862,76,77,1180
1988,3352,324,410,114568,114575,50,12.27,45,11.043,16174,7530,8644,6.572,14.117,16303,10537,5766,9.197,14.229,-129,-0.113,28.233,26,27,1966
1988,3353,2119,2585,233020,232538,197,7.624,195,7.546,25519,7674,17845,3.3,10.974,24416,7109,17307,3.057,10.5,1103,0.474,21,127,127,1171
1988,3359,2229,2581,202202,197587,262,10.193,241,9.376,35261,12266,22995,6.208,17.846,25416,11109,14307,5.622,12.863,9845,4.983,25.726,159,161,3422
1988,3361,223,282,239077,244392,39,13.805,40,14.159,17286,2169,15117,0.888,7.073,28832,2074,26758,0.849,11.797,-11546,-4.724,14.146,31,31,346
1988,3362,1873,2086,130032,126428,225,10.83,208,10.012,21589,7918,13671,6.263,17.076,14540,5237,9303,4.142,11.501,7049,5.576,23.001,167,167,3381
1988,3363,3982,4813,656280,659319,485,10.231,340,7.172,60281,18290,41991,2.774,9.143,66525,16331,50194,2.477,10.09,-6244,-0.947,18.286,232,233,6312
1988,3364,1402,1696,681635,673739,155,9.204,131,7.779,78436,29641,48795,4.399,11.642,64401,27988,36413,4.154,9.559,14035,2.083,19.118,83,83,894
1988,3365,165,196,27632,25891,31,16.23,21,10.995,6353,2453,3900,9.474,24.537,2855,983,1872,3.797,11.027,3498,13.51,22.054,11,11,390
1988,3366,1249,1348,168035,162060,175,13.173,136,10.237,28019,6465,21554,3.989,17.289,16134,3647,12487,2.25,9.956,11885,7.334,19.911,99,100,2385
1988,3369,481,494,31501,30909,65,13.333,52,10.667,4461,815,3646,2.637,14.433,3315,555,2760,1.796,10.725,1146,3.708,21.45,40,40,435
1988,3371,13277,13954,406588,401649,1950,14.097,1708,12.347,65231,23429,41802,5.833,16.241,55356,22671,32685,5.644,13.782,9875,2.459,27.564,1353,1358,13548
1988,3372,2969,3152,162611,158522,365,11.789,253,8.172,26236,9379,16857,5.917,16.55,18159,7192,10967,4.537,11.455,8077,5.095,22.91,188,188,2982
1988,3379,1092,1249,41883,41620,116,9.408,84,6.813,5565,1495,4070,3.592,13.371,5126,1125,4001,2.703,12.316,439,1.055,24.633,61,61,679
1988,3391,10458,11005,246671,241146,1163,10.582,1133,10.309,37603,10495,27108,4.352,15.593,27003,7110,19893,2.948,11.198,10600,4.396,22.396,859,860,3747
1988,3399,15520,16055,415827,407511,2229,14.079,1783,11.262,71191,19596,51595,4.809,17.47,54878,19624,35254,4.816,13.467,16313,4.003,26.933,1439,1446,14194
1988,4231,21741,26692,309789,310511,2717,10.074,3272,12.132,51353,16265,35088,5.238,16.538,52859,22226,30633,7.158,17.023,-1506,-0.485,33.076,2126,2272,12899
1988,4232,8492,9719,121579,118222,1371,14.283,1131,11.782,26741,9104,17637,7.701,22.619,19873,7306,12567,6.18,16.81,6868,5.809,33.62,857,878,5107
1988,4233,8402,10840,145903,142565,1313,12.269,1037,9.69,27249,8522,18727,5.978,19.113,20548,6731,13817,4.721,14.413,6701,4.7,28.826,756,769,4342
1988,4234,25594,35089,621040,614341,4586,13.185,3970,11.414,118834,36036,82798,5.866,19.343,105903,50287,55616,8.186,17.238,12931,2.105,34.477,2436,2528,15852
1988,4235,6970,9214,138411,134728,958,10.467,836,9.134,25055,7154,17901,5.31,18.597,17443,6476,10967,4.807,12.947,7612,5.65,25.894,500,522,3210
1988,4236,15902,23077,325609,319410,3023,13.269,2434,10.684,63001,23917,39084,7.488,19.724,50881,23289,27592,7.291,15.93,12120,3.795,31.859,1402,1449,10154
1988,4237,11218,15278,168168,166360,1475,9.747,1185,7.831,25761,8080,17681,4.857,15.485,22306,7414,14892,4.457,13.408,3455,2.077,26.817,815,871,4557
1988,4238,47681,61967,659117,650052,6064,9.834,5462,8.857,113979,38331,75648,5.897,17.534,96471,36931,59540,5.681,14.841,17508,2.693,29.681,3446,3574,19183
1988,4239,24976,26629,257264,249632,4239,16.125,3559,13.538,59588,19815,39773,7.938,23.87,43955,19098,24857,7.65,17.608,15633,6.262,35.216,2825,2836,13335
1988,4241,8647,11662,171881,169587,1411,12.37,901,7.899,31734,10036,21698,5.918,18.713,26548,7277,19271,4.291,15.655,5186,3.058,31.309,588,596,3386
1988,4242,3022,3904,111184,109097,574,14.798,524,13.509,21406,7853,13553,7.198,19.621,17816,6519,11297,5.975,16.33,3590,3.291,32.661,333,335,2126
1988,4243,11815,12712,153161,153220,1945,15.416,1755,13.91,32956,10911,22045,7.121,21.509,33162,12793,20369,8.349,21.643,-206,-0.134,43.018,1364,1371,7771
1988,4244,27520,34020,675665,676766,3928,11.561,3839,11.299,114534,34701,79833,5.127,16.924,117680,52514,65166,7.76,17.389,-3146,-0.465,33.847,2822,2849,34021
1988,4245,7196,10152,89105,89664,716,7.045,739,7.271,14806,4312,10494,4.809,16.513,15874,4746,11128,5.293,17.704,-1068,-1.191,33.026,449,464,3013
1988,4246,7598,11058,127299,126260,1395,12.801,1074,9.855,24003,8192,15811,6.488,19.011,21656,8011,13645,6.345,17.152,2347,1.859,34.304,593,632,3999
1988,4247,9703,12844,135499,139619,1049,8.123,1189,9.207,22825,6375,16450,4.566,16.348,31208,9120,22088,6.532,22.352,-8383,-6.004,32.696,724,734,4950
1988,4248,3950,5062,138946,140110,326,6.379,423,8.277,14952,3799,11153,2.711,10.672,17246,5115,12131,3.651,12.309,-2294,-1.637,21.343,300,308,2803
1988,4249,21086,25446,297045,292469,3531,13.98,3153,12.484,56502,19293,37209,6.597,19.319,47493,17699,29794,6.052,16.239,9009,3.08,32.477,2182,2230,10718
1988,4251,31216,33680,323188,315929,3991,11.991,3199,9.611,68696,27969,40727,8.853,21.744,54274,19755,34519,6.253,17.179,14422,4.565,34.358,2145,2151,10676
1988,4411,39050,40909,1010740,1001360,4741,11.676,4133,10.179,141821,56855,84966,5.678,14.163,123112,45859,77253,4.58,12.294,18709,1.868,24.589,3358,3387,36070
1988,4412,11460,12137,92667,91701,1362,11.246,1311,10.824,18988,6626,12362,7.226,20.707,17074,6362,10712,6.938,18.619,1914,2.087,37.239,1058,1065,5073
1988,4413,49712,73794,527604,526085,6391,8.618,7126,9.609,94954,35142,59812,6.68,18.049,91353,31558,59795,5.999,17.365,3601,0.684,34.729,4689,5003,19909
1988,4421,22089,28291,240771,239287,3333,11.876,2880,10.262,45725,17376,28349,7.262,19.109,42757,15835,26922,6.618,17.869,2968,1.24,35.737,2060,2185,11115
1988,4422,23012,28811,184222,177341,4222,14.909,3236,11.427,45810,20732,25078,11.691,25.832,31943,12525,19418,7.063,18.012,13867,7.819,36.024,2220,2329,8281
1988,4431,21540,29793,210955,201614,5605,19.573,3291,11.493,56349,30473,25876,15.115,27.949,37521,16039,21482,7.955,18.61,18828,9.339,37.221,2130,2228,9804
1988,4441,55480,71425,778771,770991,6429,9.016,6195,8.688,131073,48110,82963,6.24,17.001,116104,41308,74796,5.358,15.059,14969,1.942,30.118,4257,4382,22281
1988,4442,16226,19733,151027,147843,2079,10.633,1716,8.777,30683,9125,21558,6.172,20.754,24144,7658,16486,5.18,16.331,6539,4.423,32.662,1163,1185,5024
1988,4451,63533,96133,2264911,2222845,12716,13.266,12156,12.682,409656,201159,208497,9.05,18.429,326659,136670,189989,6.148,14.696,82997,3.734,29.391,7779,8076,52408
1988,4452,21462,25803,165511,167131,3706,14.279,4007,15.439,38898,18410,20488,11.015,23.274,42577,17827,24750,10.667,25.475,-3679,-2.201,46.548,3094,3135,12917
1988,4453,27120,32106,154337,156054,3625,11.24,3916,12.142,29465,13299,16166,8.522,18.881,32935,13603,19332,8.717,21.105,-3470,-2.224,37.763,2919,2977,10412
1988,4461,48186,75585,709693,705261,8089,10.819,6455,8.633,130935,58237,72698,8.258,18.565,121438,42701,78737,6.055,17.219,9497,1.347,34.438,3931,4056,19771
1988,4471,86583,137694,954696,950958,16941,12.377,15312,11.186,215163,100371,114792,10.555,22.626,207229,80009,127220,8.414,21.792,7934,0.834,43.583,9485,9919,46078
1988,4481,55362,104317,950300,938432,14577,14.115,12495,12.099,223720,100626,123094,10.723,23.84,196954,66388,130566,7.074,20.988,26766,2.852,41.975,7303,7839,33056
1988,4482,11143,37173,203229,201717,4176,11.268,3951,10.661,44869,21218,23651,10.519,22.244,41839,15619,26220,7.743,20.741,3030,1.502,41.483,1634,1771,6300
1988,4483,19145,28764,176173,174305,3811,13.415,3100,10.912,39756,16464,23292,9.446,22.808,36721,12777,23944,7.33,21.067,3035,1.741,42.134,1914,2012,6937
1988,4511,32565,42572,310700,302642,6207,14.716,5422,12.855,71383,32157,39226,10.625,23.587,55379,21827,33552,7.212,18.299,16004,5.288,36.597,3899,4059,13457
1988,4512,8272,12685,88225,85416,1744,13.969,1344,10.765,20077,7650,12427,8.956,23.505,14597,5566,9031,6.516,17.089,5480,6.416,34.179,901,946,3583
1988,4522,228,6416,1179874,1151715,362,5.737,150,2.377,148310,46892,101418,4.071,12.877,93068,22607,70461,1.963,8.081,55242,4.797,16.162,13,15,4366
1988,4523,11614,27526,898483,873561,3001,10.941,2806,10.23,151122,73894,77228,8.459,17.3,103125,42947,60178,4.916,11.805,47997,5.494,23.61,1535,1646,10194
1988,4531,23513,25019,128193,126200,3590,14.538,2939,11.902,27883,10705,17178,8.483,22.094,23721,9206,14515,7.295,18.796,4162,3.298,37.593,2164,2210,6873
1988,4532,30502,38433,238197,230474,6802,18.176,4783,12.781,61119,27945,33174,12.125,26.519,45916,19629,26287,8.517,19.922,15203,6.596,39.845,3397,3618,14252
1988,4533,9427,11359,60467,58816,1995,17.753,1752,15.591,14341,7400,6941,12.582,24.383,11250,4156,7094,7.066,19.128,3091,5.255,38.255,1166,1180,2651
1988,4539,23777,27500,144082,140920,4758,17.529,4044,14.899,39893,18456,21437,13.097,28.309,33555,16063,17492,11.399,23.811,6338,4.498,47.623,2838,3078,12054
1988,4541,5524,6863,112879,106090,971,14.383,747,11.065,32003,13465,18538,12.692,30.166,17696,7830,9866,7.381,16.68,14307,13.486,33.361,569,578,4144
1988,4542,4019,4950,76858,74212,679,13.885,559,11.431,17533,5719,11814,7.706,23.626,12197,6266,5931,8.443,16.435,5336,7.19,32.871,374,378,4014
1988,4543,16249,22263,223900,220958,2477,11.195,2201,9.948,46758,13036,33722,5.9,21.161,40418,15317,25101,6.932,18.292,6340,2.869,36.584,1368,1397,6946
1988,4811,683,2697,425668,407062,318,11.771,327,12.104,69625,6977,62648,1.714,17.104,31023,9974,21049,2.45,7.621,38602,9.483,15.242,111,137,8294
1988,4812,842,906,12082,11671,167,18.87,125,14.124,2803,1006,1797,8.62,24.017,2071,1227,844,10.513,17.745,732,6.272,35.49,47,47,343
1988,4831,330,605,37692,34683,82,13.443,92,15.082,11237,845,10392,2.436,32.4,5161,3208,1953,9.25,14.881,6076,17.519,29.761,26,26,213
1988,4832,307,340,11701,12430,38,11.063,45,13.1,1629,284,1345,2.285,13.105,3087,925,2162,7.442,24.835,-1458,-11.73,26.211,32,32,410
1988,4841,20484,26708,571148,547001,4919,18.818,3782,14.469,138477,45536,92941,8.325,25.316,89131,33532,55599,6.13,16.294,49346,9.021,32.589,2843,2871,19032
1988,4842,47830,52446,566594,558659,8711,16.63,8581,16.382,136245,51813,84432,9.275,24.388,119943,46064,73879,8.245,21.47,16302,2.918,42.94,6646,6713,30330
1988,4851,377,397,34296,35096,60,15.424,44,11.311,1841,566,1275,1.613,5.246,3419,1499,1920,4.271,9.742,-1578,-4.496,10.491,34,34,1007
1988,4852,327,525,18372,19467,68,11.857,165,28.771,3067,1220,1847,6.267,15.755,5332,2324,3008,11.938,27.39,-2265,-11.635,31.51,32,32,254
1988,4853,4994,5042,55425,55555,951,18.946,906,18.05,11395,4942,6453,8.896,20.511,11735,5430,6305,9.774,21.123,-340,-0.612,41.022,753,753,4368
1988,4854,3238,3603,103975,102565,451,12.649,376,10.546,23051,11562,11489,11.273,22.475,19891,8851,11040,8.63,19.394,3160,3.081,38.787,283,293,6732
1988,4855,732,778,18215,17843,138,17.98,117,15.244,4301,2017,2284,11.304,24.105,3628,1689,1939,9.466,20.333,673,3.772,40.667,80,85,946
1988,4859,1007,1030,22500,21890,220,21.505,206,20.137,5340,1936,3404,8.844,24.395,4162,2310,1852,10.553,19.014,1178,5.382,38.027,149,149,1506
1988,4861,62,300,9600,9411,42,14.261,31,10.526,1388,683,705,7.257,14.749,1098,624,474,6.631,11.667,290,3.082,23.334,8,9,201
1988,4862,246,1316,55726,57291,142,10.709,162,12.217,6976,2175,4801,3.796,12.177,9967,2602,7365,4.542,17.397,-2991,-5.221,24.353,27,27,177
1988,4869,62,374,8001,7788,59,16.55,24,6.732,1601,503,1098,6.459,20.557,1186,406,780,5.213,15.229,415,5.329,30.457,4,4,142
1988,4871,252,258,4726,4586,68,27.869,40,16.393,1156,441,715,9.617,25.21,921,191,730,4.165,20.085,235,5.125,40.17,30,30,125
1988,4872,687,698,6379,6452,139,20.411,105,15.419,1666,697,969,10.803,25.821,1817,747,1070,11.578,28.162,-151,-2.34,51.643,78,78,571
1988,4879,90,93,642,582,19,20.765,16,17.486,206,114,92,19.604,35.426,89,35,54,6.019,15.305,117,20.12,30.61,10,10,24
1988,4881,2169,2739,75115,73236,413,14.994,444,16.119,15890,4822,11068,6.584,21.697,12444,5688,6756,7.767,16.992,3446,4.705,33.983,252,252,2277
1988,4882,383,582,14804,14146,150,27.447,79,14.456,3515,1428,2087,10.095,24.848,2197,1110,1087,7.847,15.531,1318,9.317,31.062,48,48,463
1988,4883,2035,2484,84367,85880,354,14.309,334,13.5,21320,9037,12283,10.523,24.825,24178,9318,14860,10.85,28.153,-2858,-3.328,49.651,249,250,3815
1988,4884,1000,1090,8618,8275,612,68.495,219,24.51,3870,2740,1130,33.112,46.767,3322,2014,1308,24.338,40.145,548,6.622,80.29,93,93,626
1988,4885,6785,9173,104417,101460,1617,18.28,962,10.876,27018,12148,14870,11.973,26.629,20788,7276,13512,7.171,20.489,6230,6.14,40.978,705,718,4805
1988,4889,587,613,7194,6806,141,24.373,72,12.446,2245,647,1598,9.506,32.986,1434,640,794,9.403,21.07,811,11.916,42.139,60,60,574
1988,4921,1355,3651,299046,286800,914,26.776,439,12.861,56397,22560,33837,7.866,19.664,29397,7625,21772,2.659,10.25,27000,9.414,20.5,232,236,3536
1988,4922,3856,4141,60895,58222,798,19.687,623,15.369,16674,6497,10177,11.159,28.639,11495,4011,7484,6.889,19.743,5179,8.895,39.487,513,514,2966
1988,4931,6277,9866,413501,408158,1116,11.331,1083,10.995,79740,25070,54670,6.142,19.537,68996,24629,44367,6.034,16.904,10744,2.632,33.809,387,398,3265
1988,5111,14033,16412,680352,677369,1945,11.977,1601,9.858,71549,23758,47791,3.507,10.563,65605,22169,43436,3.273,9.685,5944,0.878,19.371,1249,1253,12723
1988,5112,2875,3258,57530,55372,810,26.154,488,15.757,16415,6366,10049,11.497,29.645,12103,5811,6292,10.495,21.858,4312,7.787,43.716,332,336,2709
1988,5121,9496,14120,228259,226321,2270,15.897,2588,18.125,75357,33679,41678,14.881,33.297,71965,25489,46476,11.262,31.798,3392,1.499,63.596,1498,1629,9824
1988,5122,2136,2152,15366,14976,669,33.135,403,19.96,5587,3252,2335,21.715,37.306,4860,2424,2436,16.186,32.452,727,4.854,64.904,328,328,1425
1988,5151,6032,7513,235180,231748,998,13.394,874,11.73,41391,20463,20928,8.83,17.86,34590,16965,17625,7.32,14.926,6801,2.935,29.851,642,647,9605
1988,5152,220,315,10766,9774,64,22.456,4,1.404,3107,1182,1925,12.093,31.788,1168,12,1156,0.123,11.95,1939,19.838,23.9,3,3,10
1988,5173,5016,22096,1027179,1019095,2194,9.859,2511,11.283,101504,36149,65355,3.547,9.96,86388,20650,65738,2.026,8.477,15116,1.483,16.954,441,449,4850
1988,5174,164,284,11334,15241,52,14.525,200,55.866,2451,946,1505,6.207,16.082,10319,7671,2648,50.331,67.706,-7868,-51.624,32.163,85,86,2789
1988,5179,792,1449,42522,44949,323,20.798,531,34.192,5392,2131,3261,4.741,11.996,10288,6331,3957,14.085,22.888,-4896,-10.892,23.992,212,212,1853
1988,5182,5459,7283,257504,250527,1146,15.846,1044,14.436,63247,26120,37127,10.426,25.246,48878,18797,30081,7.503,19.51,14369,5.736,39.02,650,659,5866
1988,5191,2433,2888,33161,35054,395,13.997,263,9.32,5461,2137,3324,6.096,15.579,9521,6453,3068,18.409,27.161,-4060,-11.582,31.158,183,183,1356
1988,5211,47,86,24861,24750,4,4.678,3,3.509,927,45,882,0.182,3.745,731,26,705,0.105,2.954,196,0.792,5.907,(D),(D),(D)
1988,5221,16817,73593,1957348,1965164,5721,7.882,3699,5.096,272268,100723,171545,5.125,13.855,286691,73589,213102,3.745,14.589,-14423,-0.734,27.709,916,981,25074
1988,5222,23120,42147,569543,575073,4762,11.347,4401,10.487,104108,44272,59836,7.699,18.103,114735,45140,69595,7.849,19.951,-10627,-1.848,36.207,1686,1788,11167
1988,5223,4940,5628,59729,59484,1551,29.289,886,16.731,16535,9677,6858,16.268,27.798,16062,7227,8835,12.15,27.002,473,0.795,54.005,630,639,4160
1988,5231,6754,13555,337288,353296,2170,16.002,2181,16.083,58465,20481,37984,5.797,16.548,87640,26827,60813,7.593,24.806,-29175,-8.258,33.097,965,999,8963
1988,5232,98,112,7674,7366,10,8.439,23,19.409,1164,28,1136,0.38,15.803,571,66,505,0.896,7.752,593,8.051,15.505,13,13,39
1988,5239,15224,15857,188313,176600,3329,21.227,2981,19.008,59780,21752,38028,12.317,33.851,36871,18364,18507,10.399,20.878,22909,12.972,41.757,2356,2357,10907
1988,5241,6905,36656,1354638,1353742,5684,16.236,2389,6.824,213812,50199,163613,3.708,15.794,208686,52733,155953,3.895,15.415,5126,0.379,30.831,433,438,12624
1988,5242,100628,105831,770378,766576,13485,12.827,12090,11.5,157647,67893,89754,8.857,20.565,151668,64360,87308,8.396,19.785,5979,0.78,39.57,8973,8987,42534
1988,5259,844,1054,14330,13432,96,8.968,129,12.05,3528,1427,2101,10.624,26.267,1727,991,736,7.378,12.858,1801,13.409,25.716,97,98,665
1988,5311,95121,98975,543490,536292,13708,14.001,11578,11.825,125676,61467,64209,11.461,23.434,110614,47659,62955,8.887,20.626,15062,2.809,41.251,9070,9140,35632
1988,5312,40125,42654,241165,242176,7508,17.834,6397,15.195,64331,30971,33360,12.789,26.564,66126,29101,37025,12.016,27.305,-1795,-0.741,53.128,4795,4802,17695
1988,5313,25055,26476,310586,302395,4969,19.077,4110,15.779,81590,36992,44598,12.233,26.981,65039,30873,34166,10.21,21.508,16551,5.473,43.016,3119,3126,20389
1988,5321,5922,10817,143231,138654,2104,20.073,1434,13.681,32852,15316,17536,11.046,23.694,23319,9440,13879,6.808,16.818,9533,6.875,33.636,869,893,4964
1988,5322,20317,25034,157000,148071,5293,22.003,3336,13.868,53528,24931,28597,16.837,36.15,35742,15026,20716,10.148,24.138,17786,12.012,48.277,2529,2619,10854
1988,5323,4295,5755,40052,38938,1006,17.959,699,12.479,11505,4932,6573,12.666,29.547,9257,3946,5311,10.134,23.774,2248,5.773,47.548,504,525,2896
1988,5324,8221,10235,111926,110402,1773,17.717,1318,13.17,27390,9360,18030,8.478,24.809,24267,8503,15764,7.702,21.981,3123,2.829,43.961,954,987,5711
1988,5331,928,1009,13929,13128,276,29.237,146,15.466,5839,3515,2324,26.776,44.479,4329,1466,2863,11.167,32.977,1510,11.503,65.953,100,100,713
1988,5411,132003,136977,902380,882189,15918,11.746,13001,9.594,161842,54159,107683,6.139,18.346,121358,45098,76260,5.112,13.756,40484,4.589,27.513,9509,9590,31937
1988,5412,67178,71433,631065,608437,11374,16.142,9435,13.39,140424,49202,91222,8.087,23.079,95545,40518,55027,6.659,15.703,44879,7.376,31.407,6936,7019,29975
1988,5413,59497,66114,898678,869877,10393,16.006,8026,12.361,200549,64795,135754,7.449,23.055,141605,47590,94015,5.471,16.279,58944,6.776,32.557,5830,5882,25343
1988,5414,15178,15407,94938,92855,3079,20.522,2272,15.143,25276,12646,12630,13.619,27.221,21037,10593,10444,11.408,22.656,4239,4.565,45.312,1795,1801,7092
1988,5415,19784,22439,336715,321786,5838,27.423,3538,16.619,91449,37767,53682,11.737,28.419,61445,26878,34567,8.353,19.095,30004,9.324,38.19,2593,2610,12643
1988,5416,41867,43641,356503,332210,11887,28.396,8328,19.894,131958,61857,70101,18.62,39.721,83290,41487,41803,12.488,25.072,48668,14.65,50.143,6577,6615,31129
1988,5417,6721,8196,444395,436784,1275,15.827,995,12.351,68470,15789,52681,3.615,15.676,53654,18618,35036,4.263,12.284,14816,3.392,24.568,637,642,5313
1988,5418,26372,28602,341970,336673,5175,18.477,3987,14.235,80952,35196,45756,10.454,24.045,69895,31930,37965,9.484,20.761,11057,3.284,41.521,3007,3034,16390
1988,5419,31960,35612,270151,263673,4530,12.915,3456,9.853,59422,20820,38602,7.896,22.536,46669,16529,30140,6.269,17.7,12753,4.837,35.399,2477,2530,11024
1988,5511,25499,47370,3131313,3089866,8124,17.681,5279,11.489,704918,215770,489148,6.983,22.814,620331,188462,431869,6.099,20.076,84587,2.738,40.153,868,919,14203
1988,5611,12778,13613,237395,228031,2542,19.024,2040,15.267,70857,29371,41486,12.88,31.073,51925,22485,29440,9.861,22.771,18932,8.302,45.542,1567,1581,14595
1988,5612,430,597,64249,60982,133,23.623,65,11.545,13892,5967,7925,9.785,22.781,7096,2074,5022,3.401,11.636,6796,11.144,23.273,42,42,1237
1988,5613,16586,22717,1326428,1206363,4665,21.388,2853,13.081,524276,136138,388138,11.285,43.459,283056,78370,204686,6.496,23.464,241220,19.996,46.927,1936,1983,42542
1988,5614,21277,24135,284919,273352,4314,18.224,3389,14.316,74830,30897,43933,11.303,27.375,51737,22024,29713,8.057,18.927,23093,8.448,37.854,2635,2659,12807
1988,5615,23518,27929,218079,211336,4070,14.902,2836,10.384,52612,21546,31066,10.195,24.895,39188,14850,24338,7.027,18.543,13424,6.352,37.086,2102,2155,10699
1988,5616,12155,14959,486326,464702,2458,16.581,2188,14.76,143742,64746,78996,13.933,30.932,99145,50325,48820,10.83,21.335,44597,9.597,42.67,1563,1567,18432
1988,5617,78745,82600,1024878,996679,19062,23.853,13691,17.132,277231,107269,169962,10.763,27.815,220219,89168,131051,8.947,22.095,57012,5.72,44.191,10611,10665,62054
1988,5619,14064,15175,205560,200233,2862,19.218,2297,15.424,59453,24596,34857,12.284,29.692,47926,17370,30556,8.675,23.935,11527,5.757,47.87,1718,1736,11118
1988,5621,2793,2881,32403,30027,422,15.472,115,4.216,7480,3678,3802,12.249,24.911,2680,819,1861,2.728,8.925,4800,15.986,17.851,72,73,528
1988,5622,1757,2490,63259,61203,425,17.555,287,11.855,13794,5845,7949,9.55,22.538,9383,4847,4536,7.92,15.331,4411,7.207,30.662,174,206,3545
1988,5629,4786,5074,54676,51676,846,16.942,685,13.718,15538,5768,9770,11.162,30.068,9443,3872,5571,7.493,18.274,6095,11.795,36.547,500,514,2439
1988,6111,13404,14478,440296,435626,687,4.76,597,4.136,40848,7546,33302,1.732,9.377,31463,6905,24558,1.585,7.222,9385,2.154,14.445,436,441,5480
1988,6112,494,687,53603,52786,60,8.863,40,5.908,8618,2457,6161,4.655,16.326,6910,943,5967,1.786,13.091,1708,3.236,26.181,17,22,331
1988,6113,1993,2324,973001,968667,91,3.921,85,3.662,73706,2859,70847,0.295,7.609,64643,2120,62523,0.219,6.673,9063,0.936,13.347,54,54,859
1988,6114,2410,2930,48234,46092,555,19.532,378,13.303,12642,3534,9108,7.667,27.428,8290,4235,4055,9.188,17.986,4352,9.442,35.972,267,273,3302
1988,6115,3943,4780,65775,62079,690,14.847,425,9.145,16453,4480,11973,7.217,26.504,9154,2440,6714,3.931,14.746,7299,11.758,29.492,289,301,1720
1988,6116,11559,12206,93075,89978,2560,21.68,1764,14.939,25453,11297,14156,12.555,28.288,19460,8719,10741,9.69,21.628,5993,6.661,43.255,1362,1372,6237
1988,6117,1636,1693,17319,16846,359,21.877,255,15.539,4292,1634,2658,9.7,25.478,3409,1212,2197,7.195,20.236,883,5.242,40.473,198,199,873
1988,6211,183247,192554,1256404,1251516,15383,8.01,14393,7.494,224817,74759,150058,5.973,17.964,215102,64583,150519,5.16,17.187,9715,0.776,34.375,11335,11509,49060
1988,6212,98560,101418,505547,498895,6220,6.174,4889,4.852,78945,23093,55852,4.629,15.824,65701,16597,49104,3.327,13.169,13244,2.655,26.339,3757,3802,13122
1988,6213,52016,54619,206154,197145,8037,15.185,4651,8.788,52675,23497,29178,11.919,26.719,34770,13529,21241,6.862,17.637,17905,9.082,35.274,3264,3308,9798
1988,6214,7450,11201,189818,184765,1596,14.626,1018,9.329,42733,15775,26958,8.538,23.128,32431,11899,20532,6.44,17.553,10302,5.576,35.105,630,641,7182
1988,6215,5142,6496,93814,90692,1048,16.602,681,10.788,19697,7445,12252,8.209,21.719,13528,5538,7990,6.106,14.917,6169,6.802,29.833,447,457,3189
1988,6216,4745,6945,314632,305393,1528,23.136,847,12.825,86759,28911,57848,9.467,28.409,68236,25005,43231,8.188,22.344,18523,6.065,44.687,502,527,9518
1988,6219,5279,6103,119038,114136,1225,20.686,863,14.573,32825,11931,20894,10.453,28.76,23171,12021,11150,10.532,20.301,9654,8.458,40.602,608,619,6490
1988,6221,3756,5170,3637670,3598175,208,3.994,284,5.453,312126,99532,212594,2.766,8.675,233404,115999,117405,3.224,6.487,78722,2.188,12.973,138,150,68903
1988,6222,525,840,301735,295645,73,8.87,39,4.739,26006,11309,14697,3.825,8.796,13758,6540,7218,2.212,4.654,12248,4.143,9.307,20,20,3987
1988,6223,206,251,95805,94503,21,8.333,23,9.127,8038,2205,5833,2.333,8.506,5274,3302,1972,3.494,5.581,2764,2.925,11.162,10,10,883
1988,6231,8065,13482,1150196,1134424,1141,8.533,921,6.888,158340,68267,90073,6.018,13.958,127847,50098,77749,4.416,11.27,30493,2.688,22.54,520,538,27186
1988,6232,5410,8526,192041,182939,1617,20.435,391,4.941,42798,20516,22282,11.215,23.395,24622,6912,17710,3.778,13.459,18176,9.936,26.918,222,228,4085
1988,6233,8770,10369,262234,256743,1779,17.753,1083,10.807,49779,23525,26254,9.163,19.389,38825,18008,20817,7.014,15.122,10954,4.267,30.244,737,749,11656
1988,6239,3363,4336,108973,106259,576,13.749,283,6.755,18858,5985,12873,5.632,17.747,13375,4359,9016,4.102,12.587,5483,5.16,25.174,178,181,3131
1988,6241,16995,22675,323637,315246,2774,12.591,1486,6.745,59613,18987,40626,6.023,18.91,43051,10284,32767,3.262,13.656,16562,5.254,27.313,846,859,5961
1988,6242,4795,5647,55639,53373,668,12.199,326,5.953,11602,4055,7547,7.598,21.738,7108,1718,5390,3.219,13.318,4494,8.42,26.635,173,175,1009
1988,6243,4532,6705,266675,263173,636,9.631,433,6.557,47028,8185,38843,3.11,17.87,39378,5909,33469,2.245,14.963,7650,2.907,29.926,196,202,2218
1988,6244,32986,39553,372842,361271,5469,14.124,3803,9.822,80078,33748,46330,9.341,22.166,56890,21512,35378,5.955,15.747,23188,6.418,31.494,2861,2919,15599
1988,7111,5124,5182,77222,75333,898,17.301,915,17.628,24484,5351,19133,7.103,32.501,20259,6908,13351,9.17,26.893,4225,5.608,53.786,677,679,5413
1988,7112,2422,2557,73523,73612,463,18.329,401,15.875,17429,4553,12876,6.185,23.677,17711,3754,13957,5.1,24.06,-282,-0.383,47.354,289,290,2124
1988,7113,2236,2291,34083,33609,433,19.125,379,16.74,8875,2744,6131,8.165,26.407,7802,3037,4765,9.036,23.214,1073,3.193,46.429,277,278,2058
1988,7114,1180,1198,11473,11217,261,22.795,155,13.537,3526,1470,2056,13.105,31.434,3000,1080,1920,9.628,26.745,526,4.689,53.49,118,119,824
1988,7115,10545,10575,63777,55753,3899,39.818,2333,23.826,34345,23438,10907,42.039,61.603,18258,8888,9370,15.942,32.748,16087,28.854,65.497,1737,1742,6181
1988,7121,2817,3036,57651,55293,308,10.384,168,5.664,9185,1423,7762,2.574,16.612,4592,1219,3373,2.205,8.305,4593,8.307,16.61,111,114,765
1988,7131,1679,2323,63513,62406,325,14.097,290,12.579,13399,4862,8537,7.791,21.471,10914,2838,8076,4.548,17.489,2485,3.982,34.977,232,234,1797
1988,7132,632,665,23452,22689,140,21.522,111,17.064,4247,1592,2655,7.017,18.718,2790,1561,1229,6.88,12.297,1457,6.422,24.593,87,88,1252
1988,7139,37056,40347,602087,588759,6545,16.598,4716,11.96,130768,51455,79313,8.74,22.211,103724,39983,63741,6.791,17.617,27044,4.593,35.235,3532,3606,28003
1988,7211,29939,35712,1329342,1308176,5184,14.703,4276,12.128,280784,130700,150084,9.991,21.464,239909,110461,129448,8.444,18.339,40875,3.125,36.678,3040,3142,64215
1988,7212,3945,4239,28257,26964,628,15.211,407,9.858,9367,5162,4205,19.144,34.74,6908,3067,3841,11.375,25.62,2459,9.12,51.24,257,259,1203
1988,7213,3747,3845,18509,19834,347,8.983,383,9.915,3753,1357,2396,6.842,18.922,6134,4451,1683,22.441,30.927,-2381,-12.005,37.844,266,266,4103
1988,7223,17467,30791,573076,572836,6428,20.759,6775,21.88,170391,85938,84453,15.002,29.745,170215,64479,105736,11.256,29.714,176,0.031,59.429,2990,3044,28256
1988,7224,51543,52532,309648,311784,7979,15.117,8475,16.057,81295,43008,38287,13.794,26.074,85982,41106,44876,13.184,27.577,-4687,-1.503,52.148,6645,6672,32947
1988,7225,210954,284421,5424360,5318671,48546,17.392,37972,13.604,1265413,670969,594444,12.615,23.792,1061175,421776,639399,7.93,19.952,204238,3.84,39.904,27797,28561,277828
1988,8111,113679,120597,631363,616092,19338,16.267,15903,13.377,156244,73518,82726,11.933,25.361,125881,54784,71097,8.892,20.432,30363,4.928,40.864,12109,12305,43139
1988,8112,11380,13650,116282,113461,2179,16.259,1683,12.558,26330,11517,14813,10.151,23.206,20681,7924,12757,6.984,18.227,5649,4.979,36.455,1235,1241,3874
1988,8113,20021,21017,157649,154235,2928,14.03,2633,12.616,34260,10974,23286,7.115,22.213,27352,11010,16342,7.138,17.734,6908,4.479,35.468,1979,1986,7845
1988,8114,25374,27025,173062,167053,4541,16.91,4200,15.64,40295,17179,23116,10.284,24.121,28665,11738,16927,7.027,17.159,11630,6.962,34.318,3235,3246,8218
1988,8121,76581,85877,442787,435266,13862,16.301,12181,14.324,112053,61336,50717,14.092,25.744,96923,47443,49480,10.9,22.268,15130,3.476,44.535,9296,9412,31890
1988,8122,17168,20362,125095,124873,1584,7.817,1385,6.835,19881,7433,12448,5.952,15.921,19256,5064,14192,4.055,15.421,625,0.501,30.841,894,950,3687
1988,8123,33662,40270,372722,368998,5595,14.016,4892,12.255,72331,30046,42285,8.143,19.602,64682,26064,38618,7.063,17.529,7649,2.073,35.058,3502,3626,18410
1988,8129,13115,21456,166695,164462,4136,19.786,3031,14.5,40813,18089,22724,10.999,24.816,36239,14821,21418,9.012,22.035,4574,2.781,44.07,1644,1672,7587
1988,8131,127844,127909,1048075,1032115,6265,4.926,4794,3.77,131095,18660,112435,1.808,12.702,98790,15318,83472,1.484,9.572,32305,3.13,19.143,2953,2953,9013
1988,8132,8565,9775,134834,132326,1140,12.021,557,5.873,22523,7026,15497,5.31,17.021,17507,3539,13968,2.674,13.23,5016,3.791,26.461,382,384,1945
1988,8133,7816,9071,99056,97718,1142,12.954,631,7.158,17856,5795,12061,5.93,18.273,15263,3186,12077,3.26,15.62,2593,2.654,31.239,418,420,2113
1988,8134,29640,31165,274608,269831,2466,8.002,1769,5.74,41558,10086,31472,3.738,15.402,31899,6344,25555,2.351,11.822,9659,3.58,23.644,1128,1131,3782
1988,8139,56640,58975,476129,470936,4936,8.416,4286,7.308,83695,21802,61893,4.63,17.772,73552,20324,53228,4.316,15.618,10143,2.154,31.237,2996,2998,13145
1989,1131,226,237,2590,2886,46,19.828,36,15.517,419,238,181,8.248,14.521,993,347,646,12.026,34.413,-574,-19.893,29.042,27,27,327
1989,1132,94,109,1717,1664,16,14.747,15,13.825,514,93,421,5.589,30.889,376,75,301,4.507,22.596,138,8.293,45.192,9,9,57
1989,1133,10953,11035,89349,89782,1693,15.446,1544,14.087,20668,7661,13007,8.533,23.02,21545,7354,14191,8.191,23.997,-877,-0.977,46.04,1165,1165,5711
1989,1141,1013,1020,7130,7133,168,16.077,218,20.861,2429,1240,1189,17.384,34.053,2419,1079,1340,15.127,33.913,10,0.14,67.826,162,162,821
1989,1142,147,151,1283,1119,44,31.429,22,15.714,438,297,141,26.553,39.16,130,42,88,3.755,11.623,308,27.537,23.245,17,17,33
1989,1151,3879,4217,54119,53884,600,14.451,470,11.32,15409,6341,9068,11.768,28.597,15029,3786,11243,7.026,27.892,380,0.705,55.783,332,332,2553
1989,1152,2025,2041,13886,13892,360,18.045,268,13.434,2694,1102,1592,7.933,19.392,2711,847,1864,6.097,19.515,-17,-0.122,38.785,201,201,620
1989,1153,792,803,10734,10697,148,18.782,118,14.975,3022,1080,1942,10.096,28.251,2917,1115,1802,10.423,27.269,105,0.982,54.539,86,86,915
1989,2111,6924,8407,116097,120519,847,9.895,1153,13.47,16251,4310,11941,3.576,13.484,25021,9377,15644,7.781,20.761,-8770,-7.277,26.968,804,813,3411
1989,2121,2168,2732,137598,140857,436,15.726,517,18.647,20103,8404,11699,5.966,14.272,26447,10351,16096,7.349,18.776,-6344,-4.504,28.544,379,383,5345
1989,2122,476,639,44824,42559,111,17.384,110,17.228,8817,2408,6409,5.658,20.717,4445,1630,2815,3.83,10.444,4372,10.273,20.889,84,84,544
1989,2123,3487,5050,106143,105760,441,8.723,452,8.941,16701,6137,10564,5.803,15.791,15868,4919,10949,4.651,15.004,833,0.788,30.008,275,279,2563
1989,2131,7816,8922,156568,159365,1126,12.352,1514,16.608,43176,16887,26289,10.596,27.093,49217,23011,26206,14.439,30.883,-6041,-3.791,54.185,1009,1026,10270
1989,2211,1743,6099,594716,596267,254,4.196,162,2.676,27441,8704,18737,1.46,4.602,30668,3019,27649,0.506,5.143,-3227,-0.541,9.204,64,64,847
1989,2212,636,2462,139412,143343,173,6.966,216,8.697,8553,2811,5742,1.961,5.967,16094,6896,9198,4.811,11.228,-7541,-5.261,11.934,46,46,313
1989,2213,4019,4278,33398,32757,376,8.907,263,6.23,4811,1483,3328,4.527,14.687,3564,1384,2180,4.225,10.88,1247,3.807,21.76,193,193,796
1989,2361,110442,110851,659700,648665,22288,20.37,19416,17.745,212709,85745,126964,13.219,32.792,190678,75694,114984,11.669,29.395,22031,3.396,58.791,14273,14280,57380
1989,2362,38526,39228,717296,713140,5097,13.03,4877,12.467,179515,39772,139743,5.577,25.172,171921,42431,129490,5.95,24.108,7594,1.065,48.215,3746,3757,29595
1989,2371,13586,13874,304367,303510,1375,9.902,1399,10.075,63544,11286,52258,3.718,20.936,61924,11816,50108,3.893,20.403,1620,0.534,40.805,1044,1045,7542
1989,2372,9911,10129,86777,83176,2201,21.808,2128,21.085,31103,15071,16032,18.119,37.394,24058,12250,11808,14.728,28.924,7045,8.47,57.848,1745,1748,8446
1989,2373,9580,9973,249569,257176,990,9.902,1039,10.393,45541,9290,36251,3.612,17.708,60620,11020,49600,4.285,23.571,-15079,-5.863,35.416,789,790,7340
1989,2379,5114,5188,80199,80000,725,13.861,810,15.486,19694,3395,16299,4.244,24.618,19191,6453,12738,8.066,23.989,503,0.629,47.978,623,623,4066
1989,2381,77266,77696,763781,752501,11531,14.903,10890,14.074,214612,58222,156390,7.737,28.52,191678,62186,129492,8.264,25.472,22934,3.048,50.944,8436,8447,50491
1989,2382,119803,121610,1287233,1266737,15837,13.166,13186,10.962,286945,70438,216507,5.561,22.652,246140,81733,164407,6.452,19.431,40805,3.221,38.862,10096,10117,54277
1989,2383,80379,80828,699384,684023,14212,17.711,13044,16.255,206786,61274,145512,8.958,30.231,175776,58954,116822,8.619,25.697,31010,4.533,51.395,10029,10037,46872
1989,2389,41106,41344,363182,356470,6091,14.847,5454,13.294,103344,33135,70209,9.295,28.991,89771,30516,59255,8.561,25.183,13573,3.808,50.367,4150,4152,21282
1989,3111,1183,1785,47804,48351,84,4.66,119,6.602,5010,1133,3877,2.343,10.362,6125,1998,4127,4.132,12.668,-1115,-2.306,20.724,68,68,741
1989,3112,479,823,65533,65467,58,7.073,52,6.341,5089,1009,4080,1.541,7.773,4882,1221,3661,1.865,7.457,207,0.316,14.914,30,30,233
1989,3113,1571,1857,86879,87042,198,10.622,212,11.373,10969,2486,8483,2.856,12.602,11329,3345,7984,3.843,13.016,-360,-0.414,25.204,135,144,1106
1989,3114,1170,1599,174693,171995,142,8.965,112,7.071,22841,4155,18686,2.416,13.28,17249,4360,12889,2.535,10.029,5592,3.251,20.058,70,73,1632
1989,3115,1477,2102,138624,137707,120,5.643,169,7.947,15844,2796,13048,2.03,11.506,14173,5967,8206,4.333,10.292,1671,1.213,20.584,93,94,1254
1989,3116,3686,4297,371961,365452,339,7.869,361,8.38,43888,12623,31265,3.454,12.009,30882,9187,21695,2.514,8.45,13006,3.559,16.901,265,266,4251
1989,3117,716,827,47270,46849,85,10.353,73,8.892,9492,2310,7182,4.931,20.261,8666,3270,5396,6.98,18.498,826,1.763,36.995,47,47,1728
1989,3118,9245,10671,308847,309589,1311,12.238,1394,13.013,36824,11055,25769,3.571,11.894,38496,15137,23359,4.889,12.435,-1672,-0.54,23.789,1027,1049,9149
1989,3119,2061,2427,132501,135551,274,11.327,258,10.666,15647,3972,11675,2.93,11.543,22420,6312,16108,4.657,16.54,-6773,-4.997,23.087,180,183,2501
1989,3121,1760,2226,141166,145153,201,8.937,247,10.983,12589,2211,10378,1.523,8.673,20807,8398,12409,5.786,14.335,-8218,-5.662,17.346,161,162,2693
1989,3122,99,135,36708,35994,13,9.701,11,8.209,4909,2697,2212,7.493,13.638,3411,321,3090,0.892,9.477,1498,4.162,18.953,8,8,186
1989,3131,396,620,111161,111863,44,7.131,38,6.159,10577,2998,7579,2.68,9.455,11986,3373,8613,3.015,10.715,-1409,-1.26,18.911,22,22,726
1989,3132,1642,1979,256571,257497,161,8.133,162,8.184,22387,5317,17070,2.065,8.694,24275,5265,19010,2.045,9.427,-1888,-0.733,17.388,124,124,1595
1989,3133,1705,1964,108577,108970,224,11.417,220,11.213,14166,4194,9972,3.849,13,14884,5411,9473,4.966,13.659,-718,-0.659,26,114,117,1957
1989,3141,3713,4004,134012,132125,427,10.61,468,11.629,18228,4348,13880,3.291,13.796,14202,3446,10756,2.608,10.749,4026,3.047,21.498,383,391,2083
1989,3149,3877,3987,119217,116606,596,15.272,427,10.942,23598,8902,14696,7.634,20.237,18518,7321,11197,6.278,15.881,5080,4.357,31.762,348,348,4520
1989,3151,1251,1374,138304,137515,134,9.728,141,10.236,17168,3792,13376,2.758,12.485,15741,3745,11996,2.723,11.447,1427,1.038,22.894,112,113,2147
1989,3152,11343,12668,774371,777475,1991,15.653,2094,16.463,123100,42695,80405,5.491,15.833,128623,57394,71229,7.382,16.544,-5523,-0.71,31.667,1772,1785,37037
1989,3159,1792,1872,67695,66795,294,15.965,233,12.653,11788,4133,7655,6.188,17.648,10027,3911,6116,5.855,15.012,1761,2.636,30.023,204,204,3220
1989,3161,345,372,16220,15700,40,10.87,32,8.696,2506,321,2185,2.045,15.962,1464,621,843,3.955,9.325,1042,6.637,18.65,28,28,320
1989,3162,371,493,77668,80652,34,6.686,65,12.783,5562,678,4884,0.841,6.896,11459,3991,7468,4.948,14.208,-5897,-7.312,13.793,44,45,1045
1989,3169,1103,1152,37479,37577,122,10.522,137,11.815,5344,1231,4113,3.276,14.222,5585,1659,3926,4.415,14.863,-241,-0.641,28.443,116,116,1373
1989,3211,4592,5124,145643,146216,500,9.728,532,10.35,17719,5198,12521,3.555,12.118,18846,6104,12742,4.175,12.889,-1127,-0.771,24.237,410,410,3009
1989,3212,1310,1609,104694,105349,152,9.426,159,9.86,11605,3477,8128,3.3,11.016,12674,5466,7208,5.188,12.03,-1069,-1.015,22.032,103,103,2020
1989,3219,9159,9836,293583,288467,1111,11.315,1077,10.969,52548,15310,37238,5.307,18.216,42565,15472,27093,5.364,14.756,9983,3.461,29.511,825,828,8742
1989,3221,226,543,192546,191785,25,4.596,27,4.963,9364,1663,7701,0.867,4.883,8188,2694,5494,1.405,4.269,1176,0.613,8.539,16,16,688
1989,3222,3595,5188,398658,398013,293,5.638,310,5.966,34270,6353,27917,1.596,8.61,32793,9597,23196,2.411,8.239,1477,0.371,16.478,211,213,4605
1989,3231,41645,43559,849818,840968,4748,10.986,4064,9.404,110358,28931,81427,3.44,13.123,92401,32435,59966,3.857,10.987,17957,2.135,21.975,3195,3215,20502
1989,3241,1300,2213,141543,145753,173,7.848,156,7.076,9188,2938,6250,2.016,6.304,17869,8180,9689,5.612,12.26,-8681,-5.956,12.608,80,81,475
1989,3251,1128,2274,227695,228346,168,7.401,160,7.048,18821,5660,13161,2.479,8.242,20105,11238,8867,4.921,8.805,-1284,-0.562,16.485,74,74,666
1989,3252,358,635,135003,134065,47,7.396,48,7.553,9164,1955,7209,1.458,6.835,7188,2303,4885,1.718,5.362,1976,1.474,10.723,23,26,1458
1989,3253,620,882,42712,42223,66,7.437,77,8.676,4813,897,3916,2.124,11.399,3758,1322,2436,3.131,8.9,1055,2.499,17.801,42,44,632
1989,3254,1073,1336,174664,170186,116,8.751,95,7.167,19695,4639,15056,2.726,11.573,10790,2620,8170,1.539,6.34,8905,5.233,12.68,57,57,453
1989,3255,1635,2164,77846,77611,164,7.649,124,5.784,7966,2265,5701,2.918,10.264,7357,2279,5078,2.936,9.479,609,0.785,18.959,80,81,1080
1989,3256,2025,2282,118817,118186,199,8.715,202,8.846,14742,2957,11785,2.502,12.474,13525,5651,7874,4.781,11.444,1217,1.03,22.888,144,144,1356
1989,3259,2110,2748,138249,137883,245,8.912,247,8.985,14185,3538,10647,2.566,10.288,13705,5485,8220,3.978,9.94,480,0.348,19.879,146,146,1985
1989,3261,9926,11837,683463,670775,1097,9.328,943,8.019,100545,23433,77112,3.493,14.989,74594,25452,49142,3.794,11.121,25951,3.869,22.241,636,650,10470
1989,3262,2106,2570,200821,196846,243,9.563,185,7.281,20771,3535,17236,1.796,10.552,12840,3736,9104,1.898,6.523,7931,4.029,13.046,133,134,1185
1989,3271,1424,1716,83354,83353,201,11.865,157,9.268,9708,1820,7888,2.183,11.647,9932,2274,7658,2.728,11.916,-224,-0.269,23.294,111,112,1014
1989,3272,1738,1992,147773,145975,240,12.183,196,9.949,14097,2753,11344,1.886,9.657,10249,2574,7675,1.763,7.021,3848,2.636,14.042,141,141,1220
1989,3273,6488,9024,190546,190628,699,7.739,716,7.927,30531,8394,22137,4.403,16.016,30588,9792,20796,5.137,16.046,-57,-0.03,32.032,460,465,5419
1989,3274,256,344,17943,17873,38,11.193,29,8.542,1630,645,985,3.609,9.12,1461,870,591,4.868,8.174,169,0.946,16.349,17,17,188
1989,3279,1898,2197,77784,78206,210,9.602,190,8.688,8458,2023,6435,2.587,10.815,9247,3553,5694,4.543,11.824,-789,-1.009,21.63,135,136,1716
1989,3311,306,359,163025,163293,31,8.623,32,8.901,6361,789,5572,0.483,3.895,7052,884,6168,0.541,4.319,-691,-0.423,7.791,24,24,397
1989,3312,533,723,67062,65662,62,8.683,44,6.162,7661,2590,5071,3.944,11.667,5070,1565,3505,2.383,7.721,2591,3.946,15.443,26,26,692
1989,3313,423,594,102711,102793,36,6.04,40,6.711,8027,1927,6100,1.875,7.809,8048,3791,4257,3.688,7.829,-21,-0.02,15.618,21,21,368
1989,3314,761,919,83437,82708,80,8.719,77,8.392,7489,1768,5721,2.138,9.055,6074,1807,4267,2.185,7.344,1415,1.711,14.688,51,53,852
1989,3315,2532,2792,224624,219076,190,6.806,189,6.771,28129,5988,22141,2.733,12.84,17030,6913,10117,3.156,7.774,11099,5.066,15.547,127,128,2611
1989,3321,3307,3497,145598,144221,253,7.247,241,6.903,17793,4189,13604,2.905,12.337,15027,5780,9247,4.008,10.419,2766,1.918,20.839,157,165,2135
1989,3322,1296,1434,83285,80640,124,8.717,101,7.1,10693,4088,6605,5.069,13.26,5585,1413,4172,1.752,6.926,5108,6.334,13.852,73,73,874
1989,3323,10119,10946,350771,344780,944,8.648,884,8.098,54644,12415,42229,3.601,15.849,42837,15717,27120,4.559,12.424,11807,3.425,24.849,670,680,8043
1989,3324,1495,1832,120849,118836,142,7.781,128,7.014,15899,2966,12933,2.496,13.379,12020,4577,7443,3.852,10.115,3879,3.264,20.23,86,93,3328
1989,3325,965,1056,73933,75167,103,9.796,94,8.94,8942,2795,6147,3.718,11.896,11332,5425,5907,7.217,15.076,-2390,-3.18,23.792,69,70,744
1989,3326,1781,1983,70842,69847,271,14.174,129,6.747,9950,2802,7148,4.012,14.246,7931,2734,5197,3.914,11.355,2019,2.891,22.71,92,92,1118
1989,3327,21428,21730,346187,337015,1999,9.243,1792,8.286,55203,11506,43697,3.414,16.38,36831,12774,24057,3.79,10.929,18372,5.451,21.857,1395,1397,8652
1989,3328,5491,5834,142782,139670,426,7.314,407,6.988,22207,4671,17536,3.344,15.9,15859,5007,10852,3.585,11.355,6348,4.545,22.709,303,304,3110
1989,3329,6724,7223,370658,365114,855,12.066,581,8.199,43452,11414,32038,3.126,11.901,31989,8819,23170,2.415,8.761,11463,3.14,17.523,450,452,4946
1989,3331,2916,3171,213736,206642,256,8.08,251,7.922,29921,4519,25402,2.187,14.48,15694,5520,10174,2.671,7.595,14227,6.885,15.19,176,177,2029
1989,3332,4170,4416,178404,172691,376,8.61,278,6.366,27037,5450,21587,3.156,15.656,15845,4353,11492,2.521,9.175,11192,6.481,18.351,204,204,2359
1989,3333,2251,2386,158343,158056,214,9.039,177,7.476,18124,4224,13900,2.672,11.467,17539,5861,11678,3.708,11.097,585,0.37,22.193,122,122,1134
1989,3334,1624,1881,166804,165883,165,8.76,170,9.026,18499,4611,13888,2.78,11.152,16611,6065,10546,3.656,10.014,1888,1.138,20.027,118,118,2191
1989,3335,9388,9712,232690,226284,740,7.671,609,6.313,32252,6313,25939,2.79,14.253,19513,7343,12170,3.245,8.623,12739,5.63,17.246,478,480,4686
1989,3336,739,886,134157,131535,49,5.496,60,6.73,14831,3525,11306,2.68,11.275,9203,3268,5935,2.485,6.997,5628,4.279,13.993,35,35,704
1989,3339,5381,5969,326734,323459,436,7.308,430,7.208,39283,8452,30831,2.613,12.145,32660,13387,19273,4.139,10.097,6623,2.048,20.194,284,285,3761
1989,3341,1627,1777,270359,272486,264,14.966,238,13.492,37912,7386,30526,2.711,13.913,43351,12739,30612,4.675,15.909,-5439,-1.996,27.827,180,181,6300
1989,3342,1577,1771,256110,252149,217,12.576,126,7.302,36345,11753,24592,4.661,14.414,29148,6965,22183,2.762,11.56,7197,2.854,23.12,78,79,1515
1989,3343,408,432,35386,33523,60,14.406,29,6.963,6101,778,5323,2.321,18.199,2302,432,1870,1.289,6.867,3799,11.333,13.734,23,23,268
1989,3344,4863,5467,538431,533916,755,14.121,514,9.614,71480,21337,50143,3.996,13.388,63189,23652,39537,4.43,11.835,8291,1.553,23.67,350,354,7033
1989,3345,4436,5067,672218,675465,406,7.98,448,8.805,70212,25867,44345,3.83,10.395,76516,25561,50955,3.784,11.328,-6304,-0.933,20.789,262,262,3051
1989,3346,763,800,47781,52000,127,16.066,108,13.662,8922,1906,7016,3.665,17.158,17312,5987,11325,11.513,33.292,-8390,-16.135,34.315,85,85,643
1989,3351,1165,1287,83925,84854,107,8.275,119,9.203,7275,1168,6107,1.376,8.574,9002,2828,6174,3.333,10.609,-1727,-2.035,17.147,91,91,951
1989,3352,334,416,112474,113670,43,10.374,40,9.65,10498,2695,7803,2.371,9.236,12852,5119,7733,4.503,11.306,-2354,-2.071,18.471,22,22,618
1989,3353,2127,2585,234388,233582,181,6.998,184,7.114,22212,2863,19349,1.226,9.509,20547,7977,12570,3.415,8.797,1665,0.713,17.593,106,112,1258
1989,3359,2180,2546,208127,205277,200,7.803,234,9.13,24781,7139,17642,3.478,12.072,19397,6855,12542,3.339,9.449,5384,2.623,18.898,153,153,1479
1989,3361,238,297,233028,236004,43,14.879,27,9.343,22965,3562,19403,1.509,9.731,28854,3745,25109,1.587,12.226,-5889,-2.495,19.462,19,19,605
1989,3362,1848,2059,122814,125924,195,9.407,223,10.757,17965,4495,13470,3.57,14.267,24616,12550,12066,9.966,19.548,-6651,-5.282,28.533,156,157,2212
1989,3363,4073,4922,682010,669042,491,10.076,393,8.065,72214,16430,55784,2.456,10.794,46487,17497,28990,2.615,6.948,25727,3.845,13.897,261,264,4695
1989,3364,1415,1728,683065,669626,148,8.637,119,6.945,90846,60480,30366,9.032,13.567,61826,7188,54638,1.073,9.233,29020,4.334,18.466,88,90,5265
1989,3365,166,201,31021,29193,24,12.214,15,7.634,5498,1004,4494,3.439,18.834,1839,403,1436,1.38,6.3,3659,12.534,12.599,11,11,255
1989,3366,1272,1379,169018,167242,162,11.921,122,8.977,21920,3871,18049,2.315,13.107,18544,3357,15187,2.007,11.088,3376,2.019,22.176,85,85,1600
1989,3369,487,501,31474,31408,61,12.286,52,10.473,4024,873,3151,2.78,12.812,3998,665,3333,2.117,12.729,26,0.083,25.458,34,35,525
1989,3371,13438,14092,405016,405710,1876,13.372,1751,12.481,53709,15622,38087,3.851,13.238,55232,21208,34024,5.227,13.614,-1523,-0.375,26.477,1385,1397,14122
1989,3372,3122,3306,164501,163816,403,12.448,266,8.216,21255,5579,15676,3.406,12.975,19974,6282,13692,3.835,12.193,1281,0.782,24.386,208,208,3057
1989,3379,1121,1273,43614,42855,142,11.27,116,9.206,6644,2340,4304,5.46,15.504,5294,1824,3470,4.256,12.353,1350,3.15,24.707,85,87,828
1989,3391,10433,10930,257701,251967,1045,9.532,1110,10.125,40054,9254,30800,3.673,15.897,28800,13487,15313,5.353,11.43,11254,4.466,22.86,801,801,4000
1989,3399,16122,16638,425564,421207,2261,13.808,1733,10.584,67116,18642,48474,4.426,15.934,58169,21218,36951,5.037,13.81,8947,2.124,27.62,1379,1379,11677
1989,4231,21422,26466,313488,311660,2559,9.643,2704,10.189,50193,16824,33369,5.398,16.105,46439,19154,27285,6.146,14.901,3754,1.205,29.801,1951,2053,11441
1989,4232,8507,9737,124419,122948,1205,12.387,1187,12.202,22957,7639,15318,6.213,18.672,20064,7496,12568,6.097,16.319,2893,2.353,32.638,907,927,4941
1989,4233,8470,11046,147043,146715,1244,11.337,1097,9.998,24200,7737,16463,5.274,16.495,23526,9462,14064,6.449,16.035,674,0.459,32.07,776,792,6017
1989,4234,25177,34637,639770,628836,4382,12.622,4541,13.08,122234,43755,78479,6.958,19.438,99622,53841,45781,8.562,15.842,22612,3.596,31.685,2546,2652,18254
1989,4235,7021,9364,142792,140775,931,10.021,784,8.439,23051,7452,15599,5.294,16.374,19327,5987,13340,4.253,13.729,3724,2.645,27.458,493,516,2755
1989,4236,16233,23523,327965,326182,2896,12.422,2478,10.629,68965,23316,45649,7.148,21.143,65990,34690,31300,10.635,20.231,2975,0.912,40.462,1373,1426,9701
1989,4237,11196,15426,174284,171255,1367,8.905,1217,7.928,26327,8277,18050,4.833,15.373,20112,7391,12721,4.316,11.744,6215,3.629,23.488,840,867,4793
1989,4238,48832,63369,696011,679652,6168,9.819,5064,8.062,118163,34377,83786,5.058,17.386,85913,30171,55742,4.439,12.641,32250,4.745,25.281,3253,3420,17565
1989,4239,24981,26724,267999,261408,3665,13.776,3427,12.881,55717,16767,38950,6.414,21.314,42599,17145,25454,6.559,16.296,13118,5.018,32.592,2735,2761,11426
1989,4241,8886,11979,173143,172562,1224,10.354,909,7.689,25372,8045,17327,4.662,14.703,24235,7974,16261,4.621,14.044,1137,0.659,28.089,610,628,4394
1989,4242,3079,4086,113990,112492,682,17.048,511,12.773,20036,6778,13258,6.025,17.811,16912,9061,7851,8.055,15.034,3124,2.777,30.068,348,353,2537
1989,4243,12104,13040,162784,157985,2094,16.252,1783,13.838,37288,11445,25843,7.244,23.602,27643,11134,16509,7.048,17.497,9645,6.105,34.995,1448,1464,8360
1989,4244,27437,33944,696626,687492,3849,11.316,3988,11.725,115810,34238,81572,4.98,16.845,96962,38494,58468,5.599,14.104,18848,2.742,28.207,2919,2964,21704
1989,4245,7004,9967,86097,87411,569,5.654,762,7.572,12020,3561,8459,4.074,13.751,14678,4024,10654,4.604,16.792,-2658,-3.041,27.502,505,546,2808
1989,4246,7730,11237,132432,129767,1153,10.339,982,8.806,23507,6209,17298,4.785,18.115,18389,6886,11503,5.306,14.171,5118,3.944,28.342,545,558,2725
1989,4247,9449,12658,136346,136560,902,7.077,1078,8.458,22880,7311,15569,5.354,16.755,23348,8378,14970,6.135,17.097,-468,-0.343,33.509,699,725,4957
1989,4248,3883,4946,138883,139475,321,6.398,463,9.229,17847,5800,12047,4.158,12.796,18981,9045,9936,6.485,13.609,-1134,-0.813,25.592,308,326,3523
1989,4249,21558,26047,308526,302543,3510,13.628,2929,11.372,57949,19885,38064,6.573,19.154,46054,17997,28057,5.949,15.222,11895,3.932,30.445,2181,2209,11141
1989,4251,31646,34094,332373,328496,3679,10.864,3222,9.514,61082,18796,42286,5.722,18.594,53615,20290,33325,6.177,16.321,7467,2.273,32.643,2195,2199,11351
1989,4411,39425,41378,1030587,1020534,4776,11.607,4317,10.491,147247,57819,89428,5.666,14.428,127188,53554,73634,5.248,12.463,20059,1.966,24.926,3473,3497,41301
1989,4412,11428,12123,93487,93121,1272,10.49,1277,10.532,17736,5776,11960,6.203,19.046,16999,6809,10190,7.312,18.255,737,0.791,36.509,1052,1073,5685
1989,4413,48118,72469,536923,531885,5195,7.109,6407,8.768,89535,29332,60203,5.515,16.834,79445,29120,50325,5.475,14.936,10090,1.897,29.873,4320,4624,19191
1989,4421,21969,28383,244878,243298,3066,10.822,2961,10.452,43839,15509,28330,6.375,18.019,40569,14597,25972,6,16.675,3270,1.344,33.349,2147,2343,10760
1989,4422,23217,29490,194507,189242,3859,13.245,3151,10.815,44260,17320,26940,9.152,23.388,34108,13012,21096,6.876,18.023,10152,5.365,36.047,2329,2427,8999
1989,4431,22769,32271,235885,223855,5847,18.824,3427,11.033,62568,32057,30511,14.32,27.95,38170,15204,22966,6.792,17.051,24398,10.899,34.103,2401,2554,10329
1989,4441,55558,72352,804961,792367,6391,8.884,5561,7.73,130405,50842,79563,6.416,16.458,105934,33747,72187,4.259,13.369,24471,3.088,26.739,4087,4208,22596
1989,4442,16354,19870,152489,151735,1830,9.247,1670,8.439,25706,8093,17613,5.334,16.941,24245,7101,17144,4.68,15.979,1461,0.963,31.957,1243,1268,4955
1989,4451,63391,95835,2391476,2328450,10985,11.445,11275,11.747,391055,176822,214233,7.594,16.795,266406,112715,153691,4.841,11.441,124649,5.353,22.883,7608,7834,50973
1989,4452,20924,25114,166392,166386,3253,12.772,3966,15.571,37306,15137,22169,9.098,22.421,37508,18059,19449,10.854,22.543,-202,-0.121,44.843,3019,3099,13619
1989,4453,26815,31682,153562,154238,3391,10.624,3865,12.109,29033,11447,17586,7.422,18.824,30270,13045,17225,8.458,19.626,-1237,-0.802,37.647,2959,3035,9922
1989,4461,48430,76969,740300,725476,7381,9.675,6017,7.887,133260,55063,78197,7.59,18.369,104367,37236,67131,5.133,14.386,28893,3.983,28.772,3947,4119,21433
1989,4471,85371,137575,983001,968475,14413,10.472,14527,10.555,211719,88891,122828,9.178,21.861,182124,77180,104944,7.969,18.805,29595,3.056,37.61,9229,9782,47341
1989,4481,54461,105216,958859,955164,13676,13.053,12785,12.203,202436,88237,114199,9.238,21.194,196987,71322,125665,7.467,20.623,5449,0.57,41.247,7768,8567,37851
1989,4482,10920,37483,216754,210038,4016,10.76,3694,9.898,49359,18619,30740,8.865,23.5,36097,14524,21573,6.915,17.186,13262,6.314,34.372,1560,1732,6519
1989,4483,19489,29403,179631,178210,3734,12.83,3134,10.769,37420,18192,19228,10.208,20.998,34491,14118,20373,7.922,19.354,2929,1.644,38.708,1868,2061,7548
1989,4511,33105,43570,324303,317639,6250,14.503,5301,12.301,69730,34338,35392,10.81,21.953,55812,23384,32428,7.362,17.571,13918,4.382,35.142,3909,4077,14655
1989,4512,8646,13558,91369,89788,2084,15.879,1217,9.273,19253,8699,10554,9.688,21.443,15942,5541,10401,6.171,17.755,3311,3.688,35.51,839,853,3135
1989,4522,207,6558,1137502,1151628,500,7.809,190,2.967,117325,52004,65321,4.516,10.188,145853,22652,123201,1.967,12.665,-28528,-2.477,20.376,13,16,1240
1989,4523,11569,28028,969952,943153,2832,10.148,2591,9.284,167039,70906,96133,7.518,17.711,117473,39616,77857,4.2,12.455,49566,5.255,24.911,1416,1520,11687
1989,4531,24287,25813,135972,132256,3658,14.377,2919,11.472,30831,12805,18026,9.682,23.312,23448,8980,14468,6.79,17.729,7383,5.582,35.459,2343,2382,7244
1989,4532,31143,39117,248082,243150,5999,15.459,5379,13.861,57910,24301,33609,9.994,23.817,48319,21182,27137,8.712,19.872,9591,3.944,39.744,3820,4443,15273
1989,4533,10013,11944,65494,63090,2053,17.579,1522,13.032,15084,7182,7902,11.384,23.909,10435,4187,6248,6.637,16.54,4649,7.369,33.08,1121,1130,2923
1989,4539,25020,28702,153661,149274,4897,17.361,3907,13.851,40677,17959,22718,12.031,27.25,31901,15310,16591,10.256,21.371,8776,5.879,42.742,2834,2971,11309
1989,4541,5824,7211,120466,117437,1155,16.409,811,11.522,25725,9358,16367,7.969,21.905,19424,5672,13752,4.83,16.54,6301,5.365,33.08,578,583,2792
1989,4542,4137,5034,77363,77244,700,14.035,607,12.17,12345,5426,6919,7.024,15.982,12147,4790,7357,6.201,15.725,198,0.256,31.451,393,406,2460
1989,4543,16483,22636,220420,221735,2427,10.814,2040,9.09,39292,13999,25293,6.313,17.72,41620,11139,30481,5.024,18.77,-2328,-1.05,35.441,1459,1507,7627
1989,4811,702,2700,396565,411135,301,11.158,296,10.973,45255,7900,37355,1.922,11.007,75375,11470,63905,2.79,18.333,-30120,-7.326,22.015,80,80,2048
1989,4812,878,951,12776,12023,174,18.64,139,14.89,3338,1154,2184,9.599,27.765,1804,542,1262,4.508,15.005,1534,12.759,30.01,97,97,433
1989,4831,349,626,36717,37146,90,14.646,67,10.903,7066,1983,5083,5.338,19.022,7455,1211,6244,3.26,20.07,-389,-1.047,38.045,30,30,606
1989,4832,310,341,12925,12179,50,14.749,46,13.569,2975,826,2149,6.782,24.427,1617,639,978,5.247,13.277,1358,11.15,26.554,31,31,142
1989,4841,21175,27440,585871,578681,4701,17.347,4020,14.834,106535,31313,75222,5.411,18.41,92133,42427,49706,7.332,15.921,14402,2.489,31.842,3013,3044,19298
1989,4842,48170,52753,578486,571810,8165,15.526,7837,14.902,127410,43253,84157,7.564,22.282,113381,49801,63580,8.709,19.828,14029,2.453,39.657,6041,6084,31683
1989,4851,401,424,38518,37807,65,15.796,40,9.721,3033,641,2392,1.695,8.022,1566,622,944,1.645,4.142,1467,3.88,8.284,28,28,316
1989,4852,316,518,18755,18524,48,9.222,53,10.183,2752,481,2271,2.597,14.857,2177,771,1406,4.162,11.753,575,3.104,23.505,32,32,693
1989,4853,5104,5155,54651,55019,1004,19.696,889,17.44,11566,4650,6916,8.452,21.022,12378,6571,5807,11.943,22.498,-812,-1.476,42.044,726,726,5332
1989,4854,3209,3723,104875,104076,460,12.551,344,9.386,18091,8046,10045,7.731,17.383,16365,8540,7825,8.206,15.724,1726,1.658,31.448,271,274,6647
1989,4855,770,817,20229,20096,133,16.625,99,12.375,3613,1277,2336,6.354,17.979,3344,1623,1721,8.076,16.64,269,1.339,33.28,77,79,1248
1989,4859,1052,1077,22939,22580,251,23.859,201,19.106,5396,1723,3673,7.631,23.897,4619,2083,2536,9.225,20.456,777,3.441,40.912,172,172,1640
1989,4861,60,336,8910,8777,70,22.117,31,9.795,1967,1176,791,13.399,22.411,1664,726,938,8.272,18.959,303,3.452,37.917,(D),(D),(D)
1989,4862,247,1431,54616,55123,202,14.707,87,6.334,7399,3134,4265,5.686,13.423,8542,1338,7204,2.427,15.496,-1143,-2.074,26.846,21,22,195
1989,4869,66,356,6693,7342,29,7.934,48,13.133,749,284,465,3.868,10.202,2011,1213,798,16.523,27.392,-1262,-17.19,20.405,5,5,54
1989,4871,255,264,4624,4559,55,21.073,49,18.774,993,313,680,6.866,21.781,833,344,489,7.546,18.272,160,3.51,36.543,38,39,311
1989,4872,771,783,7571,7072,184,24.831,100,13.495,2349,950,1399,13.434,33.218,1398,616,782,8.711,19.769,951,13.448,39.539,72,72,468
1989,4879,97,103,774,701,28,28.571,18,18.367,251,136,115,19.401,35.806,110,34,76,4.85,15.692,141,20.114,31.384,10,10,16
1989,4881,2246,2902,82294,78961,451,15.97,295,10.446,18721,7103,11618,8.996,23.709,12339,4320,8019,5.471,15.627,6382,8.083,31.254,203,203,1769
1989,4882,395,597,18352,16653,106,17.981,91,15.437,5051,801,4250,4.81,30.332,1828,673,1155,4.041,10.977,3223,19.354,21.955,32,74,364
1989,4883,2047,2465,82651,83435,286,11.593,290,11.755,14922,3121,11801,3.741,17.885,16556,4939,11617,5.92,19.843,-1634,-1.958,35.769,200,204,3089
1989,4884,1503,1603,11647,10209,744,55.152,236,17.494,5041,3631,1410,35.567,49.378,2150,1207,943,11.823,21.06,2891,28.318,42.12,169,182,912
1989,4885,7022,9376,108748,106318,1315,14.252,1016,11.012,23129,7268,15861,6.836,21.755,18560,8035,10525,7.558,17.457,4569,4.297,34.914,665,698,5019
1989,4889,610,647,7620,7360,140,22.364,98,15.655,2045,643,1402,8.737,27.787,1555,555,1000,7.541,21.129,490,6.658,42.258,85,86,497
1989,4921,1403,3850,337014,317664,596,15.91,388,10.358,72210,25420,46790,8.002,22.732,34100,10944,23156,3.445,10.735,38110,11.997,21.469,228,234,2144
1989,4922,3775,4051,63414,62040,619,15.166,680,16.661,14276,3889,10387,6.269,23.011,11600,4654,6946,7.502,18.698,2676,4.313,37.395,565,568,2949
1989,4931,6301,10056,427087,420793,1118,11.2,971,9.727,79499,34228,45271,8.134,18.893,67974,20617,47357,4.9,16.154,11525,2.739,32.308,393,402,3326
1989,5111,14309,16791,691692,685562,2172,13.09,1775,10.698,75831,24503,51328,3.574,11.061,63797,23620,40177,3.445,9.306,12034,1.755,18.612,1353,1368,11997
1989,5112,3588,4053,73835,66266,1116,29.94,465,12.475,24777,9704,15073,14.644,37.39,9470,3885,5585,5.863,14.291,15307,23.1,28.582,319,325,2430
1989,5121,9546,13960,214235,221925,2068,14.714,2257,16.059,47260,17043,30217,7.68,21.295,61870,21595,40275,9.731,27.879,-14610,-6.583,42.591,1227,1311,9081
1989,5122,2391,2415,16819,15984,628,27.239,409,17.74,5517,3164,2353,19.795,34.517,3786,1934,1852,12.1,23.687,1731,10.83,47.374,331,331,1533
1989,5151,6122,7672,240695,238162,1053,13.866,897,11.812,40563,20353,20210,8.546,17.032,35205,16805,18400,7.056,14.782,5358,2.25,29.564,641,650,10095
1989,5152,200,305,11440,11157,48,15.385,62,19.872,2244,566,1678,5.073,20.114,1687,596,1091,5.342,15.121,557,4.993,30.242,42,42,161
1989,5173,5047,24038,1041576,1034588,4090,17.733,2143,9.291,183082,57386,125696,5.547,17.696,169350,55539,113811,5.368,16.369,13732,1.327,32.738,770,794,9385
1989,5174,181,331,12834,11919,79,25.608,34,11.021,3395,1362,2033,11.428,28.485,1623,1189,434,9.976,13.617,1772,14.868,27.235,18,18,278
1989,5179,945,1689,40657,39546,480,30.505,249,15.825,10381,4842,5539,12.244,26.251,8307,3135,5172,7.928,21.006,2074,5.245,42.012,131,133,934
1989,5182,5424,7579,275744,272992,1320,17.737,1046,14.055,55749,21040,34709,7.707,20.422,50244,19486,30758,7.138,18.405,5505,2.017,36.81,619,626,5663
1989,5191,2609,3074,34358,34068,386,12.798,270,8.952,5333,2136,3197,6.27,15.654,4822,2398,2424,7.039,14.154,511,1.5,28.308,202,202,1034
1989,5211,47,85,25405,24982,6,7.018,7,8.187,1303,85,1218,0.34,5.216,468,103,365,0.412,1.873,835,3.342,3.747,4,4,88
1989,5221,18303,78073,2058360,2039148,5980,7.793,3310,4.313,291100,102200,188900,5.012,14.276,252638,55087,197551,2.701,12.389,38462,1.886,24.779,894,1043,22379
1989,5222,21155,39706,484640,500384,4147,10.367,4740,11.849,93585,37378,56207,7.47,18.703,122962,73902,49060,14.769,24.574,-29377,-5.871,37.405,1773,1794,17063
1989,5223,5488,6217,65269,62227,1546,26.082,967,16.314,19404,10114,9290,16.253,31.183,13308,5562,7746,8.938,21.386,6096,9.796,42.772,695,698,3113
1989,5231,6732,14393,338319,337311,2558,18.307,1717,12.288,67873,27323,40550,8.1,20.122,66534,21650,44884,6.418,19.725,1339,0.397,39.45,985,1009,9416
1989,5232,92,109,7294,7473,15,13.636,17,15.455,553,191,362,2.556,7.4,872,74,798,0.99,11.669,-319,-4.269,14.801,15,15,52
1989,5239,15349,16033,186730,192172,3067,19.277,2821,17.731,54325,27341,26984,14.227,28.269,65533,26832,38701,13.962,34.101,-11208,-5.832,56.538,2187,2188,18915
1989,5241,7025,38151,1416645,1382869,13121,35.105,11571,30.958,262744,125589,137155,9.082,19,209088,81476,127612,5.892,15.12,53656,3.88,30.24,533,547,3986
1989,5242,102210,107715,792077,781907,13042,12.215,11146,10.44,164235,67835,96400,8.676,21.004,144252,74232,70020,9.494,18.449,19983,2.556,36.897,8333,8335,54688
1989,5259,809,1018,13021,13699,72,6.946,109,10.516,2493,416,2077,3.037,18.198,3878,575,3303,4.197,28.309,-1385,-10.11,36.397,82,82,327
1989,5311,96675,100610,562947,553465,14338,14.361,12797,12.818,128183,59796,68387,10.804,23.16,109336,53669,55667,9.697,19.755,18847,3.405,39.51,10144,10190,41242
1989,5312,40792,43477,244863,242590,7112,16.535,6179,14.366,58998,24391,34607,10.054,24.32,54031,22758,31273,9.381,22.273,4967,2.047,44.545,4725,4741,16175
1989,5313,25586,27173,319121,313896,4711,17.568,3998,14.909,71761,28328,43433,9.025,22.861,61345,25144,36201,8.01,19.543,10416,3.318,39.086,3096,3122,18848
1989,5321,5694,10538,140530,142144,1200,11.262,1435,13.467,27456,8823,18633,6.207,19.316,30997,9642,21355,6.783,21.807,-3541,-2.491,38.631,822,883,4341
1989,5322,20719,26156,176107,166416,5012,19.608,3822,14.952,56498,26683,29815,16.034,33.95,37014,17276,19738,10.381,22.242,19484,11.708,44.484,2949,3104,13096
1989,5323,4356,6141,43972,41716,1014,16.975,679,11.367,12505,5632,6873,13.501,29.977,7924,3366,4558,8.069,18.995,4581,10.981,37.99,464,501,2325
1989,5324,8152,10333,111316,112491,1459,14.17,1386,13.461,29503,8116,21387,7.215,26.227,30987,8730,22257,7.761,27.546,-1484,-1.319,52.454,970,1001,5172
1989,5331,979,1027,14618,13808,223,22.189,179,17.811,4800,1910,2890,13.833,34.764,3221,1862,1359,13.485,23.328,1579,11.436,46.656,123,123,1363
1989,5411,133835,139004,951588,928127,15252,11.05,13294,9.632,163249,53480,109769,5.762,17.589,116360,45084,71276,4.858,12.537,46889,5.052,25.074,10092,10183,33024
1989,5412,67500,71741,671274,645393,9928,13.959,8687,12.214,147094,44307,102787,6.865,22.791,95741,47128,48613,7.302,14.835,51353,7.957,29.669,6487,6559,25273
1989,5413,60216,67374,950120,924829,9475,14.238,7819,11.75,202466,62798,139668,6.79,21.892,151118,55117,96001,5.96,16.34,51348,5.552,32.68,5633,5715,28074
1989,5414,16009,16239,102116,99354,3077,19.392,2333,14.703,25840,10827,15013,10.897,26.008,20242,10135,10107,10.201,20.374,5598,5.634,40.747,1867,1871,7773
1989,5415,21959,24929,378294,357413,6374,26.846,4001,16.852,113301,50310,62991,14.076,31.7,71967,34117,37850,9.546,20.136,41334,11.565,40.271,2777,2806,14269
1989,5416,44890,46741,402588,380575,10883,24.031,7974,17.608,137722,60428,77294,15.878,36.188,94401,42393,52008,11.139,24.805,43321,11.383,49.61,6218,6255,31768
1989,5417,6629,8227,447569,447527,1057,12.916,970,11.853,61419,15091,46328,3.372,13.724,61906,19174,42732,4.284,13.833,-487,-0.109,27.448,619,631,6282
1989,5418,27430,29731,362367,354638,5140,17.589,4123,14.109,79177,31590,47587,8.908,22.326,63872,25363,38509,7.152,18.011,15305,4.316,36.021,3263,3313,17760
1989,5419,33234,36938,290205,279579,4508,12.433,3150,8.687,65491,22128,43363,7.915,23.425,44467,16539,27928,5.916,15.905,21024,7.52,31.81,2321,2329,10813
1989,5511,26539,49774,3225916,3182298,6748,13.892,4349,8.953,632623,235011,397612,7.385,19.879,549450,127764,421686,4.015,17.266,83173,2.614,34.532,937,970,14821
1989,5611,12107,13057,246112,240971,1706,12.83,2186,16.44,62455,20580,41875,8.54,25.918,52143,21027,31116,8.726,21.639,10312,4.279,43.277,1686,1691,14551
1989,5612,435,734,70733,69346,220,32.934,88,13.174,19397,12453,6944,17.958,27.972,16798,4977,11821,7.177,24.224,2599,3.748,48.447,48,51,1111
1989,5613,18028,25098,1436372,1380216,5339,22.296,3035,12.674,473856,171400,302456,12.418,34.332,365496,93615,271881,6.783,26.481,108360,7.851,52.962,2087,2146,52303
1989,5614,22162,25200,321453,303814,4335,17.535,3380,13.672,86410,35544,50866,11.699,28.442,51276,20846,30430,6.861,16.877,35134,11.564,33.755,2668,2692,12245
1989,5615,24570,29707,235875,227219,4502,15.595,2826,9.789,54004,22088,31916,9.721,23.767,36869,15378,21491,6.768,16.226,17135,7.541,32.452,2156,2226,10902
1989,5616,12379,15426,505106,495047,2523,16.593,2082,13.692,118722,39620,79102,8.003,23.982,98624,33252,65372,6.717,19.922,20098,4.06,39.844,1553,1572,20314
1989,5617,84265,88349,1124395,1074510,19672,22.991,14104,16.483,312452,94844,217608,8.827,29.079,215609,86934,128675,8.091,20.066,96843,9.013,40.132,11121,11158,58899
1989,5619,14723,16028,221121,214783,2900,18.545,2119,13.551,62941,21686,41255,10.097,29.305,49976,14227,35749,6.624,23.268,12965,6.036,46.536,1614,1636,9198
1989,5621,3048,3156,38053,35143,486,16.119,204,6.766,9027,4254,4773,12.105,25.687,3302,1565,1737,4.453,9.396,5725,16.291,18.792,150,151,1190
1989,5622,1854,2662,70952,68022,405,15.686,245,9.489,14630,4497,10133,6.611,21.508,8974,3497,5477,5.141,13.193,5656,8.315,26.386,172,172,1710
1989,5629,4914,5228,62847,58823,809,15.689,666,12.916,19471,5321,14150,9.046,33.101,11444,5111,6333,8.689,19.455,8027,13.646,38.91,511,512,3005
1989,6111,13524,14625,448701,443335,592,4.055,538,3.685,42155,7588,34567,1.712,9.509,31408,6966,24442,1.571,7.084,10747,2.424,14.169,377,388,4696
1989,6112,505,709,56008,54930,59,8.435,40,5.718,8835,2348,6487,4.275,16.084,6590,1519,5071,2.765,11.997,2245,4.087,23.994,18,20,1019
1989,6113,1996,2348,974873,963227,113,4.846,81,3.473,89407,7660,81747,0.795,9.282,66335,8303,58032,0.862,6.887,23072,2.395,13.773,40,40,5768
1989,6114,2611,3168,52153,50700,643,21.061,413,13.528,14045,5272,8773,10.398,27.702,11225,4634,6591,9.14,22.14,2820,5.562,44.28,296,313,3338
1989,6115,4133,5100,75085,70542,757,15.294,456,9.213,19835,7276,12559,10.314,28.118,11038,3104,7934,4.4,15.647,8797,12.471,31.295,310,325,2068
1989,6116,12432,13091,103354,98811,2635,20.778,1816,14.32,27866,10691,17175,10.82,28.201,18666,8403,10263,8.504,18.891,9200,9.311,37.781,1414,1425,5936
1989,6117,1695,1747,19855,18551,338,19.76,265,15.493,5145,1896,3249,10.22,27.734,2586,873,1713,4.706,13.94,2559,13.794,27.88,203,203,700
1989,6211,182410,192323,1313893,1286202,13884,7.215,14115,7.335,220587,66571,154016,5.176,17.15,165461,57817,107644,4.495,12.864,55126,4.286,25.729,11476,11641,45107
1989,6212,99364,102223,521605,513459,5834,5.729,5036,4.946,78985,22211,56774,4.326,15.383,62663,18803,43860,3.662,12.204,16322,3.179,24.408,4019,4096,15735
1989,6213,55606,58306,233267,219551,8462,14.98,4828,8.547,62391,27909,34482,12.712,28.418,34814,14782,20032,6.733,15.857,27577,12.561,31.714,3605,3707,11520
1989,6214,7630,11757,213952,201981,1503,13.125,891,7.781,48604,16769,31835,8.302,24.064,24765,9539,15226,4.723,12.261,23839,11.803,24.522,557,577,5098
1989,6215,5422,7008,105343,99659,1227,18.124,751,11.093,27216,10504,16712,10.54,27.309,15986,6486,9500,6.508,16.041,11230,11.268,32.082,502,515,3397
1989,6216,5161,7598,321300,318543,1457,19.898,906,12.373,81905,26159,55746,8.212,25.712,74750,17688,57062,5.553,23.466,7155,2.246,46.933,535,565,7685
1989,6219,5521,6373,126375,122423,1076,17.307,764,12.289,30405,10739,19666,8.772,24.836,22308,7503,14805,6.129,18.222,8097,6.614,36.444,529,534,4260
1989,6221,3485,4902,3723990,3666495,180,3.619,324,6.514,263011,60334,202677,1.646,7.173,147093,69720,77373,1.902,4.012,115918,3.162,8.024,199,204,37798
1989,6222,535,874,329799,315250,68,7.958,29,3.394,41021,29281,11740,9.288,13.012,10562,6033,4529,1.914,3.35,30459,9.662,6.701,13,13,4284
1989,6223,211,277,103334,99626,40,15.152,14,5.303,11565,4894,6671,4.912,11.608,4090,2479,1611,2.488,4.105,7475,7.503,8.211,7,7,559
1989,6231,8075,13628,1195349,1173311,1058,7.802,923,6.807,164521,65915,98606,5.618,14.022,120783,58506,62277,4.986,10.294,43738,3.728,20.588,530,573,34856
1989,6232,5892,9737,214174,203301,1643,17.975,450,4.923,45233,21221,24012,10.438,22.249,23538,7121,16417,3.503,11.578,21695,10.671,23.156,304,312,5246
1989,6233,9236,10977,276765,269480,1743,16.316,1154,10.803,49134,20191,28943,7.493,18.233,34864,15592,19272,5.786,12.938,14270,5.295,25.875,768,811,11275
1989,6239,3514,4592,118880,114142,535,11.969,291,6.51,20454,5522,14932,4.838,17.92,10962,3412,7550,2.989,9.604,9492,8.316,19.208,183,188,1951
1989,6241,18041,24056,350604,337767,2762,11.803,1453,6.209,65234,19732,45502,5.842,19.313,39717,9524,30193,2.82,11.759,25517,7.555,23.517,898,904,5603
1989,6242,5090,5962,61103,58591,674,11.594,377,6.485,11935,4759,7176,8.122,20.37,6883,2255,4628,3.849,11.748,5052,8.623,23.495,218,218,1214
1989,6243,4745,7038,276237,272314,753,10.95,431,6.267,44915,9136,35779,3.355,16.494,37074,6918,30156,2.54,13.614,7841,2.879,27.229,192,213,2002
1989,6244,34528,41502,400280,386612,5805,14.324,3856,9.515,81308,35558,45750,9.197,21.031,53855,21665,32190,5.604,13.93,27453,7.101,27.86,3017,3068,16398
1989,7111,5244,5296,79158,78524,920,17.524,828,15.771,19549,5811,13738,7.4,24.896,18208,5032,13176,6.408,23.188,1341,1.708,46.376,588,590,3456
1989,7112,2464,2591,71537,72563,479,18.606,446,17.324,15915,5171,10744,7.126,21.933,17644,5014,12630,6.91,24.316,-1729,-2.383,43.866,337,337,3180
1989,7113,2388,2442,39836,37887,473,19.958,329,13.882,12178,3187,8991,8.412,32.143,8242,2388,5854,6.303,21.754,3936,10.389,43.508,238,241,1456
1989,7114,1240,1256,12260,11869,236,19.179,185,15.035,3428,1272,2156,10.717,28.883,2646,960,1686,8.089,22.294,782,6.589,44.589,145,146,789
1989,7115,12215,12252,70915,68403,3738,32.326,2361,20.418,27044,14732,12312,21.537,39.537,21848,7706,14142,11.266,31.94,5196,7.596,63.881,1740,1742,5312
1989,7121,2958,3217,61028,59424,317,10.133,140,4.475,9059,1088,7971,1.831,15.245,5726,569,5157,0.958,9.636,3333,5.609,19.272,107,108,452
1989,7131,1691,2474,76717,70527,416,17.344,265,11.049,18715,3723,14992,5.279,26.536,6835,1126,5709,1.597,9.691,11880,16.845,19.383,214,216,866
1989,7132,715,758,25940,24701,166,23.331,73,10.26,5544,2755,2789,11.154,22.445,3089,797,2292,3.227,12.506,2455,9.939,25.012,59,59,489
1989,7139,37199,40488,625757,613347,5589,13.848,5334,13.216,125166,43201,81965,7.043,20.407,99837,41117,58720,6.704,16.277,25329,4.13,32.555,4189,4283,31918
1989,7211,30220,36393,1401727,1366652,4911,13.62,4238,11.754,273313,127274,146039,9.313,19.999,205033,101720,103313,7.443,15.003,68280,4.996,30.005,3077,3159,63683
1989,7212,4064,4367,28905,28654,556,12.896,445,10.321,7833,3181,4652,11.102,27.337,7344,1924,5420,6.715,25.63,489,1.707,51.261,307,311,1325
1989,7213,3706,3807,20139,19709,327,8.538,373,9.739,4349,1955,2394,9.92,22.067,3506,1300,2206,6.596,17.789,843,4.277,35.579,268,268,1007
1989,7223,17190,31717,588692,581248,5787,18.523,4836,15.479,150541,68755,81786,11.829,25.9,136889,59290,77599,10.2,23.551,13652,2.349,47.102,2869,2920,27138
1989,7224,51367,52378,320099,315167,7906,15.061,8136,15.499,86901,44213,42688,14.028,27.573,76660,37115,39545,11.776,24.324,10241,3.249,48.647,6579,6593,30210
1989,7225,216747,292548,5597835,5511781,47457,16.447,39440,13.669,1227307,641197,586110,11.633,22.267,1051836,454173,597663,8.24,19.083,175471,3.184,38.167,29024,30139,306809
1989,8111,117030,124741,672642,653168,19295,15.721,15280,12.45,163825,78535,85290,12.024,25.082,124421,54580,69841,8.356,19.049,39404,6.033,38.098,11844,12077,43500
1989,8112,11620,13842,125956,121190,2024,14.75,1784,13.001,30678,10242,20436,8.451,25.314,21660,10104,11556,8.337,17.873,9018,7.441,35.746,1232,1272,5211
1989,8113,20411,21475,169030,163244,2862,13.472,2401,11.302,36791,12458,24333,7.632,22.537,25191,10257,14934,6.283,15.432,11600,7.106,30.863,1878,1887,7942
1989,8114,25850,27661,182196,177518,4504,16.47,3876,14.173,39658,19405,20253,10.931,22.34,30338,13103,17235,7.381,17.09,9320,5.25,34.18,2994,3011,9746
1989,8121,77664,87574,459526,452364,13684,15.761,12181,14.03,110967,57998,52969,12.821,24.53,96173,41121,55052,9.09,21.26,14794,3.27,42.52,9807,10036,31880
1989,8122,17240,20516,127573,126370,1730,8.463,1580,7.73,23126,9178,13948,7.263,18.3,20569,8745,11824,6.92,16.277,2557,2.023,32.554,1104,1188,6463
1989,8123,33653,40364,377256,374856,5247,13.014,5158,12.793,69834,27233,42601,7.265,18.63,65011,29246,35765,7.802,17.343,4823,1.287,34.686,3938,4157,20986
1989,8129,13700,22609,172744,170946,4143,18.764,3083,13.963,41177,19087,22090,11.166,24.088,37901,15954,21947,9.333,22.171,3276,1.916,44.343,1932,2024,9679
1989,8131,129674,129740,1080569,1064680,5992,4.649,4314,3.347,129233,17101,112132,1.606,12.138,97608,13355,84253,1.254,9.168,31625,2.97,18.336,2604,2604,7887
1989,8132,9011,10399,146800,140857,1191,11.789,599,5.929,24709,6890,17819,4.892,17.542,13102,3438,9664,2.441,9.302,11607,8.24,18.603,390,398,2305
1989,8133,8229,9578,106640,103144,1093,11.688,640,6.844,19211,5871,13340,5.692,18.625,12219,2980,9239,2.889,11.847,6992,6.779,23.693,411,427,1798
1989,8134,30621,32220,288868,282376,2785,8.777,1806,5.692,43480,10475,33005,3.71,15.398,30402,6985,23417,2.474,10.767,13078,4.631,21.533,1304,1316,4747
1989,8139,57070,59359,494395,485814,4706,7.947,4416,7.458,85318,19620,65698,4.039,17.562,68282,21167,47115,4.357,14.055,17036,3.507,28.11,3189,3231,16355
1990,1131,223,243,3034,2808,44,18.526,33,13.895,949,463,486,16.489,33.796,523,158,365,5.627,18.625,426,15.171,37.251,24,24,101
1990,1132,95,110,1636,1659,15,13.953,10,9.302,200,77,123,4.641,12.055,238,87,151,5.244,14.346,-38,-2.291,24.111,7,7,71
1990,1133,11274,11367,90492,89920,1865,16.639,1548,13.811,21079,8335,12744,9.269,23.442,19961,7057,12904,7.848,22.199,1118,1.243,44.397,1163,1163,5536
1990,1141,1009,1019,8023,7602,180,17.682,178,17.485,2850,1339,1511,17.615,37.493,1981,960,1021,12.629,26.061,869,11.432,52.121,131,131,683
1990,1142,151,155,1535,1386,26,17.049,21,13.77,458,80,378,5.774,33.057,158,66,92,4.764,11.404,300,21.653,22.808,16,16,50
1990,1151,4068,4407,57225,55966,664,15.376,487,11.277,17719,6579,11140,11.755,31.66,15495,5218,10277,9.324,27.686,2224,3.974,55.373,317,329,2630
1990,1152,2119,2151,14439,14171,407,19.395,302,14.391,3157,1479,1678,10.437,22.278,2629,905,1724,6.386,18.552,528,3.726,37.104,245,245,704
1990,1153,821,831,10768,10716,162,19.938,125,15.385,3028,1560,1468,14.558,28.258,2878,868,2010,8.1,26.858,150,1.4,53.717,85,85,667
1990,2111,6826,8213,119433,117631,853,10.264,1048,12.611,21253,8147,13106,6.926,18.068,17709,5708,12001,4.852,15.055,3544,3.013,30.11,681,694,2764
1990,2121,2097,2647,135394,136368,415,15.425,502,18.658,20402,7348,13054,5.388,14.961,22452,8874,13578,6.507,16.464,-2050,-1.503,29.922,365,368,5033
1990,2122,429,611,47283,45874,85,13.655,108,17.349,7562,2346,5216,5.114,16.484,4792,1839,2953,4.009,10.446,2770,6.038,20.892,80,80,929
1990,2123,3454,5090,104863,105508,408,8.039,378,7.448,15990,3753,12237,3.557,15.155,17247,5452,11795,5.167,16.347,-1257,-1.191,30.311,235,240,1327
1990,2131,7858,8899,162024,159127,1237,13.855,1295,14.505,38694,9796,28898,6.156,24.316,32567,14671,17896,9.22,20.466,6127,3.85,40.932,884,893,6634
1990,2211,1741,6198,595606,595172,299,4.867,189,3.077,30528,7228,23300,1.214,5.129,29488,3177,26311,0.534,4.955,1040,0.175,9.909,77,77,689
1990,2212,652,2626,147687,143627,312,12.274,144,5.665,15497,9839,5658,6.85,10.79,8007,2300,5707,1.601,5.575,7490,5.215,11.15,49,49,572
1990,2213,4117,4374,33392,33383,380,8.781,287,6.632,3939,1363,2576,4.083,11.8,3960,1503,2457,4.502,11.863,-21,-0.063,23.599,214,214,805
1990,2361,114426,114833,668456,664757,23564,20.87,19717,17.463,211832,87927,123905,13.227,31.866,204749,80132,124617,12.054,30.801,7083,1.066,61.601,14490,14496,60701
1990,2362,38547,39220,733150,723114,5032,12.831,5029,12.823,181821,39112,142709,5.409,25.144,160868,37975,122893,5.252,22.247,20953,2.898,44.493,3845,3849,29541
1990,2371,13694,14009,321078,313666,1398,10.03,1257,9.018,76804,15331,61473,4.888,24.486,61534,11406,50128,3.636,19.618,15270,4.868,39.235,942,945,8445
1990,2372,9764,9967,84697,84492,2023,20.102,2216,22.02,25540,11078,14462,13.111,30.228,25114,12836,12278,15.192,29.724,426,0.504,59.447,1817,1819,9854
1990,2373,9538,9935,264496,257321,953,9.568,1003,10.07,62167,8778,53389,3.411,24.159,47941,11650,36291,4.527,18.631,14226,5.529,37.262,735,736,7689
1990,2379,5007,5096,78104,79287,676,13.158,759,14.774,19289,3766,15523,4.75,24.328,21842,5095,16747,6.426,27.548,-2553,-3.22,48.656,583,583,3840
1990,2381,78167,78606,776664,769540,11578,14.818,10633,13.609,216024,59901,156123,7.784,28.072,202312,63770,138542,8.287,26.29,13712,1.782,52.58,8162,8172,51349
1990,2382,122411,124227,1306091,1298303,15684,12.755,13150,10.695,270982,65239,205743,5.025,20.872,255972,73184,182788,5.637,19.716,15010,1.156,39.432,10275,10289,58482
1990,2383,81846,82291,712902,706411,14565,17.865,13035,15.989,202951,65932,137019,9.333,28.73,189973,62697,127276,8.875,26.893,12978,1.837,53.785,10065,10073,49788
1990,2389,41727,41975,378777,371069,6193,14.873,5521,13.259,106100,26638,79462,7.179,28.593,90235,27766,62469,7.483,24.318,15865,4.275,48.635,4160,4161,21401
1990,3111,1164,1771,48853,48428,103,5.801,112,6.308,5698,1339,4359,2.765,11.766,4810,1620,3190,3.345,9.932,888,1.834,19.865,77,78,743
1990,3112,478,829,65258,65317,36,4.353,32,3.869,3553,609,2944,0.932,5.44,3745,173,3572,0.265,5.734,-192,-0.294,10.879,22,22,82
1990,3113,1578,1844,87256,86972,207,11.183,221,11.939,9189,1774,7415,2.04,10.566,8470,1775,6695,2.041,9.739,719,0.827,19.478,147,147,1062
1990,3114,1165,1594,176478,175630,124,7.786,121,7.598,20129,3329,16800,1.895,11.461,18794,3674,15120,2.092,10.701,1335,0.76,21.402,80,80,1829
1990,3115,1420,2031,137286,137978,112,5.433,173,8.392,12709,3746,8963,2.715,9.211,14219,4446,9773,3.222,10.305,-1510,-1.094,18.422,122,122,1838
1990,3116,3642,4261,386369,378649,312,7.292,347,8.11,42736,6774,35962,1.789,11.286,26910,6785,20125,1.792,7.107,15826,4.18,14.214,253,254,3845
1990,3117,705,822,46185,46681,75,9.096,80,9.703,8004,2360,5644,5.056,17.146,9052,2169,6883,4.646,19.391,-1048,-2.245,34.292,57,57,1258
1990,3118,9202,10573,303984,306212,1247,11.736,1352,12.724,33573,10434,23139,3.407,10.964,38030,15049,22981,4.915,12.42,-4457,-1.456,21.928,1012,1032,8047
1990,3119,2062,2427,132816,132290,248,10.231,242,9.983,16452,4707,11745,3.558,12.436,15616,5446,10170,4.117,11.804,836,0.632,23.609,173,173,2079
1990,3121,1751,2190,139566,139079,205,9.382,195,8.924,18960,8527,10433,6.131,13.633,18212,7488,10724,5.384,13.095,748,0.538,26.19,134,135,1512
1990,3122,97,131,37607,37155,6,4.528,9,6.792,3520,2521,999,6.785,9.474,2453,466,1987,1.254,6.602,1067,2.872,13.204,4,4,13
1990,3131,391,628,108085,109609,43,6.864,40,6.385,9038,2909,6129,2.654,8.246,12039,3230,8809,2.947,10.984,-3001,-2.738,16.491,23,23,947
1990,3132,1646,1981,246332,251072,153,7.718,156,7.869,18421,6145,12276,2.448,7.337,27833,7131,20702,2.84,11.086,-9412,-3.749,14.674,120,120,2960
1990,3133,1831,2082,109286,108980,271,13.409,149,7.373,16200,7524,8676,6.904,14.865,15713,6892,8821,6.324,14.418,487,0.447,28.836,97,98,1519
1990,3141,3608,3904,131704,132835,411,10.405,503,12.734,17621,7892,9729,5.941,13.265,20187,8450,11737,6.361,15.197,-2566,-1.932,26.531,415,417,3074
1990,3149,3959,4079,119245,119095,599,14.854,506,12.548,20448,7787,12661,6.539,17.17,20208,7606,12602,6.387,16.968,240,0.202,33.936,435,435,6170
1990,3151,1211,1339,132875,135739,147,10.849,179,13.21,17745,6739,11006,4.965,13.073,23714,5970,17744,4.398,17.47,-5969,-4.397,26.146,142,143,2357
1990,3152,11397,12694,735224,754953,2043,16.112,2015,15.891,101210,39972,61238,5.295,13.406,141111,53533,87578,7.091,18.691,-39901,-5.285,26.812,1675,1697,37551
1990,3159,1805,1892,64616,65289,278,14.791,253,13.461,10098,3012,7086,4.613,15.467,11614,3389,8225,5.191,17.789,-1516,-2.322,30.933,211,211,2682
1990,3161,331,356,16204,16199,26,7.123,44,12.055,1675,312,1363,1.926,10.34,1695,741,954,4.574,10.464,-20,-0.123,20.68,31,31,423
1990,3162,350,469,72961,75042,41,8.551,62,12.93,5597,1623,3974,2.163,7.459,9818,3360,6458,4.478,13.083,-4221,-5.625,14.917,48,51,1522
1990,3169,1070,1119,36371,36949,105,9.243,139,12.236,4830,849,3981,2.298,13.072,6033,1821,4212,4.928,16.328,-1203,-3.256,26.144,106,109,1446
1990,3211,4496,5034,144375,145199,431,8.489,517,10.183,15983,4877,11106,3.359,11.008,17741,5756,11985,3.964,12.218,-1758,-1.211,22.015,393,393,3203
1990,3212,1304,1610,103701,104062,136,8.455,133,8.269,10730,2350,8380,2.258,10.311,11658,4297,7361,4.129,11.203,-928,-0.892,20.622,89,89,1873
1990,3219,9167,9862,285191,289960,1056,10.707,1057,10.717,36474,10555,25919,3.64,12.579,46120,13916,32204,4.799,15.906,-9646,-3.327,25.158,829,834,9858
1990,3221,230,551,195787,193906,27,4.945,17,3.114,10152,3571,6581,1.842,5.236,6379,2142,4237,1.105,3.29,3773,1.946,6.579,7,7,217
1990,3222,3539,5177,400577,399576,275,5.31,279,5.387,32566,7703,24863,1.928,8.15,30766,7695,23071,1.926,7.7,1800,0.45,15.399,194,194,3110
1990,3231,42161,44151,853426,851066,4569,10.419,3975,9.064,103454,31262,72192,3.673,12.156,98940,34188,64752,4.017,11.625,4514,0.53,23.251,3237,3245,22115
1990,3241,1295,2221,141898,141620,167,7.548,150,6.78,8827,1572,7255,1.11,6.233,8224,1454,6770,1.027,5.807,603,0.426,11.614,88,88,635
1990,3251,1161,2335,234474,231458,171,7.414,114,4.943,15278,3535,11743,1.527,6.601,9196,1608,7588,0.695,3.973,6082,2.628,7.946,49,49,673
1990,3252,371,647,133908,134713,49,7.626,40,6.226,6355,1607,4748,1.193,4.717,7825,3108,4717,2.307,5.809,-1470,-1.091,9.435,17,17,180
1990,3253,634,891,42713,42721,60,6.734,60,6.734,4131,597,3534,1.397,9.67,4181,1728,2453,4.045,9.787,-50,-0.117,19.34,32,32,616
1990,3254,1084,1348,176154,175425,109,8.134,93,6.94,15268,1484,13784,0.846,8.703,13438,2472,10966,1.409,7.66,1830,1.043,15.321,62,62,1031
1990,3255,1619,2136,75941,76515,130,6.069,142,6.629,6590,1794,4796,2.345,8.613,7782,1667,6115,2.179,10.171,-1192,-1.558,17.225,85,85,718
1990,3256,2072,2340,121941,120353,236,10.194,186,8.035,14729,3366,11363,2.797,12.238,11531,2777,8754,2.307,9.581,3198,2.657,19.162,138,138,1609
1990,3259,2122,2781,134599,136223,241,8.697,221,7.975,11521,3542,7979,2.6,8.457,14666,3541,11125,2.599,10.766,-3145,-2.309,16.915,154,158,1727
1990,3261,10063,12057,677891,680757,1074,8.994,843,7.059,79639,21282,58357,3.126,11.699,85269,22523,62746,3.309,12.526,-5630,-0.827,23.397,591,596,9039
1990,3262,2115,2589,195010,197871,204,7.913,182,7.06,12520,3176,9344,1.605,6.327,18231,2764,15467,1.397,9.214,-5711,-2.886,12.655,133,133,1604
1990,3271,1459,1761,82268,82799,216,12.471,158,9.122,7491,2077,5414,2.508,9.047,8473,1231,7242,1.487,10.233,-982,-1.186,18.094,122,122,863
1990,3272,1798,2064,145978,146922,263,12.93,203,9.98,12560,4167,8393,2.836,8.549,14352,4025,10327,2.74,9.768,-1792,-1.22,17.098,157,157,1581
1990,3273,6467,9131,190235,190585,705,7.763,607,6.684,30385,8329,22056,4.37,15.943,30982,7886,23096,4.138,16.256,-597,-0.313,31.886,370,384,4256
1990,3274,267,378,18519,18012,65,18.056,29,8.056,2291,1421,870,7.889,12.719,1230,346,884,1.921,6.829,1061,5.891,13.658,24,24,185
1990,3279,1891,2200,78292,78121,190,8.625,196,8.897,7870,2304,5566,2.949,10.074,7554,2083,5471,2.666,9.67,316,0.405,19.339,142,142,974
1990,3311,315,371,160821,162408,31,8.435,24,6.531,3477,828,2649,0.51,2.141,6668,280,6388,0.172,4.106,-3191,-1.965,4.282,17,17,216
1990,3312,535,726,65133,66195,49,6.749,49,6.749,4515,1060,3455,1.601,6.821,6674,1539,5135,2.325,10.082,-2159,-3.262,13.642,33,33,536
1990,3313,419,595,100994,101452,38,6.424,31,5.241,5925,1453,4472,1.432,5.84,6796,1879,4917,1.852,6.699,-871,-0.859,11.68,18,18,478
1990,3314,768,932,85308,84468,89,9.616,76,8.212,7908,3640,4268,4.309,9.362,6377,1799,4578,2.13,7.55,1531,1.813,15.099,55,55,506
1990,3315,2572,2845,214438,219156,203,7.196,155,5.495,15361,4548,10813,2.075,7.009,24802,3535,21267,1.613,11.317,-9441,-4.308,14.018,108,108,1616
1990,3321,3324,3516,143150,144719,239,6.808,228,6.495,13593,4098,9495,2.832,9.393,16841,4177,12664,2.886,11.637,-3248,-2.244,18.785,172,172,2601
1990,3322,1310,1436,81816,82511,96,6.692,93,6.483,6662,1263,5399,1.531,8.074,8144,2812,5332,3.408,9.87,-1482,-1.796,16.148,60,60,660
1990,3323,10275,11111,344213,347095,960,8.698,812,7.357,43357,11638,31719,3.353,12.491,49185,13159,36026,3.791,14.17,-5828,-1.679,24.983,623,626,8211
1990,3324,1516,1847,117643,119257,118,6.41,106,5.758,10717,2664,8053,2.234,8.986,14085,4970,9115,4.167,11.811,-3368,-2.824,17.973,58,58,1044
1990,3325,965,1055,72159,73177,82,7.736,92,8.679,6537,2104,4433,2.875,8.933,8698,2248,6450,3.072,11.886,-2161,-2.953,17.866,66,67,737
1990,3326,1865,2060,70666,70790,220,10.845,157,7.74,8493,2368,6125,3.345,11.997,8760,2888,5872,4.08,12.375,-267,-0.377,23.995,114,114,1129
1990,3327,21445,21760,342382,344266,1798,8.279,1711,7.879,41644,10070,31574,2.925,12.096,45512,10496,35016,3.049,13.22,-3868,-1.124,24.193,1388,1391,8084
1990,3328,5490,5856,138356,140455,402,6.882,373,6.385,15853,4002,11851,2.849,11.287,20137,5358,14779,3.815,14.337,-4284,-3.05,22.574,293,295,3356
1990,3329,7085,7593,366577,368457,889,11.96,569,7.655,37671,12306,25365,3.34,10.224,41184,10020,31164,2.719,11.177,-3513,-0.953,20.448,438,439,4385
1990,3331,2889,3139,217482,215539,214,6.794,236,7.492,23433,5491,17942,2.548,10.872,19316,6945,12371,3.222,8.962,4117,1.91,17.923,155,155,2518
1990,3332,4172,4435,173490,175962,347,7.844,325,7.346,20240,4599,15641,2.614,11.503,24810,8781,16029,4.99,14.1,-4570,-2.597,23.005,247,247,2444
1990,3333,2296,2424,158178,157807,210,8.737,169,7.031,16511,3665,12846,2.322,10.463,15568,3016,12552,1.911,9.865,943,0.598,19.73,124,124,1187
1990,3334,1639,1893,161303,162966,153,8.119,136,7.217,14335,3443,10892,2.113,8.796,17739,2940,14799,1.804,10.885,-3404,-2.089,17.593,93,93,945
1990,3335,9428,9765,231246,232282,620,6.361,585,6.002,22502,5692,16810,2.45,9.687,24543,5635,18908,2.426,10.566,-2041,-0.879,19.375,470,471,3641
1990,3336,726,874,131184,132345,44,4.997,57,6.474,8134,1734,6400,1.31,6.146,10368,1280,9088,0.967,7.834,-2234,-1.688,12.292,36,36,555
1990,3339,5388,5979,323969,324993,418,7.003,397,6.652,33849,9517,24332,2.928,10.415,36083,11446,24637,3.522,11.103,-2234,-0.687,20.831,285,286,3425
1990,3341,1625,1771,261392,265219,214,12.097,210,11.871,30591,6173,24418,2.328,11.534,37902,9472,28430,3.571,14.291,-7311,-2.757,23.069,145,145,1889
1990,3342,1660,1866,243030,250633,238,13.059,151,8.285,25919,10988,14931,4.384,10.341,41115,13453,27662,5.368,16.404,-15196,-6.063,20.683,92,92,903
1990,3343,423,458,35900,35921,63,14.11,40,8.959,3943,1261,2682,3.511,10.977,3842,549,3293,1.528,10.696,101,0.281,21.392,31,31,393
1990,3344,5104,5721,526006,532421,770,13.754,525,9.378,53690,16219,37471,3.046,10.084,66224,17916,48308,3.365,12.438,-12534,-2.354,20.168,378,380,4906
1990,3345,4440,5076,644148,657982,358,7.055,355,6.996,47520,10979,36541,1.669,7.222,74560,15011,59549,2.281,11.332,-27040,-4.11,14.444,228,229,3539
1990,3346,757,804,56298,51776,102,12.742,95,11.868,15665,2884,12781,5.57,30.256,6831,1366,5465,2.638,13.193,8834,17.062,26.387,71,71,722
1990,3351,1162,1285,82887,84614,89,6.891,102,7.898,6726,1804,4922,2.132,7.949,10156,2358,7798,2.787,12.003,-3430,-4.054,15.898,74,75,1126
1990,3352,350,431,109306,110714,46,10.875,30,7.092,8655,2491,6164,2.25,7.817,11522,1443,10079,1.303,10.407,-2867,-2.59,15.635,20,20,345
1990,3353,2160,2635,229194,232060,203,7.775,155,5.936,19019,6366,12653,2.743,8.196,24520,5080,19440,2.189,10.566,-5501,-2.371,16.391,109,109,983
1990,3359,2108,2476,202880,205394,148,5.898,215,8.567,18771,4218,14553,2.054,9.139,23967,5432,18535,2.645,11.669,-5196,-2.53,18.278,153,153,2108
1990,3361,249,305,220656,225265,34,11.277,27,8.955,14365,1012,13353,0.449,6.377,22911,3345,19566,1.485,10.171,-8546,-3.794,12.754,21,21,209
1990,3362,1827,2030,113330,117648,202,9.902,222,10.882,14193,3671,10522,3.12,12.064,22327,4932,17395,4.192,18.978,-8134,-6.914,24.128,174,175,2205
1990,3363,4098,4974,654885,669356,438,8.853,385,7.782,49167,16633,32534,2.485,7.345,78515,11345,67170,1.695,11.73,-29348,-4.385,14.691,295,298,5432
1990,3364,1467,1799,691479,701912,182,10.317,112,6.349,57288,28028,29260,3.993,8.162,77734,25521,52213,3.636,11.075,-20446,-2.913,16.323,85,85,1419
1990,3365,168,208,31934,31407,23,11.275,15,7.353,4450,1462,2988,4.655,14.169,3298,522,2776,1.662,10.501,1152,3.668,21.002,10,10,177
1990,3366,1307,1413,163061,165839,160,11.445,130,9.299,16005,2985,13020,1.8,9.651,21546,3334,18212,2.01,12.992,-5541,-3.341,19.302,88,88,974
1990,3369,486,500,29899,30480,56,11.222,54,10.822,2928,306,2622,1.004,9.606,3956,706,3250,2.316,12.979,-1028,-3.373,19.213,47,47,387
1990,3371,13445,14081,392862,398636,1823,12.941,1834,13.02,47744,16656,31088,4.178,11.977,59225,20133,39092,5.05,14.857,-11481,-2.88,23.954,1457,1470,14521
1990,3372,3166,3368,163462,164149,394,11.802,335,10.034,19578,5353,14225,3.261,11.927,20887,5126,15761,3.123,12.724,-1309,-0.797,23.854,264,265,3282
1990,3379,1133,1278,43223,43328,130,10.16,133,10.395,5858,1399,4459,3.229,13.52,6063,2362,3701,5.452,13.993,-205,-0.473,27.041,104,109,1113
1990,3391,10452,10997,263816,260324,1097,10.023,992,9.064,33564,8937,24627,3.433,12.893,26265,6453,19812,2.479,10.089,7299,2.804,20.179,793,793,3679
1990,3399,16386,16915,420394,422233,2226,13.281,1918,11.443,57879,18971,38908,4.493,13.708,61464,19171,42293,4.54,14.557,-3585,-0.849,27.416,1529,1533,11034
1990,4231,21035,26048,313680,313654,2347,8.943,2739,10.437,46354,13605,32749,4.338,14.779,46366,18678,27688,5.955,14.783,-12,-0.004,29.557,2008,2109,12902
1990,4232,8558,9805,124796,124317,1231,12.599,1162,11.893,21703,8223,13480,6.615,17.458,20923,7218,13705,5.806,16.83,780,0.627,33.661,880,903,4760
1990,4233,8451,11098,145862,146248,1182,10.675,1131,10.214,21665,6729,14936,4.601,14.814,22560,7453,15107,5.096,15.426,-895,-0.612,29.628,806,838,4744
1990,4234,25502,35029,657319,651368,4242,12.187,3798,10.912,106524,31817,74707,4.885,16.354,94944,37481,57463,5.754,14.576,11580,1.778,29.152,2322,2437,17739
1990,4235,7119,9539,144135,143302,878,9.29,702,7.428,19317,5415,13902,3.779,13.48,17724,5049,12675,3.523,12.368,1593,1.112,24.737,462,488,3113
1990,4236,16703,24588,338509,332210,3324,13.82,2251,9.359,68241,30617,37624,9.216,20.542,54912,18228,36684,5.487,16.529,13329,4.012,33.059,1415,1461,9832
1990,4237,11263,15570,177802,176064,1281,8.265,1138,7.343,24798,7502,17296,4.261,14.085,21250,7054,14196,4.006,12.069,3548,2.015,24.139,779,803,4736
1990,4238,49169,64120,715971,705479,5816,9.122,5087,7.979,107769,31912,75857,4.523,15.276,86694,32065,54629,4.545,12.289,21075,2.987,24.577,3503,3636,20743
1990,4239,25092,26961,273498,271178,3578,13.34,3298,12.296,52053,17452,34601,6.436,19.195,47548,18346,29202,6.765,17.534,4505,1.661,35.068,2638,2668,12794
1990,4241,9043,12181,186434,180130,1193,9.872,1000,8.275,33553,16585,16968,9.207,18.627,21721,8341,13380,4.631,12.059,11832,6.569,24.117,656,667,4354
1990,4242,3162,4385,116772,115176,781,18.437,483,11.402,20133,8067,12066,7.004,17.48,16811,6121,10690,5.314,14.596,3322,2.884,29.192,314,318,2268
1990,4243,12219,13215,167742,165375,2029,15.446,1872,14.25,35651,11221,24430,6.785,21.558,30800,12474,18326,7.543,18.624,4851,2.933,37.249,1489,1516,8782
1990,4244,27358,33886,709372,704456,3638,10.719,3747,11.04,110501,33917,76584,4.815,15.686,100261,36798,63463,5.224,14.232,10240,1.454,28.465,2819,2852,21214
1990,4245,6749,9743,85418,85799,548,5.558,781,7.921,11777,3013,8764,3.512,13.726,12499,4449,8050,5.185,14.568,-722,-0.842,27.453,545,579,3121
1990,4246,7874,11449,137491,135050,1205,10.628,984,8.678,22659,6927,15732,5.129,16.778,17895,5394,12501,3.994,13.251,4764,3.528,26.501,587,618,2981
1990,4247,9252,12343,138347,137203,762,6.098,1066,8.531,21297,5295,16002,3.859,15.522,19111,6167,12944,4.495,13.929,2186,1.593,27.858,637,658,3576
1990,4248,3738,4792,137913,138179,253,5.193,412,8.457,14281,4082,10199,2.954,10.335,14729,5027,9702,3.638,10.659,-448,-0.324,20.67,304,315,3034
1990,4249,21967,26629,328663,318926,3519,13.356,2955,11.216,64962,22402,42560,7.024,20.369,45694,18111,27583,5.679,14.327,19268,6.042,28.655,2231,2297,12453
1990,4251,32215,34790,337941,335362,3752,10.9,3018,8.767,57145,18071,39074,5.389,17.04,51894,20031,31863,5.973,15.474,5251,1.566,30.948,2153,2161,12055
1990,4411,39484,41494,992400,1011801,4609,11.118,4534,10.937,116887,50502,66385,4.991,11.552,155734,59972,95762,5.927,15.392,-38847,-3.839,23.105,3645,3685,47323
1990,4412,11123,11818,89672,91485,1147,9.582,1451,12.122,15714,5964,9750,6.519,17.177,19374,7500,11874,8.198,21.177,-3660,-4.001,34.353,1183,1216,6517
1990,4413,46827,71048,534197,535576,4789,6.678,6115,8.527,77939,24374,53565,4.551,14.552,79974,29170,50804,5.446,14.932,-2035,-0.38,29.105,4052,4344,18912
1990,4421,21821,28268,242376,243633,2880,10.168,2990,10.557,39912,15168,24744,6.226,16.382,42559,15007,27552,6.16,17.468,-2647,-1.086,32.764,2173,2357,11262
1990,4422,23257,29813,196594,195358,3596,12.14,3211,10.84,40554,16614,23940,8.504,20.759,38023,13257,24766,6.786,19.463,2531,1.296,38.927,2385,2540,9595
1990,4431,23874,34186,251915,244161,5823,17.523,3914,11.778,62813,31838,30975,13.04,25.726,47258,18885,28373,7.735,19.355,15555,6.371,38.711,2575,2817,12244
1990,4441,55380,72305,802590,803453,5645,7.802,5733,7.924,112836,37374,75462,4.652,14.044,115134,36115,79019,4.495,14.33,-2298,-0.286,28.088,4166,4358,23347
1990,4442,16347,19877,158507,155622,1652,8.31,1656,8.33,26971,6900,20071,4.434,17.331,21217,7012,14205,4.506,13.634,5754,3.697,27.267,1256,1282,5373
1990,4451,62723,94889,2486655,2439571,10491,11.001,11448,12.004,369836,155263,214573,6.364,15.16,274881,112240,162641,4.601,11.268,94955,3.892,22.535,7738,7953,52338
1990,4452,20270,24887,162489,165020,3555,14.23,3747,14.998,33852,14519,19333,8.798,20.514,39181,16671,22510,10.102,23.743,-5329,-3.229,41.028,2917,2968,12884
1990,4453,26507,31406,153937,155337,3432,10.878,3720,11.791,29422,12400,17022,7.983,18.941,32217,12719,19498,8.188,20.74,-2795,-1.799,37.882,2836,2889,9426
1990,4461,48554,78326,753373,747824,7901,10.171,6610,8.509,119670,58028,61642,7.76,16.002,108552,40800,67752,5.456,14.516,11118,1.487,29.031,4181,4360,22397
1990,4471,83248,136100,976265,979540,12794,9.35,14258,10.42,185029,77677,107352,7.93,18.889,191278,77200,114078,7.881,19.527,-6249,-0.638,37.779,9485,10013,50404
1990,4481,52767,105923,983258,972194,12976,12.271,12628,11.941,199296,87787,111509,9.03,20.5,176183,62854,113329,6.465,18.122,23113,2.377,36.244,8036,8765,36225
1990,4482,10486,36955,209523,213229,3425,9.203,3949,10.611,39691,16557,23134,7.765,18.614,46448,18868,27580,8.849,21.783,-6757,-3.169,37.229,1565,1757,7150
1990,4483,19664,29533,181797,179775,3436,11.706,3073,10.47,37595,15292,22303,8.506,20.912,33444,13794,19650,7.673,18.603,4151,2.309,37.207,1954,2073,7530
1990,4511,33325,44122,336323,330749,5695,12.983,5178,11.805,69077,26612,42465,8.046,20.885,58459,20130,38329,6.086,17.675,10618,3.21,35.349,3973,4152,14348
1990,4512,8922,14125,100384,95935,1786,12.886,1255,9.055,22314,8068,14246,8.41,23.259,13461,5291,8170,5.515,14.031,8853,9.228,28.063,919,950,3834
1990,4522,198,6614,1171540,1149199,317,4.869,109,1.674,130290,37903,92387,3.298,11.337,85270,9549,75721,0.831,7.42,45020,3.918,14.84,8,8,409
1990,4523,11411,28377,990265,986047,2879,10.18,2685,9.494,126808,63670,63138,6.457,12.86,121370,32845,88525,3.331,12.309,5438,0.551,24.617,1408,1478,9420
1990,4531,24694,26172,138599,137512,3361,12.918,3054,11.738,28049,10653,17396,7.747,20.397,25864,10155,15709,7.385,18.809,2185,1.589,37.617,2426,2490,8207
1990,4532,31251,39579,266850,257956,5586,14.188,5168,13.127,66571,33007,33564,12.796,25.807,49305,20668,28637,8.012,19.114,17266,6.693,38.227,3982,4182,15556
1990,4533,10533,12537,68783,66813,2072,16.911,1503,12.267,15158,6548,8610,9.801,22.687,11239,5259,5980,7.871,16.822,3919,5.866,33.643,1178,1189,3831
1990,4539,25879,29866,162676,158456,5184,17.677,4104,13.994,42734,19119,23615,12.066,26.969,34264,15259,19005,9.63,21.624,8470,5.345,43.247,3062,3203,11533
1990,4541,5955,7323,125003,122433,1019,14.009,921,12.662,23925,6862,17063,5.605,19.541,18606,6065,12541,4.954,15.197,5319,4.344,30.394,627,637,3390
1990,4542,4269,5205,77217,77294,737,14.388,572,11.166,12408,6155,6253,7.963,16.053,12605,4391,8214,5.681,16.308,-197,-0.255,32.106,399,401,1952
1990,4543,16580,22988,227861,224316,2362,10.352,2021,8.857,40799,13402,27397,5.975,18.188,33815,11026,22789,4.915,15.075,6984,3.113,30.149,1572,1604,8369
1990,4811,692,2814,454353,426188,391,13.997,350,12.529,97452,19186,78266,4.502,22.866,40319,22643,17676,5.313,9.46,57133,13.406,18.921,98,107,2056
1990,4812,943,1030,13970,13358,208,20.978,131,13.212,3007,929,2078,6.955,22.512,1802,727,1075,5.443,13.491,1205,9.021,26.981,96,96,596
1990,4831,361,628,32077,33959,87,14.066,68,10.994,5394,1418,3976,4.176,15.884,9334,2002,7332,5.895,27.486,-3940,-11.602,31.768,32,39,906
1990,4832,307,340,12646,12860,40,11.765,40,11.765,1977,497,1480,3.865,15.374,2414,653,1761,5.078,18.772,-437,-3.398,30.748,28,28,402
1990,4841,21705,28088,590130,588057,4712,16.97,4069,14.654,105541,35200,70341,5.986,17.947,103055,33160,69895,5.639,17.525,2486,0.423,35.049,3140,3192,22204
1990,4842,47930,52488,576159,576695,7780,14.791,8004,15.217,117190,38015,79175,6.592,20.321,118311,46466,71845,8.057,20.515,-1121,-0.194,40.642,6245,6297,32693
1990,4851,427,455,40182,39285,62,14.123,30,6.834,3458,985,2473,2.507,8.802,1690,391,1299,0.995,4.302,1768,4.501,8.604,21,21,297
1990,4852,319,513,17965,18282,46,8.941,49,9.524,2847,976,1871,5.339,15.573,3525,747,2778,4.086,19.282,-678,-3.709,31.146,23,25,520
1990,4853,5134,5175,54583,54535,912,17.664,888,17.199,11826,5069,6757,9.295,21.685,11692,5988,5704,10.98,21.439,134,0.246,42.879,734,735,5097
1990,4854,3228,3757,112481,109155,328,8.763,300,8.015,20427,6834,13593,6.261,18.714,13616,5212,8404,4.775,12.474,6811,6.24,24.948,229,229,3550
1990,4855,791,841,19767,19396,132,15.932,107,12.915,4156,1475,2681,7.605,21.428,3435,1635,1800,8.43,17.71,721,3.717,35.421,82,82,1020
1990,4859,1070,1091,24314,23669,224,20.664,210,19.373,5466,2076,3390,8.771,23.093,4260,1861,2399,7.863,17.998,1206,5.095,35.996,178,178,1403
1990,4861,57,329,9324,9216,15,4.505,23,6.907,940,208,732,2.257,10.2,740,178,562,1.932,8.03,200,2.17,16.06,6,6,58
1990,4862,249,1428,52929,53759,92,6.447,90,6.307,5082,1253,3829,2.331,9.453,6703,963,5740,1.791,12.469,-1621,-3.015,18.907,22,22,107
1990,4869,68,360,6576,6677,30,8.357,28,7.799,592,166,426,2.486,8.867,783,202,581,3.026,11.728,-191,-2.861,17.734,6,6,29
1990,4871,260,270,4670,4675,51,19.03,47,17.537,922,309,613,6.61,19.724,914,366,548,7.83,19.553,8,0.171,39.106,39,39,305
1990,4872,803,824,8961,8367,167,20.72,131,16.253,2795,1198,1597,14.319,33.407,1617,489,1128,5.845,19.327,1178,14.08,38.654,107,107,397
1990,4879,104,109,863,815,22,20.853,15,14.218,300,100,200,12.277,36.832,190,60,130,7.366,23.327,110,13.505,46.654,12,12,57
1990,4881,2327,2902,84252,82118,445,15.519,376,13.112,16093,4803,11290,5.849,19.598,11541,5178,6363,6.306,14.054,4552,5.543,28.109,233,233,1698
1990,4882,434,619,18738,18446,89,14.602,70,11.485,2755,976,1779,5.291,14.936,2281,612,1669,3.318,12.366,474,2.57,24.732,26,26,289
1990,4883,2029,2446,83408,83037,264,10.745,286,11.64,13898,3539,10359,4.262,16.737,13039,3893,9146,4.688,15.703,859,1.034,31.405,207,207,1769
1990,4884,1952,2050,13276,12574,728,39.662,299,16.29,4464,2861,1603,22.753,35.502,3093,1451,1642,11.54,24.598,1371,10.903,49.197,223,225,1035
1990,4885,7407,9911,120000,115597,1515,15.68,1017,10.526,28978,11110,17868,9.611,25.068,20051,7785,12266,6.735,17.346,8927,7.723,34.691,696,709,4556
1990,4889,683,720,8724,8190,160,23.358,90,13.139,2560,1575,985,19.232,31.26,1521,314,1207,3.834,18.573,1039,12.687,37.145,76,76,235
1990,4921,1460,4023,350494,343258,599,15.273,397,10.122,39739,13339,26400,3.886,11.577,25558,10191,15367,2.969,7.446,14181,4.131,14.891,224,225,1976
1990,4922,3739,4025,64675,64141,624,15.453,650,16.097,13186,4169,9017,6.5,20.558,11993,4667,7326,7.276,18.698,1193,1.86,37.396,538,549,3987
1990,4931,6437,10334,442538,434711,1049,10.285,779,7.638,76767,27422,49345,6.308,17.659,60475,15386,45089,3.539,13.912,16292,3.748,27.823,356,367,3241
1990,5111,14662,17229,708057,700261,2194,12.897,1759,10.34,79287,24749,54538,3.534,11.322,63705,23791,39914,3.397,9.097,15582,2.225,18.195,1371,1387,10960
1990,5112,3864,4485,81800,77552,1071,25.053,651,15.228,21905,7668,14237,9.888,28.246,13652,5486,8166,7.074,17.604,8253,10.642,35.207,477,479,3625
1990,5121,9713,14360,243734,228590,2342,16.542,1937,13.682,76497,23909,52588,10.459,33.465,45325,22869,22456,10.004,19.828,31172,13.637,39.656,1202,1242,9041
1990,5122,2274,2296,17121,16920,362,15.457,454,19.385,4253,1321,2932,7.807,25.136,3965,1713,2252,10.124,23.434,288,1.702,46.868,374,374,1369
1990,5151,6227,7760,239807,240502,983,12.728,909,11.77,34284,15224,19060,6.33,14.255,36224,14455,21769,6.01,15.062,-1940,-0.807,28.51,622,639,9279
1990,5152,197,296,13823,12576,45,14.975,54,17.97,3881,1850,2031,14.711,30.862,1411,901,510,7.165,11.22,2470,19.641,22.44,25,25,247
1990,5173,5257,23948,1051360,1048830,2369,9.88,2427,10.122,127946,38894,89052,3.708,12.199,124064,35964,88100,3.429,11.829,3882,0.37,23.658,605,620,7127
1990,5174,210,366,17510,15403,60,16.997,34,9.632,5528,2310,3218,14.997,35.889,1290,381,909,2.474,8.375,4238,27.514,16.75,15,15,185
1990,5179,1015,1801,42173,41412,408,23.294,309,17.642,8873,4289,4584,10.357,21.426,7216,2720,4496,6.568,17.425,1657,4.001,34.85,193,193,1311
1990,5182,5494,7733,291198,283552,1255,16.373,1119,14.599,60737,25339,35398,8.936,21.42,44906,17754,27152,6.261,15.837,15831,5.583,31.674,614,623,5006
1990,5191,2662,3050,32589,33372,326,10.669,337,11.029,5162,2173,2989,6.512,15.468,6628,4595,2033,13.769,19.861,-1466,-4.393,30.937,196,196,1265
1990,5211,48,83,25208,25416,3,3.659,(D),(D),594,30,564,0.118,2.337,997,(D),852,(D),3.923,-403,-1.586,4.674,0,0,0
1990,5221,17771,79633,2081109,2069087,4805,6.093,3262,4.136,266467,93893,172574,4.538,12.878,243520,51100,192420,2.47,11.769,22947,1.109,23.539,1035,1084,19353
1990,5222,21245,39929,492953,490119,4819,12.104,4589,11.526,102140,37218,64922,7.594,20.84,95492,40273,55219,8.217,19.483,6648,1.356,38.967,1700,1717,11737
1990,5223,6012,7015,74848,72024,1801,27.06,1082,16.257,21092,10174,10918,14.126,29.285,15515,6209,9306,8.621,21.541,5577,7.743,43.083,802,805,4531
1990,5231,6783,16449,321767,330527,3960,25.668,1917,12.426,73303,34290,39013,10.374,22.178,90942,31972,58970,9.673,27.514,-17639,-5.337,44.355,1014,1025,7188
1990,5232,90,102,7420,7384,6,5.687,13,12.322,438,8,430,0.108,5.932,352,113,239,1.53,4.767,86,1.165,9.535,8,8,84
1990,5239,15728,16583,205480,195539,3205,19.681,2608,16.015,56725,21000,35725,10.74,29.01,36738,17130,19608,8.76,18.788,19987,10.221,37.576,1998,1999,10502
1990,5241,7039,39044,1439040,1429664,4563,11.821,3678,9.528,199297,61804,137493,4.323,13.94,182016,44417,137599,3.107,12.731,17281,1.209,25.463,570,579,6064
1990,5242,104287,110492,833702,828215,13934,12.773,11137,10.209,172026,73192,98834,8.837,20.771,158866,62958,95908,7.602,19.182,13160,1.589,38.363,8214,8230,38051
1990,5259,815,998,17425,15276,97,9.633,115,11.42,6199,959,5240,6.278,40.58,2190,1084,1106,7.096,14.336,4009,26.244,28.672,63,63,790
1990,5311,97722,102129,580357,570681,13812,13.627,12263,12.099,130893,62981,67912,11.036,22.936,111263,51612,59651,9.044,19.497,19630,3.44,38.993,9784,9806,37292
1990,5312,41347,44189,248289,246019,7189,16.407,6443,14.705,59019,27042,31977,10.992,23.99,54543,22441,32102,9.122,22.17,4476,1.819,44.34,4767,4785,15561
1990,5313,25936,27610,331257,325804,4616,16.859,4156,15.179,75214,30542,44672,9.374,23.086,64196,23905,40291,7.337,19.704,11018,3.382,39.408,3105,3115,14817
1990,5321,5459,10273,142201,141290,1063,10.21,1340,12.87,23490,7395,16095,5.234,16.625,21742,8411,13331,5.953,15.388,1748,1.237,30.777,810,913,6370
1990,5322,20876,27005,194081,185078,4928,18.554,4040,15.21,58785,28578,30207,15.441,31.762,41023,17442,23581,9.424,22.165,17762,9.597,44.331,3176,3331,14334
1990,5323,4272,6150,45618,44885,678,11.035,666,10.84,10267,3477,6790,7.746,22.874,8805,3064,5741,6.826,19.617,1462,3.257,39.234,464,479,2130
1990,5324,8021,10315,120299,115802,1275,12.348,1296,12.551,29815,8942,20873,7.722,25.747,21271,8070,13201,6.969,18.368,8544,7.378,36.737,931,949,5892
1990,5331,1028,1103,18428,17459,232,21.462,188,17.391,5153,1408,3745,8.065,29.515,3090,1454,1636,8.328,17.699,2063,11.816,35.397,130,130,1190
1990,5411,136006,141305,983068,968148,15022,10.717,12742,9.091,149165,50647,98518,5.231,15.407,118846,44979,73867,4.646,12.276,30319,3.132,24.551,9724,9790,34450
1990,5412,69696,73906,687039,679570,10336,14.189,8212,11.273,124243,44772,79471,6.588,18.283,109868,36974,72894,5.441,16.167,14375,2.115,32.335,6125,6179,26312
1990,5413,62518,70153,992274,971987,10186,14.807,7467,10.854,203029,65504,137525,6.739,20.888,163624,42281,121343,4.35,16.834,39405,4.054,33.668,5452,5517,26562
1990,5414,16656,16889,104539,103523,3181,19.204,2532,15.286,24922,10467,14455,10.111,24.074,23030,10907,12123,10.536,22.246,1892,1.828,44.493,2080,2082,7982
1990,5415,24065,27353,415433,396294,6841,26.163,4430,16.942,106875,48380,58495,12.208,26.969,69130,29535,39595,7.453,17.444,37745,9.524,34.888,3270,3293,16339
1990,5416,44924,47128,428308,412820,9005,19.277,8175,17.5,124810,48278,76532,11.695,30.234,93853,41650,52203,10.089,22.735,30957,7.499,45.469,6559,6583,32564
1990,5417,6843,8519,461872,454363,1115,13.317,822,9.818,55445,15974,39471,3.516,12.203,39978,7423,32555,1.634,8.799,15467,3.404,17.597,513,517,3324
1990,5418,28449,30771,390265,376824,5088,16.811,4079,13.477,90418,24729,65689,6.562,23.995,64437,24413,40024,6.479,17.1,25981,6.895,34.2,3229,3267,18182
1990,5419,34226,38081,310210,300789,4472,11.924,3321,8.855,68329,23114,45215,7.684,22.717,49433,16752,32681,5.569,16.434,18896,6.282,32.869,2555,2570,11395
1990,5511,27609,52010,3283293,3248285,6817,13.398,4555,8.953,567889,187631,380258,5.776,17.483,496360,122519,373841,3.772,15.281,71529,2.202,30.561,1046,1075,12888
1990,5611,12169,13172,253035,249132,2006,15.292,1898,14.469,64451,27491,36960,11.035,25.87,56981,24757,32224,9.937,22.872,7470,2.998,45.744,1458,1480,18670
1990,5612,453,808,76722,76841,139,17.832,82,10.52,14228,4957,9271,6.451,18.516,14203,3899,10304,5.074,18.484,25,0.033,36.967,42,42,1989
1990,5613,19063,26728,1605570,1527357,4774,18.413,3174,12.242,507480,163237,344243,10.688,33.226,352101,81235,270866,5.319,23.053,155379,10.173,46.106,2211,2253,46373
1990,5614,22992,26154,347146,335699,4307,16.769,3368,13.113,82461,29183,53278,8.693,24.564,59563,25652,33911,7.641,17.743,22898,6.821,35.486,2617,2653,17434
1990,5615,25010,30462,244032,240625,4082,13.564,3347,11.122,51012,19252,31760,8.001,21.2,43943,19203,24740,7.98,18.262,7069,2.938,36.524,2441,2563,13446
1990,5616,12789,16102,540873,524040,2685,17.031,2012,12.762,124693,41306,83387,7.882,23.795,90865,31135,59730,5.941,17.339,33828,6.455,34.679,1510,1523,18866
1990,5617,89148,93389,1146440,1136051,19951,21.956,14913,16.411,283915,105073,178842,9.249,24.991,261240,106018,155222,9.332,22.995,22675,1.996,45.991,11914,11937,61647
1990,5619,15507,16814,228469,225295,2979,18.132,2210,13.451,56941,21886,35055,9.714,25.274,50030,16319,33711,7.243,22.206,6911,3.068,44.413,1682,1698,10210
1990,5621,3215,3343,40825,39205,461,14.222,258,7.959,8020,2792,5228,7.122,20.457,4800,1624,3176,4.142,12.243,3220,8.213,24.487,211,211,1275
1990,5622,1939,2793,78820,75543,377,13.737,280,10.202,16182,4548,11634,6.02,21.421,9655,4047,5608,5.357,12.781,6527,8.64,25.562,172,172,1639
1990,5629,5057,5386,67898,65879,860,16.216,695,13.105,18819,5588,13231,8.482,28.566,14706,6415,8291,9.738,22.323,4113,6.243,44.646,533,534,4177
1990,6111,13563,14707,465797,458098,626,4.266,560,3.816,46237,7916,38321,1.728,10.093,30767,6875,23892,1.501,6.716,15470,3.377,13.433,395,396,5050
1990,6112,507,716,59061,57606,59,8.258,56,7.838,9789,4489,5300,7.793,16.993,7195,1598,5597,2.774,12.49,2594,4.503,24.98,27,34,1035
1990,6113,2030,2388,1029524,1008473,103,4.346,67,2.827,102863,17969,84894,1.782,10.2,61375,12539,48836,1.243,6.086,41488,4.114,12.172,36,36,1724
1990,6114,2824,3382,53548,52780,669,20.396,465,14.177,12969,5013,7956,9.498,24.572,11474,5297,6177,10.036,21.74,1495,2.833,43.479,325,344,3770
1990,6115,4404,5401,76531,76331,763,14.511,477,9.072,16893,5247,11646,6.874,22.131,16466,4431,12035,5.805,21.572,427,0.559,43.144,306,306,2170
1990,6116,13283,13987,113738,108849,2745,20.223,1918,14.13,29628,11677,17951,10.728,27.219,19763,7795,11968,7.161,18.156,9865,9.063,36.313,1522,1538,6073
1990,6117,1895,1954,21640,20777,430,23.168,234,12.608,4598,1475,3123,7.099,22.13,2852,1309,1543,6.3,13.727,1746,8.404,27.453,182,182,1113
1990,6211,182865,193378,1398405,1363428,13883,7.198,12888,6.682,232220,69544,162676,5.101,17.032,163546,55089,108457,4.04,11.995,68674,5.037,23.99,10613,10770,42311
1990,6212,100304,103242,538992,530413,5575,5.426,4588,4.465,78084,19743,58341,3.722,14.721,61073,17194,43879,3.242,11.514,17011,3.207,23.028,3719,3763,14594
1990,6213,59042,61909,257669,245600,8496,14.13,4931,8.201,63602,25004,38598,10.181,25.897,39591,16120,23471,6.564,16.12,24011,9.776,32.24,3834,3892,12660
1990,6214,7780,12256,231179,223259,1458,12.146,953,7.939,44472,14579,29893,6.53,19.92,28440,10187,18253,4.563,12.739,16032,7.181,25.477,545,577,5473
1990,6215,5562,7236,114957,109050,992,13.93,763,10.714,26139,9889,16250,9.068,23.97,14093,5344,8749,4.901,12.923,12046,11.046,25.847,542,566,3683
1990,6216,5315,8039,367760,346180,1229,15.682,825,10.527,91706,28475,63231,8.226,26.491,47905,13979,33926,4.038,13.838,43801,12.653,27.676,535,547,8192
1990,6219,5680,6627,136027,131319,982,15.134,705,10.865,30353,10584,19769,8.06,23.114,20706,9679,11027,7.371,15.768,9647,7.346,31.535,522,525,6104
1990,6221,3462,4923,3876476,3814530,145,2.94,162,3.285,250261,45790,204471,1.2,6.561,127677,42001,85676,1.101,3.347,122584,3.214,6.694,85,96,18793
1990,6222,557,927,339256,335765,61,6.718,23,2.533,22986,12729,10257,3.791,6.846,16794,2272,14522,0.677,5.002,6192,1.844,10.003,11,11,1468
1990,6223,221,298,110508,108248,23,7.917,8,2.754,7581,1578,6003,1.458,7.003,2971,832,2139,0.769,2.745,4610,4.259,5.489,4,4,545
1990,6231,8310,13930,1244129,1220758,983,7.126,711,5.154,155852,61218,94634,5.015,12.767,108851,42143,66708,3.452,8.917,47001,3.85,17.833,364,401,22739
1990,6232,6331,10950,239035,228144,1699,16.385,538,5.188,49582,23436,26146,10.272,21.733,27431,8448,18983,3.703,12.024,22151,9.709,24.047,362,385,5841
1990,6233,9586,11391,291362,283816,1667,14.901,1260,11.263,49062,19302,29760,6.801,17.287,34009,15226,18783,5.365,11.983,15053,5.304,23.966,834,848,9758
1990,6239,3700,4910,126763,122880,604,12.697,298,6.264,19811,7592,12219,6.178,16.122,12064,3658,8406,2.977,9.818,7747,6.305,19.635,192,192,1953
1990,6241,19153,25680,375077,363083,3172,12.733,1637,6.571,63357,20624,42733,5.68,17.45,39344,10336,29008,2.847,10.836,24013,6.614,21.672,1114,1130,6563
1990,6242,5311,6238,65288,63221,680,11.14,412,6.75,11956,3787,8169,5.99,18.912,7820,2691,5129,4.257,12.369,4136,6.542,24.739,296,297,1792
1990,6243,4910,7385,286145,281865,729,10.07,438,6.05,43564,8213,35351,2.914,15.456,35196,5109,30087,1.813,12.487,8368,2.969,24.974,214,242,2407
1990,6244,36020,43610,431496,415880,6076,14.274,3987,9.367,87167,36745,50422,8.835,20.96,55770,22131,33639,5.321,13.41,31397,7.55,26.82,3192,3239,17687
1990,7111,5577,5630,87999,83475,1116,20.413,790,14.45,24334,7433,16901,8.905,29.151,15228,5085,10143,6.092,18.243,9106,10.909,36.485,584,585,3661
1990,7112,2543,2683,78460,75011,503,19.064,414,15.691,18532,5022,13510,6.695,24.706,11736,3730,8006,4.973,15.646,6796,9.06,31.292,314,314,2247
1990,7113,2461,2521,43013,41348,444,17.874,370,14.895,11497,3285,8212,7.945,27.805,8165,2159,6006,5.222,19.747,3332,8.058,39.494,282,283,1423
1990,7114,1347,1364,14582,13354,281,21.467,171,13.063,5275,2724,2551,20.399,39.503,2749,1211,1538,9.069,20.586,2526,18.916,41.173,139,139,920
1990,7115,11364,11401,79016,74108,1970,16.816,2598,22.177,28440,8711,19729,11.755,38.377,18747,9525,9222,12.853,25.297,9693,13.08,50.594,2066,2067,7977
1990,7121,3081,3340,64517,62815,343,10.459,222,6.769,8618,1802,6816,2.869,13.72,5255,1294,3961,2.06,8.366,3363,5.354,16.732,158,161,1115
1990,7131,1634,2485,82297,79495,347,14,334,13.476,12994,2569,10425,3.232,16.346,7151,2061,5090,2.593,8.996,5843,7.35,17.991,224,232,1377
1990,7132,766,821,28609,27357,177,22.462,111,14.086,5552,2856,2696,10.44,20.295,2990,1240,1750,4.533,10.93,2562,9.365,21.859,85,85,904
1990,7139,37825,40985,655135,640440,5667,13.899,5241,12.854,132416,47247,85169,7.377,20.676,102759,39455,63304,6.161,16.045,29657,4.631,32.09,4025,4091,29331
1990,7211,30308,36802,1446048,1425102,4504,12.306,4103,11.21,256944,112461,144483,7.891,18.03,213694,94226,119468,6.612,14.995,43250,3.035,29.99,2988,3073,60658
1990,7212,4167,4462,28932,28865,577,13.057,491,11.111,6907,2312,4595,8.01,23.929,6613,2548,4065,8.827,22.91,294,1.019,45.82,315,331,1902
1990,7213,3634,3743,19570,19783,284,7.529,342,9.067,3140,937,2203,4.736,15.872,3547,1261,2286,6.374,17.93,-407,-2.057,31.744,249,249,832
1990,7223,16935,32052,585871,587875,5511,17.296,5134,16.112,140788,64443,76345,10.962,23.949,144305,60357,83948,10.267,24.547,-3517,-0.598,47.897,2786,2815,26764
1990,7224,51696,52658,332427,326012,8217,15.641,7972,15.175,90732,47759,42973,14.649,27.831,78159,37876,40283,11.618,23.974,12573,3.857,47.949,6490,6517,31484
1990,7225,220482,298863,5743424,5670239,46546,15.738,40319,13.633,1199516,633885,565631,11.179,21.155,1055090,437835,617255,7.722,18.608,144426,2.547,37.215,30247,31171,303729
1990,8111,120128,128415,692086,682690,18642,14.723,15048,11.885,153098,68969,84129,10.103,22.426,134338,56548,77790,8.283,19.678,18760,2.748,39.355,11966,12104,46568
1990,8112,11951,14216,133971,131226,2054,14.627,1708,12.163,28478,10787,17691,8.22,21.701,22954,9229,13725,7.033,17.492,5524,4.21,34.984,1233,1255,4640
1990,8113,20822,21946,176829,173686,2843,13.088,2394,11.021,35623,11560,24063,6.656,20.51,29442,10944,18498,6.301,16.951,6181,3.559,33.903,1891,1901,7983
1990,8114,26432,28333,185052,184294,4532,16.179,3889,13.884,35784,14419,21365,7.824,19.417,34377,12679,21698,6.88,18.653,1407,0.763,37.307,3065,3095,9457
1990,8121,77462,88119,475005,467174,13156,14.979,12578,14.321,111354,55044,56310,11.782,23.836,96164,42240,53924,9.042,20.584,15190,3.251,41.168,10196,10374,33070
1990,8122,16977,20407,130587,129024,1426,6.968,1544,7.544,20722,7092,13630,5.497,16.061,17592,6188,11404,4.796,13.635,3130,2.426,27.269,1162,1217,5093
1990,8123,34314,41166,383637,380989,5560,13.629,4821,11.817,67150,28148,39002,7.388,17.625,61929,24373,37556,6.397,16.255,5221,1.37,32.51,3741,3924,18994
1990,8129,14067,22955,178518,175696,3645,16.006,3281,14.407,42595,18345,24250,10.441,24.244,36684,16900,19784,9.619,20.879,5911,3.364,41.758,2026,2083,9689
1990,8131,131809,131872,1111391,1095820,6221,4.756,4107,3.14,130463,19259,111204,1.757,11.906,99165,11523,87642,1.052,9.049,31298,2.856,18.099,2448,2448,7177
1990,8132,9451,10899,155157,151149,1123,10.533,649,6.087,24779,5956,18823,3.94,16.394,16621,4299,12322,2.844,10.996,8158,5.397,21.993,426,426,2519
1990,8133,8609,10057,113396,110752,1108,11.283,635,6.466,20581,5462,15119,4.932,18.583,15183,3288,11895,2.969,13.709,5398,4.874,27.418,429,429,1934
1990,8134,30956,32596,302640,295835,2280,7.033,1922,5.929,43771,9235,34536,3.122,14.796,30055,6481,23574,2.191,10.159,13716,4.636,20.319,1398,1398,4628
1990,8139,57763,59963,513730,503817,4730,7.927,4149,6.953,86495,20888,65607,4.146,17.168,66023,18606,47417,3.693,13.105,20472,4.063,26.209,3003,3013,12765
1991,1131,233,253,3290,3208,40,15.842,39,15.446,650,166,484,5.175,20.265,495,209,286,6.516,15.433,155,4.832,30.865,30,30,143
1991,1132,104,119,1702,1672,16,13.974,7,6.114,290,184,106,11.008,17.35,231,21,210,1.256,13.82,59,3.53,27.64,5,5,8
1991,1133,11155,11244,84441,88272,1513,13.288,1798,15.791,17428,5952,11476,6.743,19.744,25150,8990,16160,10.184,28.491,-7722,-8.748,39.487,1279,1282,6785
1991,1141,1006,1014,10109,9202,150,14.641,171,16.691,3795,1116,2679,12.128,41.243,2045,811,1234,8.814,22.225,1750,19.019,44.449,123,123,550
1991,1142,177,183,1934,1743,35,20.173,16,9.222,534,180,354,10.327,30.637,155,29,126,1.664,8.893,379,21.744,17.785,14,14,26
1991,1151,4322,4629,58144,58590,594,12.92,531,11.55,16622,5524,11098,9.428,28.37,17575,4877,12698,8.324,29.997,-953,-1.627,56.741,339,341,3128
1991,1152,2309,2342,16004,15533,395,17.272,285,12.462,3386,1462,1924,9.412,21.799,2428,823,1605,5.298,15.631,958,6.168,31.262,222,222,658
1991,1153,910,928,11219,11048,188,21.135,111,12.479,3341,1206,2135,10.916,30.242,3052,1091,1961,9.876,27.626,289,2.616,55.252,86,86,877
1991,2111,6887,8230,116769,116949,924,11.161,1021,12.333,18732,7741,10991,6.619,16.017,19302,7196,12106,6.153,16.505,-570,-0.487,32.035,664,676,3249
1991,2121,1933,2465,127841,131623,330,12.964,491,19.289,18247,7551,10696,5.737,13.863,25646,9622,16024,7.31,19.484,-7399,-5.621,27.726,364,366,5864
1991,2122,407,587,45931,46593,77,12.887,98,16.402,3974,1366,2608,2.932,8.529,5257,684,4573,1.468,11.283,-1283,-2.754,17.059,61,61,319
1991,2123,3498,5159,101492,103436,406,7.827,462,8.907,14097,4412,9685,4.265,13.629,18041,5292,12749,5.116,17.442,-3944,-3.813,27.257,260,265,2170
1991,2131,8568,9619,179098,173842,1301,13.619,1169,12.237,46446,18101,28345,10.412,26.717,35980,14371,21609,8.267,20.697,10466,6.02,41.394,825,834,7314
1991,2211,1693,6585,599068,598145,618,9.663,239,3.737,43122,18744,24378,3.134,7.209,41414,5963,35451,0.997,6.924,1708,0.286,13.847,95,95,1396
1991,2212,768,2815,146039,147556,193,6.871,181,6.444,9454,2793,6661,1.893,6.407,12341,3090,9251,2.094,8.364,-2887,-1.957,12.814,83,84,731
1991,2213,4115,4466,32588,32597,427,9.686,312,7.077,4522,2382,2140,7.307,13.872,4540,1808,2732,5.547,13.928,-18,-0.055,27.745,228,229,935
1991,2361,113496,113926,580466,627816,20825,18.12,22824,19.86,154197,66982,87215,10.669,24.561,249000,88768,160232,14.139,39.661,-94803,-15.1,49.122,15799,15803,64760
1991,2362,37551,38206,648099,688766,4341,11.193,5494,14.166,122351,26217,96134,3.806,17.764,203957,53791,150166,7.81,29.612,-81606,-11.848,35.528,4094,4104,35996
1991,2371,13767,14112,308976,316007,1265,8.911,1434,10.101,58725,12188,46537,3.857,18.583,73113,15240,57873,4.823,23.137,-14388,-4.553,37.167,1042,1046,10490
1991,2372,9574,9786,79091,87390,1553,15.126,2515,24.496,19916,8598,11318,9.839,22.79,36303,15058,21245,17.231,41.542,-16387,-18.752,45.58,2024,2029,11567
1991,2373,9321,9719,235591,248288,810,8.218,1086,11.018,42256,6849,35407,2.758,17.019,67740,13868,53872,5.585,27.283,-25484,-10.264,34.038,789,792,10439
1991,2379,4816,4899,68162,73221,626,12.546,807,16.174,15451,4135,11316,5.647,21.102,25367,6569,18798,8.971,34.644,-9916,-13.543,42.204,613,613,4439
1991,2381,76887,77320,669948,725722,9844,12.554,12032,15.344,150557,44650,105907,6.152,20.746,262493,68009,194484,9.371,36.17,-111936,-15.424,41.492,8683,8689,51107
1991,2382,123403,125269,1205564,1260696,13881,11.038,14848,11.807,214438,56499,157939,4.482,17.009,324916,87048,237868,6.905,25.773,-110478,-8.763,34.019,11122,11145,67527
1991,2383,81300,81773,612382,665241,12928,15.664,14449,17.507,142652,51325,91327,7.715,21.444,249163,72281,176882,10.865,37.455,-106511,-16.011,42.887,10405,10415,54474
1991,2389,41474,41719,342671,362683,5358,12.727,6117,14.53,79255,25679,53576,7.08,21.852,119315,32126,87189,8.858,32.898,-40060,-11.045,43.705,4430,4433,24567
1991,3111,1200,1808,48754,49119,107,5.91,112,6.186,5482,1442,4040,2.936,11.161,6127,2092,4035,4.259,12.474,-645,-1.313,22.322,63,65,734
1991,3112,476,819,65409,65338,30,3.612,53,6.382,4199,712,3487,1.09,6.427,4136,1350,2786,2.066,6.33,63,0.096,12.66,35,35,438
1991,3113,1552,1795,86564,87102,171,9.427,209,11.521,8541,2444,6097,2.806,9.806,9600,3224,6376,3.701,11.022,-1059,-1.216,19.611,144,148,2363
1991,3114,1174,1603,173858,175823,115,7.127,136,8.429,18366,4157,14209,2.364,10.446,22463,6450,16013,3.668,12.776,-4097,-2.33,20.892,93,93,3307
1991,3115,1363,1958,135867,136850,54,2.688,156,7.765,12068,1184,10884,0.865,8.818,13983,5194,8789,3.795,10.218,-1915,-1.399,17.637,99,100,2007
1991,3116,3672,4297,394207,389854,305,7.017,404,9.295,45242,9277,35965,2.38,11.605,36075,14793,21282,3.794,9.253,9167,2.351,18.507,304,306,8547
1991,3117,697,811,45898,46110,64,7.781,87,10.578,8228,2197,6031,4.765,17.844,8629,2729,5900,5.919,18.714,-401,-0.87,35.689,59,61,2130
1991,3118,9301,10668,305294,305444,1224,11.461,1248,11.685,35701,10012,25689,3.278,11.688,36308,12234,24074,4.005,11.887,-607,-0.199,23.377,936,952,8626
1991,3119,2171,2544,133063,133370,236,9.319,213,8.411,16409,4628,11781,3.47,12.303,16686,7179,9507,5.383,12.511,-277,-0.208,24.607,163,167,4423
1991,3121,1756,2185,138263,138164,153,6.937,194,8.796,13255,1982,11273,1.435,9.594,13007,3459,9548,2.504,9.414,248,0.179,18.828,141,142,1842
1991,3122,90,123,35743,36571,8,6.4,12,9.6,1037,84,953,0.23,2.836,2638,224,2414,0.613,7.213,-1601,-4.378,5.671,9,9,41
1991,3131,373,616,101177,103824,35,5.641,44,7.091,11301,7478,3823,7.203,10.885,16759,2997,13762,2.887,16.142,-5458,-5.257,21.77,28,28,1424
1991,3132,1657,1994,232641,239141,177,8.83,198,9.878,14619,4846,9773,2.026,6.113,27683,8735,18948,3.653,11.576,-13064,-5.463,12.226,141,143,4673
1991,3133,1975,2234,106163,107355,314,14.384,212,9.711,12445,3655,8790,3.405,11.592,14614,4503,10111,4.194,13.613,-2169,-2.02,23.185,136,137,3395
1991,3141,3443,3726,119498,126407,330,8.636,520,13.609,10419,2830,7589,2.239,8.242,24265,6556,17709,5.186,19.196,-13846,-10.954,16.485,421,430,3817
1991,3149,3998,4117,112244,115706,529,12.838,536,13.008,17349,6071,11278,5.247,14.994,24496,9865,14631,8.526,21.171,-7147,-6.177,29.988,442,444,5945
1991,3151,1157,1282,120775,127001,102,7.721,180,13.626,12324,1908,10416,1.502,9.704,24708,8524,16184,6.712,19.455,-12384,-9.751,19.408,143,143,4935
1991,3152,11554,12756,690838,713720,2119,16.535,2237,17.456,102356,39355,63001,5.514,14.341,148292,66400,81892,9.303,20.777,-45936,-6.436,28.682,1808,1840,42568
1991,3159,1756,1844,60252,62427,245,13.112,294,15.735,7723,2512,5211,4.024,12.371,12080,5416,6664,8.676,19.351,-4357,-6.979,24.743,239,241,3217
1991,3161,328,354,15169,15688,34,9.471,44,12.256,1534,779,755,4.966,9.778,2645,509,2136,3.245,16.86,-1111,-7.082,19.556,34,34,325
1991,3162,349,463,64172,67859,30,6.363,47,9.968,3840,1099,2741,1.62,5.659,11322,3473,7849,5.118,16.685,-7482,-11.026,11.318,32,32,1701
1991,3169,1062,1107,33339,34841,103,9.164,137,12.189,4184,1342,2842,3.852,12.009,7248,2687,4561,7.712,20.803,-3064,-8.794,24.018,107,109,2157
1991,3211,4387,4898,123722,132289,392,7.867,562,11.278,10080,2839,7241,2.146,7.62,26990,9716,17274,7.345,20.402,-16910,-12.783,15.239,413,414,5058
1991,3212,1286,1593,88617,96187,107,6.636,146,9.054,6043,2058,3985,2.14,6.283,21125,5040,16085,5.24,21.963,-15082,-15.68,12.565,106,107,3007
1991,3219,9263,9949,256352,272554,1038,10.386,1128,11.287,27540,9149,18391,3.357,10.104,59847,17896,41951,6.566,21.958,-32307,-11.853,20.209,847,851,11820
1991,3221,232,544,193184,194039,18,3.282,27,4.923,7646,2238,5408,1.153,3.94,9247,4695,4552,2.42,4.766,-1601,-0.825,7.881,11,11,975
1991,3222,3545,5167,390683,395735,243,4.665,327,6.278,29105,5734,23371,1.449,7.355,39280,13383,25897,3.382,9.926,-10175,-2.571,14.709,212,214,6264
1991,3231,42564,44523,816971,834838,4041,9.049,4311,9.653,82636,24107,58529,2.888,9.898,118032,44399,73633,5.318,14.138,-35396,-4.24,19.797,3484,3499,32343
1991,3241,1321,2272,137964,140206,154,6.76,166,7.287,7409,1684,5725,1.201,5.284,11828,3607,8221,2.573,8.436,-4419,-3.152,10.569,84,90,1534
1991,3251,1198,2416,239020,236264,158,6.596,117,4.884,16203,3355,12848,1.42,6.858,10648,3238,7410,1.371,4.507,5555,2.351,9.014,60,60,925
1991,3252,365,639,132663,132942,30,4.637,46,7.11,5808,1021,4787,0.768,4.369,6416,1012,5404,0.761,4.826,-608,-0.457,8.738,23,23,391
1991,3253,648,894,42568,42977,50,5.525,72,7.956,2707,556,2151,1.294,6.299,3476,1010,2466,2.35,8.088,-769,-1.789,12.598,49,49,579
1991,3254,1136,1409,177936,178130,127,9.036,120,8.538,15990,2911,13079,1.634,8.977,16187,5076,11111,2.85,9.087,-197,-0.111,17.953,81,84,3175
1991,3255,1659,2164,74097,75122,112,5.147,136,6.25,6997,1338,5659,1.781,9.314,8997,2729,6268,3.633,11.977,-2000,-2.662,18.628,68,68,567
1991,3256,2102,2350,116893,119652,163,6.819,244,10.207,13675,3339,10336,2.791,11.429,19236,8870,10366,7.413,16.077,-5561,-4.648,22.858,177,179,3235
1991,3259,2190,2848,134598,134734,232,8.16,222,7.809,11837,3650,8187,2.709,8.785,11929,3575,8354,2.653,8.854,-92,-0.068,17.571,144,144,2307
1991,3261,10243,12270,640371,659891,976,7.961,956,7.798,64064,16631,47433,2.52,9.708,103565,29140,74425,4.416,15.694,-39501,-5.986,19.417,698,714,17129
1991,3262,2122,2607,187527,191101,233,9.033,178,6.901,12639,4650,7989,2.433,6.614,19555,4371,15184,2.287,10.233,-6916,-3.619,13.228,132,134,3008
1991,3271,1458,1749,74639,78555,172,9.742,205,11.611,5067,1408,3659,1.792,6.45,12954,3078,9876,3.918,16.49,-7887,-10.04,12.901,146,148,2055
1991,3272,1779,2042,132727,139370,185,8.965,228,11.049,7362,2844,4518,2.041,5.282,20417,6231,14186,4.471,14.649,-13055,-9.367,10.565,166,171,3807
1991,3273,6241,9067,170462,180456,617,6.758,743,8.138,21520,6970,14550,3.862,11.925,41634,10388,31246,5.757,23.072,-20114,-11.146,23.851,473,479,5257
1991,3274,246,340,16884,17691,17,4.749,53,14.804,813,98,715,0.554,4.596,2426,760,1666,4.296,13.713,-1613,-9.118,9.191,21,21,198
1991,3279,1893,2193,71028,74790,167,7.526,219,9.869,5045,1379,3666,1.844,6.746,12661,3411,9250,4.561,16.929,-7616,-10.183,13.491,146,148,2217
1991,3311,312,370,153336,156964,29,7.764,36,9.639,3401,441,2960,0.281,2.167,10882,633,10249,0.403,6.933,-7481,-4.766,4.333,31,32,558
1991,3312,524,710,60219,62834,30,4.132,62,8.54,4304,903,3401,1.437,6.85,9398,3986,5412,6.344,14.957,-5094,-8.107,13.7,41,43,2574
1991,3313,414,584,94244,98058,18,3.018,43,7.209,3381,471,2910,0.48,3.448,10819,3398,7421,3.465,11.033,-7438,-7.585,6.896,22,23,2019
1991,3314,764,926,79903,82359,73,7.783,97,10.341,3810,1022,2788,1.241,4.626,8756,2750,6006,3.339,10.632,-4946,-6.005,9.252,69,69,879
1991,3315,2565,2833,199250,206422,156,5.46,204,7.14,13625,4235,9390,2.052,6.601,27997,7277,20720,3.525,13.563,-14372,-6.962,13.201,158,158,3965
1991,3321,3273,3470,134371,139005,193,5.511,257,7.339,10947,2685,8262,1.932,7.875,20352,7092,13260,5.102,14.641,-9405,-6.766,15.751,196,198,4939
1991,3322,1298,1434,73659,77073,105,7.338,99,6.918,6458,2820,3638,3.659,8.379,13128,6636,6492,8.61,17.033,-6670,-8.654,16.758,73,73,4500
1991,3323,10352,11163,311676,329422,805,7.146,1009,8.957,34177,10625,23552,3.225,10.375,69567,20805,48762,6.316,21.118,-35390,-10.743,20.75,774,777,13118
1991,3324,1547,1877,113544,116955,99,5.279,96,5.119,9545,1782,7763,1.524,8.161,16335,2951,13384,2.523,13.967,-6790,-5.806,16.323,65,65,1804
1991,3325,932,1022,65249,68777,55,5.309,83,8.012,3294,491,2803,0.714,4.789,10333,2300,8033,3.344,15.024,-7039,-10.235,9.579,58,58,1205
1991,3326,1709,1887,64322,67065,133,6.92,203,10.562,5542,1695,3847,2.527,8.264,11042,3969,7073,5.918,16.465,-5500,-8.201,16.527,151,152,2458
1991,3327,21836,22167,330635,338516,1740,7.816,1931,8.674,38529,8754,29775,2.586,11.382,54422,16500,37922,4.874,16.077,-15893,-4.695,22.763,1525,1530,12739
1991,3328,5484,5859,130603,134697,352,5.977,412,6.996,13087,3297,9790,2.448,9.716,21225,5582,15643,4.144,15.758,-8138,-6.042,19.432,323,324,4290
1991,3329,6627,7136,343480,353470,508,7.032,685,9.482,27973,5840,22133,1.652,7.914,47785,13971,33814,3.953,13.519,-19812,-5.605,15.828,534,534,7759
1991,3331,2994,3245,205673,211449,241,7.421,246,7.575,17412,4922,12490,2.328,8.235,28989,6262,22727,2.961,13.71,-11577,-5.475,16.469,171,172,2754
1991,3332,4145,4404,159425,166250,278,6.247,370,8.315,15755,3456,12299,2.079,9.477,29571,11934,17637,7.178,17.787,-13816,-8.31,18.953,274,276,6962
1991,3333,2416,2547,144586,149184,207,8.137,201,7.901,10803,2158,8645,1.447,7.241,20152,5110,15042,3.425,13.508,-9349,-6.267,14.483,154,154,2893
1991,3334,1600,1854,146783,154084,106,5.635,160,8.506,9620,2284,7336,1.482,6.243,24386,5812,18574,3.772,15.826,-14766,-9.583,12.487,116,117,2693
1991,3335,9589,9931,220371,225883,607,6.094,665,6.677,19737,5060,14677,2.24,8.738,30836,9171,21665,4.06,13.651,-11099,-4.914,17.475,520,520,6863
1991,3336,753,900,125606,128389,39,4.319,45,4.983,6734,966,5768,0.752,5.245,12124,1793,10331,1.397,9.443,-5390,-4.198,10.49,31,31,1052
1991,3339,5471,6089,314150,320242,387,6.327,442,7.226,28142,8909,19233,2.782,8.788,40179,10888,29291,3.4,12.546,-12037,-3.759,17.575,320,322,6398
1991,3341,1689,1816,249275,253899,245,13.476,249,13.696,29596,7371,22225,2.903,11.657,38946,12028,26918,4.737,15.339,-9350,-3.683,23.313,181,184,5180
1991,3342,1842,2041,227639,235877,199,9.753,198,9.704,21996,6700,15296,2.84,9.325,37843,14205,23638,6.022,16.044,-15847,-6.718,18.65,125,125,8533
1991,3343,417,449,31984,33756,42,9.16,61,13.304,2432,593,1839,1.757,7.205,5870,1633,4237,4.838,17.39,-3438,-10.185,14.409,52,52,1522
1991,3344,5263,5850,490693,508982,588,10.042,599,10.23,47331,10510,36821,2.065,9.299,84002,32882,51120,6.46,16.504,-36671,-7.205,18.598,418,423,15438
1991,3345,4490,5115,598191,620831,346,6.698,448,8.672,35874,10487,25387,1.689,5.778,81659,19325,62334,3.113,13.153,-45785,-7.375,11.557,304,306,7979
1991,3346,745,793,57984,57080,99,12.422,107,13.425,9122,2229,6893,3.905,15.981,7263,2355,4908,4.126,12.724,1859,3.257,25.448,85,86,1476
1991,3351,1184,1298,73903,78376,106,8.079,134,10.213,4917,1646,3271,2.1,6.274,13889,4437,9452,5.661,17.721,-8972,-11.447,12.547,103,105,2896
1991,3352,396,473,98616,103934,36,7.524,47,9.822,5377,489,4888,0.47,5.173,16331,5337,10994,5.135,15.713,-10954,-10.539,10.347,27,27,604
1991,3353,2186,2644,216415,224056,155,5.811,202,7.573,12733,2632,10101,1.175,5.683,27919,8877,19042,3.962,12.461,-15186,-6.778,11.366,125,126,2532
1991,3359,2071,2433,186174,194066,127,5.126,216,8.718,13591,3174,10417,1.636,7.003,29192,11154,18038,5.748,15.042,-15601,-8.039,14.007,144,144,6406
1991,3361,257,310,189526,205938,37,11.84,42,13.44,10073,220,9853,0.107,4.891,42980,1027,41953,0.499,20.87,-32907,-15.979,9.783,34,34,655
1991,3362,1774,1966,94929,103790,147,7.297,244,12.112,9113,2370,6743,2.283,8.78,26941,8143,18798,7.846,25.957,-17828,-17.177,17.561,168,170,3474
1991,3363,4173,5049,592730,623731,371,7.298,440,8.655,36318,12159,24159,1.949,5.823,98184,17664,80520,2.832,15.741,-61866,-9.919,11.645,314,321,8138
1991,3364,1500,1838,650133,671347,134,7.271,144,7.813,39657,23842,15815,3.551,5.907,81774,8414,73360,1.253,12.181,-42117,-6.274,11.814,102,102,2074
1991,3365,176,216,30646,31062,18,8.451,12,5.634,3373,380,2993,1.223,10.859,4404,937,3467,3.017,14.178,-1031,-3.319,21.718,6,6,202
1991,3366,1299,1402,153377,158322,140,9.849,179,12.592,17271,2461,14810,1.554,10.909,27030,5961,21069,3.765,17.073,-9759,-6.164,21.818,136,138,3417
1991,3369,477,489,28811,29371,44,8.791,67,13.387,2534,239,2295,0.814,8.628,3761,749,3012,2.55,12.805,-1227,-4.178,17.255,52,52,617
1991,3371,13107,13703,347510,369904,1615,11.648,1940,13.992,34152,10358,23794,2.8,9.233,79141,30645,48496,8.285,21.395,-44989,-12.162,18.465,1511,1526,21516
1991,3372,3073,3264,145310,154962,302,9.128,391,11.818,13900,5346,8554,3.45,8.97,33290,10730,22560,6.924,21.483,-19390,-12.513,17.94,302,302,6031
1991,3379,1118,1260,38078,40636,96,7.556,117,9.209,3102,1025,2077,2.522,7.634,8248,2010,6238,4.946,20.297,-5146,-12.664,15.267,97,97,1479
1991,3391,9968,10532,266176,265639,937,8.879,979,9.277,32510,7247,25263,2.728,12.238,31348,11399,19949,4.291,11.801,1162,0.437,23.602,732,737,4869
1991,3399,16169,16697,393590,405699,1883,11.217,2062,12.284,46026,12944,33082,3.191,11.345,70458,22935,47523,5.653,17.367,-24432,-6.022,22.69,1681,1685,16200
1991,4231,19824,24951,288669,298080,2444,9.719,2836,11.278,37809,13846,23963,4.645,12.684,56650,21682,34968,7.274,19.005,-18841,-6.321,25.368,1984,2084,15237
1991,4232,8211,9428,113970,117859,1136,11.947,1298,13.65,17352,5616,11736,4.765,14.723,25029,9261,15768,7.858,21.236,-7677,-6.514,29.445,939,966,6347
1991,4233,8087,10732,132909,138078,1074,9.91,1286,11.866,17685,6262,11423,4.535,12.808,28230,9124,19106,6.608,20.445,-10545,-7.637,25.616,881,897,5873
1991,4234,23428,33027,616864,623848,4813,14.747,4034,12.36,100341,42107,58234,6.75,16.084,113797,55441,58356,8.887,18.241,-13456,-2.157,32.168,2326,2432,29764
1991,4235,6901,9336,133321,137494,823,8.8,855,9.142,14300,4507,9793,3.278,10.4,22634,8134,14500,5.916,16.462,-8334,-6.061,20.801,543,571,5110
1991,4236,16473,24632,324516,330056,2957,12.105,2548,10.431,56854,23986,32868,7.267,17.226,67936,25097,42839,7.604,20.583,-11082,-3.358,34.451,1544,1606,13180
1991,4237,10798,15234,168630,171822,1359,8.948,1266,8.336,21771,8299,13472,4.83,12.671,28208,10021,18187,5.832,16.417,-6437,-3.746,25.341,804,820,5774
1991,4238,46769,61993,666763,681417,5524,8.895,5736,9.237,86132,28353,57779,4.161,12.64,115671,43166,72505,6.335,16.975,-29539,-4.335,25.28,3868,3991,25423
1991,4239,23579,25514,257085,259853,3529,13.852,3454,13.558,47244,16876,30368,6.494,18.181,53120,20559,32561,7.912,20.442,-5876,-2.261,36.362,2704,2725,16089
1991,4241,8755,11809,176088,178995,1064,8.988,1122,9.478,22179,5593,16586,3.125,12.391,28029,10370,17659,5.793,15.659,-5850,-3.268,24.782,716,726,7039
1991,4242,3207,4373,120899,118442,614,14.012,632,14.423,21932,8096,13836,6.835,18.517,16760,6532,10228,5.515,14.15,5172,4.367,28.301,365,374,2174
1991,4243,11932,12956,155100,159711,1940,14.901,2066,15.869,29173,10536,18637,6.597,18.266,38539,15212,23327,9.525,24.13,-9366,-5.864,36.532,1638,1664,10963
1991,4244,25980,32453,670672,679912,3644,11.187,3883,11.921,89104,28212,60892,4.149,13.105,107840,43724,64116,6.431,15.861,-18736,-2.756,26.21,2935,2991,28109
1991,4245,6439,9406,82041,83757,582,6.097,860,9.01,11380,3364,8016,4.016,13.587,14870,5019,9851,5.992,17.754,-3490,-4.167,27.174,556,601,3492
1991,4246,7742,11577,135161,134689,1463,12.872,1041,9.159,22526,9550,12976,7.09,16.724,21583,8604,12979,6.388,16.024,943,0.7,32.049,576,592,3276
1991,4247,9011,12087,130929,134087,874,7.127,1225,9.99,19190,6022,13168,4.491,14.312,25599,9495,16104,7.081,19.091,-6409,-4.78,28.623,684,708,5314
1991,4248,3566,4592,132407,134549,222,4.722,441,9.38,12612,3527,9085,2.621,9.374,16761,7397,9364,5.498,12.457,-4149,-3.084,18.747,322,335,5370
1991,4249,22286,27154,318886,323088,3404,12.556,3318,12.239,51802,19333,32469,5.984,16.033,60571,24740,35831,7.657,18.748,-8769,-2.714,32.067,2407,2438,14351
1991,4251,31414,33998,313684,319563,3744,11.076,3356,9.928,48055,16886,31169,5.284,15.038,60365,23599,36766,7.385,18.89,-12310,-3.852,30.075,2260,2268,15832
1991,4411,38566,40615,918793,953286,4155,10.121,5029,12.25,98265,43046,55219,4.516,10.308,167232,71327,95905,7.482,17.543,-68967,-7.235,20.616,4076,4142,60816
1991,4412,9946,10633,74559,79785,1034,9.54,1446,13.341,11024,4326,6698,5.422,13.817,21507,8144,13363,10.207,26.956,-10483,-13.139,27.634,1150,1179,6612
1991,4413,42226,66588,494018,505427,4444,6.589,6153,9.123,68978,24437,44541,4.835,13.647,91274,31535,59739,6.239,18.059,-22296,-4.411,27.295,4210,4454,21452
1991,4421,20799,27425,225573,233360,2871,10.388,3295,11.922,34220,15310,18910,6.561,14.664,49875,17370,32505,7.443,21.373,-15655,-6.709,29.328,2276,2495,12588
1991,4422,21007,27973,177700,182261,3605,12.897,3563,12.747,33795,14936,18859,8.195,18.542,42838,15206,27632,8.343,23.504,-9043,-4.962,37.084,2510,2626,10691
1991,4431,24011,35264,257608,254133,5792,16.794,4239,12.291,57124,29084,28040,11.444,22.478,49780,20134,29646,7.923,19.588,7344,2.89,39.176,2856,3022,13210
1991,4441,52430,69409,752329,770891,5078,7.252,6299,8.996,95153,35710,59443,4.632,12.343,132502,44770,87732,5.808,17.188,-37349,-4.845,24.687,4408,4583,28239
1991,4442,15326,18894,150123,151921,1520,8.003,1719,9.05,22599,6635,15964,4.367,14.876,26233,7827,18406,5.152,17.268,-3634,-2.392,29.751,1290,1309,5858
1991,4451,61329,92612,2452348,2465903,9520,10.176,11397,12.183,303885,145163,158722,5.887,12.323,330908,113361,217547,4.597,13.419,-27023,-1.096,24.647,7519,7706,60562
1991,4452,18949,23198,150659,154619,2998,12.63,4078,17.179,29421,12926,16495,8.36,19.028,37417,17543,19874,11.346,24.199,-7996,-5.171,38.056,2674,2768,12528
1991,4453,26667,31319,150099,154399,2858,8.98,3876,12.178,25584,8926,16658,5.781,16.57,34407,14919,19488,9.663,22.285,-8823,-5.714,33.14,2862,2930,9954
1991,4461,49600,79750,781451,778296,6468,8.076,7149,8.926,121345,44608,76737,5.731,15.591,114133,47162,66971,6.06,14.664,7212,0.927,29.329,4476,4671,25805
1991,4471,79874,132820,935325,957459,12320,9.156,15795,11.738,169725,74726,94999,7.805,17.727,213275,85094,128181,8.887,22.275,-43550,-4.548,35.453,9900,10407,53160
1991,4481,49630,103318,1058941,1017247,12013,11.516,14004,13.425,280551,89365,191186,8.785,27.579,192368,76467,115901,7.517,18.911,88183,8.669,37.821,7870,9306,41190
1991,4482,9443,35436,195056,201853,2887,8.015,4059,11.268,30645,15472,15173,7.665,15.182,43787,16662,27125,8.255,21.693,-13142,-6.511,30.364,1583,1711,6396
1991,4483,19903,29495,172546,178866,3002,10.075,3603,12.092,29512,12401,17111,6.933,16.5,42484,17522,24962,9.796,23.752,-12972,-7.252,32.999,2131,2333,8977
1991,4511,33473,44758,333348,336725,5532,12.343,5652,12.611,62058,29866,32192,8.87,18.43,68154,24864,43290,7.384,20.24,-6096,-1.81,36.86,4218,4433,17394
1991,4512,9341,14780,107857,105880,1559,10.618,1363,9.283,22244,7564,14680,7.144,21.009,18362,6339,12023,5.987,17.342,3882,3.666,34.685,1007,1030,4304
1991,4522,239,6551,1092834,1132965,279,4.237,346,5.255,73717,36118,37599,3.188,6.507,155270,28230,127040,2.492,13.705,-81553,-7.198,13.013,17,25,1546
1991,4523,11537,28609,1024752,1015395,2612,9.05,3117,10.8,133971,66719,67252,6.571,13.194,119938,42545,77393,4.19,11.812,14033,1.382,23.624,1468,1593,9777
1991,4531,25196,26679,135097,138420,2989,11.147,3261,12.161,24028,9201,14827,6.647,17.359,30535,11809,18726,8.531,22.06,-6507,-4.701,34.718,2650,2685,9708
1991,4532,31699,40441,264666,267491,5174,12.773,5306,13.099,53499,24170,29329,9.036,20,59119,23234,35885,8.686,22.101,-5620,-2.101,40.001,4008,4177,16163
1991,4533,11301,13434,74653,73157,2036,15.372,1658,12.518,16036,7202,8834,9.845,21.92,13348,5129,8219,7.011,18.246,2688,3.674,36.491,1279,1293,3832
1991,4539,27441,31482,164004,167338,4581,14.55,4587,14.569,37070,17156,19914,10.252,22.153,43849,17869,25980,10.678,26.204,-6779,-4.051,44.306,3398,3502,13336
1991,4541,6462,7839,128059,127029,1158,14.972,949,12.27,24553,7377,17176,5.807,19.329,22462,7658,14804,6.029,17.683,2091,1.646,35.365,709,734,6334
1991,4542,4392,5384,67393,72045,814,15.243,726,13.596,8453,3777,4676,5.243,11.733,17656,9066,8590,12.584,24.507,-9203,-12.774,23.466,493,496,2487
1991,4543,16233,22501,218752,222954,2212,9.736,2650,11.664,35084,12122,22962,5.437,15.736,43410,17655,25755,7.919,19.47,-8326,-3.734,31.472,1667,1769,10503
1991,4811,506,2909,474322,463004,514,18.456,266,9.551,75290,12279,63011,2.652,16.261,52746,12859,39887,2.777,11.392,22544,4.869,22.784,91,91,1153
1991,4812,1139,1272,15468,16504,252,20.605,154,12.592,3194,1853,1341,11.228,19.353,5283,1418,3865,8.592,32.01,-2089,-12.658,38.706,103,103,1205
1991,4831,372,652,37179,34184,86,13.385,67,10.428,10214,3428,6786,10.028,29.88,4065,1750,2315,5.119,11.892,6149,17.988,23.783,36,38,755
1991,4832,314,355,13662,13289,47,13.448,36,10.3,2317,754,1563,5.674,17.435,1561,644,917,4.846,11.747,756,5.689,23.493,22,22,340
1991,4841,21479,27707,579882,585303,4203,15.044,4664,16.694,93006,30213,62793,5.162,15.89,104393,43588,60805,7.447,17.836,-11387,-1.945,31.78,3321,3381,25368
1991,4842,47139,51439,532722,553415,7361,14.165,8413,16.19,98504,36076,62428,6.519,17.799,140301,56615,83686,10.23,25.352,-41797,-7.553,35.599,6204,6270,37113
1991,4851,438,487,41550,41515,90,19.481,40,8.658,4747,3234,1513,7.79,11.435,4760,783,3977,1.886,11.466,-13,-0.031,22.869,27,27,127
1991,4852,392,594,15983,16616,142,24.653,106,18.403,3614,1519,2095,9.142,21.751,4936,1829,3107,11.008,29.707,-1322,-7.956,43.502,30,32,795
1991,4853,5042,5127,49605,51282,929,18.192,888,17.39,9648,4634,5014,9.036,18.814,12898,5397,7501,10.524,25.151,-3250,-6.338,37.627,754,755,4219
1991,4854,3171,3994,117811,116012,611,15.739,387,9.969,28524,17824,10700,15.364,24.587,24626,8181,16445,7.052,21.227,3898,3.36,42.454,302,306,5200
1991,4855,860,957,21172,20549,233,26.136,102,11.441,5394,3160,2234,15.378,26.249,4196,1187,3009,5.776,20.419,1198,5.83,40.839,78,78,766
1991,4859,1052,1106,22951,23160,260,24.063,209,19.343,5627,2955,2672,12.759,24.296,5975,2486,3489,10.734,25.799,-348,-1.503,48.592,183,184,1935
1991,4861,50,410,10078,9550,84,22.105,24,6.316,1983,1333,650,13.958,20.764,906,359,547,3.759,9.487,1077,11.277,18.974,5,5,161
1991,4862,280,1459,52691,53001,91,6.229,95,6.502,6533,2910,3623,5.491,12.326,7159,2851,4308,5.379,13.507,-626,-1.181,24.653,31,31,234
1991,4869,65,328,6570,6580,31,9.025,62,18.049,855,335,520,5.092,12.995,913,566,347,8.602,13.876,-58,-0.882,25.99,6,6,17
1991,4871,277,292,4376,4568,65,23.214,41,14.643,1136,509,627,11.143,24.869,1544,292,1252,6.392,33.8,-408,-8.932,49.737,33,33,154
1991,4872,880,902,9716,9389,185,21.326,116,13.372,2594,1193,1401,12.707,27.63,1966,832,1134,8.862,20.941,628,6.689,41.881,88,88,691
1991,4879,131,137,952,1003,31,23.485,21,15.909,227,149,78,14.855,22.632,321,88,233,8.774,32.004,-94,-9.372,45.264,15,15,80
1991,4881,2322,2947,83185,83094,517,17.92,393,13.622,19560,8204,11356,9.873,23.54,18994,7903,11091,9.511,22.858,566,0.681,45.717,232,232,4085
1991,4882,473,692,20965,20196,112,16.867,56,8.434,5316,2906,2410,14.389,26.322,3742,557,3185,2.758,18.528,1574,7.794,37.057,32,32,368
1991,4883,2011,2458,79629,81272,283,11.535,274,11.168,14287,4616,9671,5.68,17.579,18201,5169,13032,6.36,22.395,-3914,-4.816,35.158,198,200,2658
1991,4884,2327,2417,14707,14156,659,28.91,384,16.846,4634,2754,1880,19.455,32.735,3542,1635,1907,11.55,25.021,1092,7.714,50.042,277,282,1084
1991,4885,8087,10684,114036,114903,1644,15.819,1061,10.209,23920,8246,15674,7.176,20.818,25839,11592,14247,10.089,22.488,-1919,-1.67,41.635,712,749,5705
1991,4889,743,780,8256,8475,157,20.822,105,13.926,1991,808,1183,9.534,23.494,2465,983,1482,11.6,29.087,-474,-5.593,46.988,83,83,721
1991,4921,1361,4040,374516,363986,495,12.275,480,11.903,42337,9257,33080,2.543,11.632,19777,8592,11185,2.361,5.433,22560,6.198,10.867,251,254,1828
1991,4922,3712,3991,60688,62968,656,16.316,715,17.784,12199,4849,7350,7.701,19.373,16907,9586,7321,15.224,26.85,-4708,-7.477,38.747,546,550,3990
1991,4931,6437,10552,442202,442414,1113,10.706,802,7.714,70507,24509,45998,5.54,15.937,71246,18780,52466,4.245,16.104,-739,-0.167,31.874,388,396,6507
1991,5111,14900,17512,690122,700578,1935,11.043,1956,11.163,53614,14993,38621,2.14,7.653,74340,22749,51591,3.247,10.611,-20726,-2.958,15.306,1537,1551,16461
1991,5112,4361,5118,98168,93027,1061,21.513,689,13.97,22659,8206,14453,8.821,24.357,12613,5603,7010,6.023,13.558,10046,10.799,27.117,483,496,3849
1991,5121,9707,14367,248567,246290,2089,14.562,2046,14.262,49761,17991,31770,7.305,20.204,45741,20290,25451,8.238,18.572,4020,1.632,37.144,1183,1232,7654
1991,5122,1692,1721,13052,13231,313,17.694,409,23.12,3085,1409,1676,10.65,23.317,3398,2064,1334,15.6,25.683,-313,-2.366,46.635,338,338,1830
1991,5151,6011,7976,238601,239721,1187,15.186,868,11.105,36714,20390,16324,8.506,15.315,39197,13641,25556,5.69,16.351,-2483,-1.036,30.631,590,603,7780
1991,5152,210,338,14584,14411,67,20.775,36,11.163,2957,1685,1272,11.692,20.519,2643,1000,1643,6.939,18.34,314,2.179,36.68,21,21,484
1991,5173,5023,27224,1044641,1052042,5891,22.956,2767,10.782,207406,124017,83389,11.788,19.715,223389,47127,176262,4.48,21.234,-15983,-1.519,39.429,721,730,7395
1991,5174,176,313,12256,13847,55,17.6,54,17.28,1684,416,1268,3.004,12.162,4911,3763,1148,27.177,35.467,-3227,-23.306,24.324,19,19,160
1991,5179,1034,1949,39670,40233,582,31.106,426,22.769,9705,6408,3297,15.927,24.122,11000,3675,7325,9.134,27.341,-1295,-3.219,48.245,201,203,1569
1991,5182,5492,7753,284438,289508,1271,16.324,1337,17.172,52435,20372,32063,7.037,18.112,62358,26361,35997,9.105,21.539,-9923,-3.428,36.224,606,613,7889
1991,5191,2585,3016,34001,34814,343,11.311,376,12.399,5707,3277,2430,9.413,16.393,7277,2292,4985,6.584,20.903,-1570,-4.51,32.786,259,273,1911
1991,5211,45,79,24910,25001,6,7.895,0,0,639,234,405,0.936,2.556,827,0,827,0,3.308,-188,-0.752,5.112,0,0,0
1991,5221,21983,97823,2099717,2128960,17695,19.304,5379,5.868,410443,254119,156324,11.936,19.279,467931,91219,376712,4.285,21.979,-57488,-2.7,38.558,1313,1714,35836
1991,5222,14872,35800,438880,435732,6174,17.649,4540,12.978,122558,78832,43726,18.092,28.127,118041,43818,74223,10.056,27.09,4517,1.037,54.181,1967,1995,16601
1991,5223,6643,8506,74151,73821,2513,31.925,1244,15.804,23062,14963,8099,20.269,31.24,22412,7589,14823,10.28,30.36,650,0.881,60.72,886,893,5336
1991,5231,6461,17616,305005,310951,3703,21.811,2427,14.295,60838,31001,29837,9.97,19.565,73492,21582,51910,6.941,23.635,-12654,-4.069,39.13,1055,1088,7999
1991,5232,74,89,7436,7753,10,11.299,9,10.169,595,411,184,5.302,7.675,1229,49,1180,0.632,15.853,-634,-8.178,15.35,9,9,49
1991,5239,15109,16304,180554,174787,3346,20.966,2656,16.643,49974,27128,22846,15.521,28.591,38748,20139,18609,11.522,22.169,11226,6.423,44.338,1964,1968,14210
1991,5241,8093,41130,1504833,1486322,4704,11.5,4255,10.402,222726,99931,122795,6.723,14.985,187503,53978,133525,3.632,12.615,35223,2.37,25.23,637,697,9652
1991,5242,103979,115233,916730,955027,16998,15.114,11463,10.192,208265,106527,101738,11.154,21.807,288020,92578,195442,9.694,30.158,-79755,-8.351,43.614,8381,8396,55929
1991,5259,925,1119,17949,18704,135,12.334,86,7.857,4328,1499,2829,8.015,23.14,6158,1782,4376,9.528,32.924,-1830,-9.784,46.28,51,51,907
1991,5311,88417,95237,512187,518360,13270,13.979,12648,13.324,114633,59646,54987,11.507,22.115,125798,53136,72662,10.251,24.268,-11165,-2.154,44.229,10154,10182,41560
1991,5312,42079,47335,232104,249174,8975,19.288,7368,15.834,61040,36946,24094,14.827,24.497,95366,46572,48794,18.691,38.273,-34326,-13.776,48.994,5419,5436,21567
1991,5313,25977,28752,329116,330196,5287,18.618,4576,16.115,81865,42907,38958,12.994,24.793,83945,30170,53775,9.137,25.423,-2080,-0.63,49.586,3536,3576,20859
1991,5321,5027,9821,132736,136167,1113,11.207,1334,13.432,21702,9220,12482,6.771,15.938,28128,10462,17666,7.683,20.657,-6426,-4.719,31.876,761,821,6687
1991,5322,21137,28454,208368,202050,5379,19.32,4155,14.923,67149,41605,25544,20.591,33.234,55503,24399,31104,12.076,27.47,11646,5.764,54.94,2996,3181,14859
1991,5323,3924,5942,40519,41805,683,11.499,678,11.415,7872,2813,5059,6.729,18.83,10362,4446,5916,10.635,24.787,-2490,-5.956,37.661,434,444,3086
1991,5324,7484,10023,113980,115173,1386,13.856,1346,13.456,24589,9161,15428,7.954,21.35,27108,11225,15883,9.746,23.537,-2519,-2.187,42.699,895,915,6713
1991,5331,1063,1176,15073,16551,301,27.142,167,15.059,3236,1653,1583,9.987,19.552,6265,3492,2773,21.098,37.853,-3029,-18.301,39.103,129,130,3231
1991,5411,136816,142786,970321,976661,14892,10.486,13368,9.412,134511,50819,83692,5.203,13.773,148097,55062,93035,5.638,15.164,-13586,-1.391,27.545,10356,10428,43860
1991,5412,71578,75733,715684,707415,10113,13.498,8493,11.336,128175,48689,79486,6.883,18.119,112049,43979,68070,6.217,15.839,16126,2.28,31.678,6248,6334,26176
1991,5413,62390,70498,948108,965043,9322,13.284,8678,12.366,157535,50214,107321,5.203,16.324,191474,66461,125013,6.887,19.841,-33939,-3.517,32.648,6097,6177,41209
1991,5414,16886,17135,100548,102064,3062,18.057,2706,15.958,22698,11102,11596,10.878,22.239,25745,10470,15275,10.258,25.224,-3047,-2.985,44.478,2186,2194,8588
1991,5415,26522,30019,421630,421271,6489,22.037,5342,18.142,87449,35332,52117,8.387,20.758,86682,37743,48939,8.959,20.576,767,0.182,41.153,3873,3910,21846
1991,5416,36982,39408,357593,363578,8637,22.051,8156,20.823,93898,39924,53974,10.981,25.826,105814,49953,55861,13.739,29.104,-11916,-3.277,51.652,6464,6493,38236
1991,5417,6769,8533,472663,466179,1184,14.115,895,10.669,69426,15447,53979,3.314,14.893,56050,14127,41923,3.03,12.023,13376,2.869,24.047,561,569,5495
1991,5418,29837,33607,405660,402362,6059,18.411,4664,14.172,85860,30595,55265,7.604,21.339,79085,36969,42116,9.188,19.655,6775,1.684,39.31,3718,3752,22937
1991,5419,34429,39075,317130,314900,4628,12.016,3510,9.113,62543,25982,36561,8.251,19.861,58669,20893,37776,6.635,18.631,3874,1.23,37.262,2717,2740,15588
1991,5511,28492,54545,3293821,3286131,6871,12.862,4621,8.65,545917,184809,361108,5.624,16.613,529136,109767,419369,3.34,16.102,16781,0.511,32.204,1168,1201,14009
1991,5611,11970,13179,260882,255559,2387,18.451,1903,14.71,67550,31127,36423,12.18,26.432,57938,26106,31832,10.215,22.671,9612,3.761,45.342,1404,1424,15211
1991,5612,461,884,77315,77002,184,21.711,111,13.097,12398,5972,6426,7.756,16.101,11593,4953,6640,6.432,15.056,805,1.045,30.111,54,54,896
1991,5613,19610,27457,1518358,1559330,4740,17.455,4136,15.231,435780,161574,274206,10.362,27.947,517994,169003,348991,10.838,33.219,-82214,-5.272,55.893,2737,2831,112832
1991,5614,23754,27155,356514,346775,4599,17.265,3563,13.376,88014,40274,47740,11.614,25.381,67741,23245,44496,6.703,19.535,20273,5.846,39.069,2772,2799,16568
1991,5615,25208,31510,246027,246866,4334,13.902,3663,11.75,51389,24552,26837,9.945,20.817,52937,21763,31174,8.816,21.444,-1548,-0.627,41.633,2718,2833,15116
1991,5616,13133,16703,549647,548715,2487,15.103,2014,12.231,111047,39331,71716,7.168,20.238,109661,34751,74910,6.333,19.985,1386,0.253,39.97,1525,1546,20060
1991,5617,92780,97181,1121025,1137175,18091,18.831,15871,16.52,245396,93503,151893,8.222,21.579,277112,97749,179363,8.596,24.368,-31716,-2.789,43.159,12465,12506,71967
1991,5619,15963,17447,232552,226918,3222,18.957,2320,13.65,61564,23818,37746,10.496,27.131,49921,18675,31246,8.23,22,11643,5.131,43.999,1750,1754,14165
1991,5621,3803,3974,49904,48570,460,11.769,329,8.418,8542,3156,5386,6.498,17.587,5858,2001,3857,4.12,12.061,2684,5.526,24.122,267,267,1641
1991,5622,1540,2442,77943,76011,378,15.649,325,13.455,15276,5205,10071,6.848,20.097,11533,5640,5893,7.42,15.173,3743,4.924,30.346,182,182,2077
1991,5629,4858,5207,64724,65154,802,15.462,762,14.691,15691,6213,9478,9.536,24.083,16732,5298,11434,8.132,25.681,-1041,-1.598,48.166,550,551,3299
1991,6111,13754,15079,486588,478671,699,4.672,463,3.095,46280,8221,38059,1.717,9.668,30655,5511,25144,1.151,6.404,15625,3.264,12.808,340,343,4354
1991,6112,506,718,60420,59833,43,6.006,39,5.447,7436,1096,6340,1.832,12.428,6257,1605,4652,2.682,10.458,1179,1.971,20.915,21,25,1380
1991,6113,2066,2431,1093829,1076624,109,4.512,79,3.27,94187,12083,82104,1.122,8.748,62033,3247,58786,0.302,5.762,32154,2.987,11.524,40,43,1194
1991,6114,3276,3795,52645,54571,637,16.932,571,15.178,10586,4133,6453,7.574,19.399,14624,6376,8248,11.684,26.798,-4038,-7.4,38.798,373,395,4382
1991,6115,4839,5795,75696,77558,753,13.098,661,11.498,14767,5785,8982,7.459,19.04,18256,6528,11728,8.417,23.539,-3489,-4.499,38.08,397,427,4549
1991,6116,14547,15313,121896,120703,2712,18.082,2082,13.882,28148,11901,16247,9.86,23.32,25820,11117,14703,9.21,21.391,2328,1.929,42.783,1638,1647,8793
1991,6117,2155,2229,21938,21689,565,27.04,286,13.687,4528,2149,2379,9.908,20.877,3947,1271,2676,5.86,18.199,581,2.679,36.397,228,228,848
1991,6211,181983,193325,1426537,1411403,13305,6.881,13374,6.917,216690,66857,149833,4.737,15.353,186516,72250,114266,5.119,13.215,30174,2.138,26.43,10913,11065,56132
1991,6212,100553,103584,545240,542547,5256,5.081,4994,4.827,73543,18229,55314,3.36,13.555,67939,19577,48362,3.608,12.522,5604,1.033,25.044,4105,4159,16653
1991,6213,61857,65044,269957,264310,8251,12.942,5672,8.897,60479,23570,36909,8.918,22.882,49284,20203,29081,7.644,18.646,11195,4.236,37.293,4396,4456,16529
1991,6214,7790,12785,249294,240931,1596,12.79,983,7.878,47977,17224,30753,7.149,19.913,31052,11401,19651,4.732,12.888,16925,7.025,25.777,566,592,5855
1991,6215,5963,7698,123154,120419,1027,13.383,979,12.757,23216,7418,15798,6.16,19.279,18000,7776,10224,6.457,14.948,5216,4.332,29.896,637,656,4697
1991,6216,5317,8438,412934,390216,1367,16.674,888,10.831,107355,34137,73218,8.748,27.512,60914,19700,41214,5.048,15.61,46441,11.901,31.221,556,572,10511
1991,6219,5728,7241,140135,137399,1325,19.167,669,9.677,32596,15541,17055,11.311,23.724,27299,8664,18635,6.306,19.868,5297,3.855,39.737,499,500,5229
1991,6221,3438,4933,3956123,3920886,147,2.965,198,3.993,240309,53161,187148,1.356,6.129,168827,79757,89070,2.034,4.306,71482,1.823,8.612,122,130,55580
1991,6222,583,969,336685,336924,59,6.201,24,2.522,18753,11180,7573,3.318,5.566,19772,3510,16262,1.042,5.868,-1019,-0.302,11.132,10,10,2547
1991,6223,220,314,108451,109120,26,8.469,12,3.909,10830,3534,7296,3.239,9.925,11774,2014,9760,1.846,10.79,-944,-0.865,19.85,6,6,1188
1991,6231,8470,14238,1278632,1260823,878,6.189,773,5.449,150886,56800,94086,4.505,11.967,115410,46835,68575,3.715,9.154,35476,2.814,18.307,474,495,30046
1991,6232,6945,12678,266310,255461,1973,16.397,682,5.668,53340,24264,29076,9.498,20.88,31838,10914,20924,4.272,12.463,21502,8.417,24.926,430,436,6571
1991,6233,9521,11423,294537,289998,1668,14.847,1291,11.491,49109,19232,29877,6.632,16.934,40519,17026,23493,5.871,13.972,8590,2.962,27.944,858,879,10259
1991,6239,3766,5079,131435,128223,599,12.117,328,6.635,20317,6486,13831,5.058,15.845,14009,5757,8252,4.49,10.926,6308,4.92,21.851,200,206,2701
1991,6241,19855,26943,391470,384408,3210,12.202,1940,7.374,66249,20406,45843,5.308,17.234,52003,16103,35900,4.189,13.528,14246,3.706,27.056,1235,1248,11429
1991,6242,5504,6499,69750,67554,708,11.104,462,7.246,12636,3558,9078,5.267,18.705,8247,2667,5580,3.948,12.208,4389,6.497,24.416,319,319,1892
1991,6243,4959,7737,288827,285956,901,11.969,482,6.403,45196,11060,34136,3.868,15.805,39601,7995,31606,2.796,13.849,5595,1.957,27.697,222,244,4088
1991,6244,36080,44308,439180,429694,6113,14.095,4235,9.765,84726,37833,46893,8.805,19.718,65614,25644,39970,5.968,15.27,19112,4.448,30.54,3284,3357,19533
1991,7111,5910,5972,88763,88733,1070,18.185,894,15.194,20874,7016,13858,7.907,23.525,20998,6449,14549,7.268,23.664,-124,-0.14,47.049,639,640,4513
1991,7112,2668,2801,76335,77087,487,17.632,409,14.808,16532,4599,11933,5.966,21.446,18076,5228,12848,6.782,23.449,-1544,-2.003,42.892,316,324,4213
1991,7113,2564,2661,44940,44303,438,16.648,378,14.367,11179,4367,6812,9.857,25.233,10026,2798,7228,6.316,22.631,1153,2.603,45.262,302,302,2509
1991,7114,1427,1448,13789,14196,266,18.68,218,15.309,2939,1370,1569,9.651,20.704,3804,1794,2010,12.638,26.797,-865,-6.093,41.407,168,168,1381
1991,7115,7247,7302,53565,57676,1274,16.27,2331,29.768,14456,4204,10252,7.289,25.064,23217,12429,10788,21.55,40.254,-8761,-15.19,50.128,1867,1867,7461
1991,7121,3090,3377,63670,63224,286,8.568,208,6.231,7574,2170,5404,3.432,11.98,6572,1844,4728,2.917,10.395,1002,1.585,20.79,166,167,1642
1991,7131,1622,2505,76446,79150,299,11.856,333,13.204,10720,2099,8621,2.652,13.544,15661,2271,13390,2.869,19.787,-4941,-6.243,27.088,244,250,1316
1991,7132,858,930,34037,32100,180,20.145,107,11.975,9033,3884,5149,12.1,28.14,5121,2014,3107,6.274,15.953,3912,12.187,31.907,85,85,1109
1991,7139,38400,41564,659558,656923,5223,12.59,5065,12.209,115384,44691,70693,6.803,17.564,110036,40818,69218,6.214,16.75,5348,0.814,33.5,3946,4056,31259
1991,7211,29984,36780,1419052,1434048,4291,11.695,4114,11.212,223772,110609,113163,7.713,15.604,253641,97134,156507,6.773,17.687,-29869,-2.083,31.208,2970,3012,64264
1991,7212,3936,4248,27374,27431,522,12.365,469,11.11,6112,2135,3977,7.783,22.281,6230,1704,4526,6.212,22.712,-118,-0.43,44.563,333,346,1212
1991,7213,3525,3625,18894,19237,246,6.672,370,10.035,2881,872,2009,4.533,14.977,3535,1461,2074,7.595,18.377,-654,-3.4,29.953,271,275,1111
1991,7223,16689,31680,552188,568315,5055,15.867,5411,16.985,116764,55022,61742,9.682,20.546,149778,65181,84597,11.469,26.355,-33014,-5.809,41.091,2652,2727,27576
1991,7224,50593,51527,325385,328182,7445,14.334,8271,15.924,82290,43020,39270,13.109,25.075,87724,41489,46235,12.642,26.73,-5434,-1.656,50.149,6789,6809,34218
1991,7225,221763,302666,5620085,5677407,44620,14.855,40034,13.328,1061597,591861,469736,10.425,18.699,1173594,458998,714596,8.085,20.671,-111997,-1.973,37.397,29901,31083,324316
1991,8111,120295,129617,666489,677935,17600,13.661,16025,12.439,131991,64927,67064,9.577,19.47,154145,60322,93823,8.898,22.737,-22154,-3.268,38.939,12326,12444,47088
1991,8112,12316,14975,133496,134087,2345,15.999,1709,11.66,29670,15262,14408,11.382,22.127,31113,11799,19314,8.8,23.204,-1443,-1.076,44.255,1227,1255,7881
1991,8113,20561,21647,169157,170967,2604,12.068,2464,11.42,29526,10103,19423,5.909,17.27,33283,11962,21321,6.997,19.467,-3757,-2.198,34.54,1855,1857,9048
1991,8114,26526,28387,174351,179949,4062,14.269,4221,14.828,27690,11233,16457,6.242,15.388,38877,13751,25126,7.642,21.605,-11187,-6.217,30.775,3154,3193,9675
1991,8121,76993,88173,469651,475914,11908,13.467,12415,14.04,101730,51501,50229,10.822,21.376,113801,44594,69207,9.37,23.912,-12071,-2.536,42.751,9830,10061,33744
1991,8122,17384,21037,130897,132675,1316,6.194,1734,8.162,21668,7449,14219,5.614,16.332,25083,8756,16327,6.6,18.906,-3415,-2.574,32.663,1272,1303,6054
1991,8123,34070,41213,381975,382671,5082,12.34,5019,12.188,65909,27428,38481,7.168,17.223,67686,26375,41311,6.892,17.688,-1777,-0.464,34.447,3835,3952,20474
1991,8129,14111,23316,164045,169897,3649,15.689,3533,15.19,32669,15101,17568,8.888,19.229,44332,17052,27280,10.037,26.093,-11663,-6.865,38.457,2120,2224,10221
1991,8131,134422,134498,1151063,1131981,6410,4.812,3857,2.895,136870,18119,118751,1.601,12.091,98621,11753,86868,1.038,8.712,38249,3.379,17.424,2179,2179,6821
1991,8132,9857,11561,152105,151430,1357,12.063,734,6.525,24243,8623,15620,5.694,16.009,22715,6676,16039,4.409,15,1528,1.009,30.001,528,532,5655
1991,8133,8936,10517,118018,115714,1138,11.06,682,6.628,20263,5299,14964,4.579,17.511,15633,3798,11835,3.282,13.51,4630,4.001,27.02,449,455,2523
1991,8134,31022,32773,306725,304029,2175,6.654,2004,6.131,41804,9653,32151,3.175,13.75,36328,8305,28023,2.732,11.949,5476,1.801,23.898,1488,1489,6309
1991,8139,61400,63698,530165,531886,4375,6.87,4336,6.809,78607,19794,58813,3.721,14.779,82032,25305,56727,4.758,15.423,-3425,-0.644,29.558,3173,3188,18774
1992,1131,252,272,3396,3363,50,18.692,41,15.327,843,320,523,9.517,25.071,773,157,616,4.669,22.989,70,2.082,45.978,31,31,103
1992,1132,108,124,1659,1615,17,13.821,15,12.195,518,423,95,26.2,32.084,444,151,293,9.353,27.501,74,4.583,55.002,10,10,135
1992,1133,11081,11161,81861,81645,1622,14.533,1622,14.533,19622,6237,13385,7.639,24.033,19277,6545,12732,8.016,23.611,345,0.423,47.222,1222,1223,4863
1992,1141,1030,1034,9743,9792,187,18.271,166,16.219,2797,1080,1717,11.029,28.564,2935,1099,1836,11.223,29.973,-138,-1.409,57.128,124,125,718
1992,1142,180,186,1693,1813,26,14.092,23,12.466,242,128,114,7.06,13.348,478,256,222,14.12,26.365,-236,-13.017,26.696,18,18,247
1992,1151,4418,4722,66139,61962,620,13.266,523,11.191,21048,5523,15525,8.914,33.969,12712,3971,8741,6.409,20.516,8336,13.454,41.032,358,363,3069
1992,1152,2330,2365,15561,15608,359,15.352,306,13.085,2795,983,1812,6.298,17.908,2866,901,1965,5.773,18.363,-71,-0.455,35.816,231,231,725
1992,1153,932,949,12467,12611,151,15.987,142,15.034,2641,731,1910,5.797,20.943,2948,835,2113,6.621,23.377,-307,-2.434,41.886,107,107,692
1992,2111,6835,8067,115752,117619,779,9.471,1096,13.324,26263,6246,20017,5.31,22.329,29397,10426,18971,8.864,24.993,-3134,-2.665,44.658,629,632,3465
1992,2121,1599,2127,115750,120781,349,15.735,531,23.94,19135,9432,9703,7.809,15.843,28927,12408,16519,10.273,23.95,-9792,-8.107,31.685,371,376,5697
1992,2122,394,577,47056,46534,92,15.862,98,16.897,5427,2558,2869,5.497,11.662,4458,1354,3104,2.91,9.58,969,2.082,19.16,57,60,451
1992,2123,3394,5009,96786,98806,306,6.031,435,8.574,11502,2790,8712,2.824,11.641,15483,3904,11579,3.951,15.67,-3981,-4.029,23.282,245,253,1596
1992,2131,7888,8904,146782,159993,1103,12.105,1519,16.67,27370,11563,15807,7.227,17.107,54150,16960,37190,10.6,33.845,-26780,-16.738,34.214,1015,1021,7004
1992,2211,1492,6827,633646,635585,458,6.839,197,2.942,64473,30456,34017,4.792,10.144,68315,21942,46373,3.452,10.748,-3842,-0.604,20.288,62,63,430
1992,2212,581,2727,108546,108686,361,13.758,155,5.907,14109,9200,4909,8.465,12.981,14295,3027,11268,2.785,13.153,-186,-0.171,25.963,42,42,294
1992,2213,3709,4076,30361,30031,308,7.581,282,6.941,3979,1467,2512,4.885,13.25,3288,1470,1818,4.895,10.949,691,2.301,21.898,194,194,668
1992,2361,112717,113117,555557,559708,22216,19.624,22398,19.785,172982,70742,102240,12.639,30.906,181749,77683,104066,13.879,32.472,-8767,-1.566,61.812,15673,15684,56869
1992,2362,35864,36499,585159,608283,4249,11.494,5183,14.021,121180,28295,92885,4.652,19.922,167681,35834,131847,5.891,27.566,-46501,-7.645,39.843,3859,3859,24805
1992,2371,13852,14153,309967,315171,1223,8.574,1446,10.137,62420,9324,53096,2.958,19.805,72209,12602,59607,3.998,22.911,-9789,-3.106,39.61,1026,1027,8642
1992,2372,6542,6730,55795,58680,1154,15.801,2301,31.505,15243,6090,9153,10.378,25.976,21037,10806,10231,18.415,35.85,-5794,-9.874,51.953,1811,1818,8496
1992,2373,9345,9715,225634,227852,858,8.76,1016,10.374,45944,7421,38523,3.257,20.164,50346,9366,40980,4.111,22.096,-4402,-1.932,40.328,748,750,5827
1992,2379,4774,4848,72100,73133,635,12.843,828,16.746,16697,3259,13438,4.456,22.831,18743,5511,13232,7.536,25.629,-2046,-2.798,45.662,622,622,3251
1992,2381,75719,76152,644341,653304,10668,13.949,11317,14.798,173443,47678,125765,7.298,26.549,190628,57623,133005,8.82,29.179,-17185,-2.63,53.097,8223,8227,44600
1992,2382,120522,122485,1158958,1179423,13283,10.776,14838,12.038,225494,52682,172812,4.467,19.119,266334,67046,199288,5.685,22.582,-40840,-3.463,38.238,11008,11015,51338
1992,2383,79893,80361,579969,593257,13371,16.557,14166,17.541,155394,50998,104396,8.596,26.193,182037,59922,122115,10.101,30.684,-26643,-4.491,52.387,10326,10334,45446
1992,2389,40306,40546,323274,329739,5219,12.742,6045,14.759,78667,21676,56991,6.574,23.857,91791,29947,61844,9.082,27.838,-13124,-3.98,47.715,4338,4339,20503
1992,3111,1137,1750,48310,48558,84,4.752,119,6.733,4598,1066,3532,2.195,9.469,5050,1149,3901,2.366,10.4,-452,-0.931,18.938,76,76,478
1992,3112,457,806,64795,64983,51,6.359,43,5.362,4906,1433,3473,2.205,7.55,5469,1486,3983,2.287,8.416,-563,-0.866,15.099,23,23,613
1992,3113,1469,1691,84315,83255,177,10.378,206,12.079,10101,1702,8399,2.044,12.133,8090,2149,5941,2.581,9.717,2011,2.415,19.434,123,128,1219
1992,3114,1226,1665,174323,175332,139,8.422,110,6.665,17437,3735,13702,2.13,9.945,19433,3763,15670,2.146,11.084,-1996,-1.138,19.89,70,70,1557
1992,3115,1314,1891,134102,134846,85,4.45,123,6.44,11350,1523,9827,1.129,8.417,12835,4633,8202,3.436,9.518,-1485,-1.101,16.834,78,79,1709
1992,3116,3561,4175,392826,393012,242,5.709,370,8.728,31601,4620,26981,1.176,8.041,31901,10121,21780,2.575,8.117,-300,-0.076,16.081,274,275,4078
1992,3117,667,774,46697,46698,65,8.275,88,11.203,8790,1498,7292,3.208,18.823,8596,2880,5716,6.167,18.408,194,0.415,36.815,59,59,1828
1992,3118,9067,10255,303172,303855,1189,11.498,1360,13.152,36254,8959,27295,2.948,11.931,37969,15086,22883,4.965,12.496,-1715,-0.564,23.863,872,887,6207
1992,3119,2149,2521,133045,133078,237,9.401,237,9.401,16581,5682,10899,4.27,12.46,16801,6536,10265,4.911,12.625,-220,-0.165,24.919,173,174,2856
1992,3121,1666,2100,132667,134609,153,7.262,167,7.926,10331,2464,7867,1.83,7.675,14326,3575,10751,2.656,10.643,-3995,-2.968,15.35,128,128,1500
1992,3122,76,110,37022,36505,4,3.604,6,5.405,2229,14,2215,0.038,6.106,1278,42,1236,0.115,3.501,951,2.605,7.002,4,4,6
1992,3131,340,588,98007,97771,22,3.67,45,7.506,7832,1170,6662,1.197,8.011,7326,2640,4686,2.7,7.493,506,0.518,14.986,32,32,671
1992,3132,1614,1957,242342,242298,149,7.581,166,8.446,18719,3390,15329,1.399,7.726,18656,5069,13587,2.092,7.7,63,0.026,15.399,120,120,1309
1992,3133,1897,2107,103665,101605,216,10.208,234,11.059,12900,2360,10540,2.323,12.696,8826,2543,6283,2.503,8.687,4074,4.01,17.373,173,175,1415
1992,3141,3015,3308,121217,120965,256,7.439,523,15.197,14383,2051,12332,1.696,11.89,13933,4610,9323,3.811,11.518,450,0.372,23.036,414,416,2983
1992,3149,3871,3996,115278,113355,459,11.409,513,12.752,21407,6262,15145,5.524,18.885,17318,6644,10674,5.861,15.278,4089,3.607,30.555,431,431,5128
1992,3151,1099,1229,118225,117225,145,11.75,155,12.561,15054,4131,10923,3.524,12.842,12964,4963,8001,4.234,11.059,2090,1.783,22.118,125,130,3288
1992,3152,11132,12282,689697,688145,2056,16.578,2296,18.513,115844,40821,75023,5.932,16.834,113296,54644,58652,7.941,16.464,2548,0.37,32.928,1947,1960,39390
1992,3159,1785,1883,62746,62548,226,11.92,252,13.291,10015,2815,7200,4.501,16.012,9589,2992,6597,4.784,15.331,426,0.681,30.661,206,206,2131
1992,3161,306,338,17341,16662,26,7.613,33,9.663,2489,392,2097,2.353,14.939,1192,286,906,1.717,7.154,1297,7.784,14.308,27,27,166
1992,3162,328,424,62143,62857,31,7.168,48,11.098,6055,755,5300,1.201,9.633,7413,3353,4060,5.334,11.794,-1358,-2.16,19.266,24,25,414
1992,3169,1057,1101,31718,32220,121,10.995,120,10.904,4560,1547,3013,4.801,14.153,5493,1763,3730,5.472,17.048,-933,-2.896,28.305,92,92,782
1992,3211,4315,4822,126334,126692,406,8.326,514,10.541,14340,3439,10901,2.714,11.319,14957,5485,9472,4.329,11.806,-617,-0.487,22.638,379,381,3245
1992,3212,1279,1573,91724,89820,106,6.652,147,9.225,12715,2710,10005,3.017,14.156,9002,3279,5723,3.651,10.022,3713,4.134,20.045,105,105,1376
1992,3219,8940,9596,253810,251763,959,9.911,1120,11.574,38567,7985,30582,3.172,15.319,34376,11339,23037,4.504,13.654,4191,1.665,27.308,846,846,6774
1992,3221,210,521,189894,190275,20,3.813,27,5.148,7456,2275,5181,1.196,3.919,8341,2615,5726,1.374,4.384,-885,-0.465,7.837,15,15,504
1992,3222,3494,5114,393669,394971,239,4.646,300,5.831,30524,7068,23456,1.79,7.728,32897,7847,25050,1.987,8.329,-2373,-0.601,15.456,184,188,3428
1992,3231,42085,44104,813781,819535,3666,8.256,4265,9.605,91482,26461,65021,3.229,11.163,103752,33373,70379,4.072,12.66,-12270,-1.497,22.325,3479,3487,21826
1992,3241,1126,2034,135710,136116,107,5.149,195,9.384,9785,2691,7094,1.977,7.189,10517,4236,6281,3.112,7.726,-732,-0.538,14.377,82,82,820
1992,3251,1107,2265,231061,230248,103,4.477,174,7.564,14223,2957,11266,1.284,6.177,12770,3583,9187,1.556,5.546,1453,0.631,11.092,79,80,1085
1992,3252,326,606,131959,132502,34,5.601,36,5.931,6371,1618,4753,1.221,4.808,7373,1440,5933,1.087,5.564,-1002,-0.756,9.616,17,17,128
1992,3253,613,836,41634,41505,47,5.592,56,6.663,3833,1180,2653,2.843,9.235,3478,1009,2469,2.431,8.38,355,0.855,16.76,38,38,303
1992,3254,1059,1347,191229,186308,94,6.953,104,7.692,24502,4644,19858,2.493,13.151,14396,3453,10943,1.853,7.727,10106,5.424,15.454,65,65,1619
1992,3255,1601,2071,72266,73979,117,5.597,156,7.462,6174,1467,4707,1.983,8.346,9711,2488,7223,3.363,13.127,-3537,-4.781,16.691,88,93,737
1992,3256,1993,2233,117325,118193,153,6.77,207,9.159,13603,5194,8409,4.395,11.509,15309,6043,9266,5.113,12.953,-1706,-1.443,23.018,153,153,1478
1992,3259,2224,2903,129674,131526,220,7.571,226,7.777,9833,2053,7780,1.561,7.476,13533,3840,9693,2.92,10.289,-3700,-2.813,14.952,133,133,1206
1992,3261,10129,12195,670649,660982,876,7.177,899,7.365,87726,17005,70721,2.573,13.272,67761,18592,49169,2.813,10.252,19965,3.021,20.503,642,646,8635
1992,3262,2225,2705,184802,184986,201,7.462,178,6.609,15604,3573,12031,1.931,8.435,16185,4428,11757,2.394,8.749,-581,-0.314,16.87,106,110,1226
1992,3271,1401,1694,74350,73994,148,8.663,177,10.36,8061,2319,5742,3.134,10.894,7286,1656,5630,2.238,9.847,775,1.047,19.694,130,130,893
1992,3272,1689,1957,132395,131730,181,9.185,208,10.556,11603,2005,9598,1.522,8.808,10046,3029,7017,2.299,7.626,1557,1.182,15.252,152,152,1108
1992,3273,6041,8821,163416,167235,465,5.21,674,7.551,22486,5145,17341,3.077,13.446,30036,8657,21379,5.177,17.96,-7550,-4.515,26.892,359,364,3628
1992,3274,254,355,16986,17172,29,8.146,31,8.708,910,253,657,1.473,5.299,1279,436,843,2.539,7.448,-369,-2.149,10.599,18,18,139
1992,3279,1916,2212,67051,68942,188,8.499,188,8.499,8392,3664,4728,5.315,12.173,12109,5323,6786,7.721,17.564,-3717,-5.391,24.345,140,142,1361
1992,3311,219,278,147294,149648,18,6.207,42,14.483,4597,503,4094,0.336,3.072,9253,2212,7041,1.478,6.183,-4656,-3.111,6.144,30,30,399
1992,3312,507,701,63776,64032,28,3.938,48,6.751,4876,735,4141,1.148,7.615,5328,1613,3715,2.519,8.321,-452,-0.706,15.23,25,25,391
1992,3313,390,554,88548,90618,30,5.391,35,6.289,5233,1186,4047,1.309,5.775,9240,4058,5182,4.478,10.197,-4007,-4.422,11.55,16,16,170
1992,3314,794,953,78532,79817,67,6.99,78,8.138,5224,1738,3486,2.177,6.545,7937,2033,5904,2.547,9.944,-2713,-3.399,13.09,54,54,646
1992,3315,2400,2654,190647,194330,115,4.249,220,8.129,14722,2256,12466,1.161,7.576,21984,5345,16639,2.75,11.313,-7262,-3.737,15.152,159,160,1871
1992,3321,3161,3353,126433,127755,191,5.646,251,7.419,13140,2878,10262,2.253,10.285,15608,4356,11252,3.41,12.217,-2468,-1.932,20.571,182,183,2216
1992,3322,1327,1452,74133,74781,84,5.771,91,6.252,5835,467,5368,0.624,7.803,7071,1934,5137,2.586,9.456,-1236,-1.653,15.606,63,63,499
1992,3323,10323,11092,310507,314467,658,5.834,1030,9.133,39923,10986,28937,3.494,12.695,47672,12362,35310,3.931,15.16,-7749,-2.464,25.391,769,776,7355
1992,3324,1545,1866,106923,109278,94,5.004,119,6.335,8444,1714,6730,1.568,7.727,13200,2375,10825,2.173,12.079,-4756,-4.352,15.454,75,75,848
1992,3325,902,989,64974,64558,70,7.06,75,7.564,5566,732,4834,1.134,8.622,4810,684,4126,1.06,7.451,756,1.171,14.901,52,52,295
1992,3326,1501,1674,62041,60957,97,5.736,131,7.747,7777,1428,6349,2.343,12.758,5595,1142,4453,1.873,9.179,2182,3.58,18.357,106,106,718
1992,3327,21711,22036,324844,333032,1797,8.124,1962,8.87,36319,8425,27894,2.53,10.906,52735,15753,36982,4.73,15.835,-16416,-4.929,21.811,1446,1452,8112
1992,3328,5316,5706,126746,127599,330,5.723,451,7.821,16004,3187,12817,2.498,12.542,17618,4888,12730,3.831,13.807,-1614,-1.265,25.085,339,343,3537
1992,3329,5777,6276,314664,319182,464,7.34,555,8.78,25508,5934,19574,1.859,7.992,34460,7769,26691,2.434,10.796,-8952,-2.805,15.983,420,421,3761
1992,3331,2735,2986,190372,196697,200,6.628,263,8.716,14705,2852,11853,1.45,7.476,27025,5135,21890,2.611,13.739,-12320,-6.263,14.952,167,170,1638
1992,3332,4018,4269,154140,158077,244,5.669,314,7.296,13857,3141,10716,1.987,8.766,21743,4300,17443,2.72,13.755,-7886,-4.989,17.532,230,232,2239
1992,3333,2418,2547,141231,142928,191,7.473,209,8.177,13703,2436,11267,1.704,9.587,17269,5691,11578,3.982,12.082,-3566,-2.495,19.175,137,137,1020
1992,3334,1541,1785,147774,145596,122,6.8,140,7.804,17111,2429,14682,1.668,11.752,12649,4649,8000,3.193,8.688,4462,3.065,17.376,99,100,1176
1992,3335,9269,9604,204866,207606,503,5.196,657,6.786,20378,3974,16404,1.914,9.816,26003,6411,19592,3.088,12.525,-5625,-2.709,19.631,477,480,3868
1992,3336,768,909,119389,120982,55,6.061,52,5.73,5708,1017,4691,0.841,4.718,8945,2396,6549,1.98,7.394,-3237,-2.676,9.436,32,32,467
1992,3339,5340,5949,297112,304243,417,7.015,408,6.863,24049,6491,17558,2.133,7.905,38035,9051,28984,2.975,12.502,-13986,-4.597,15.809,282,282,2758
1992,3341,1650,1756,197057,213138,246,14.029,241,13.744,21459,5258,16201,2.467,10.068,54061,19857,34204,9.317,25.364,-32602,-15.296,20.136,176,177,4670
1992,3342,1749,1945,217183,221763,165,8.429,190,9.706,20656,4140,16516,1.867,9.314,29874,6720,23154,3.03,13.471,-9218,-4.157,18.629,128,128,2348
1992,3343,386,417,31539,31908,44,10.39,57,13.459,3046,389,2657,1.219,9.546,3710,1085,2625,3.4,11.627,-664,-2.081,19.092,45,45,583
1992,3344,4956,5510,475996,487921,529,9.533,607,10.939,46346,14539,31807,2.98,9.499,70153,24815,45338,5.086,14.378,-23807,-4.879,18.997,432,434,7035
1992,3345,4560,5172,574839,598371,374,7.208,407,7.844,29577,6156,23421,1.029,4.943,76304,15176,61128,2.536,12.752,-46727,-7.809,9.886,257,257,2896
1992,3346,688,738,41383,48506,111,15.01,114,15.416,4911,1076,3835,2.218,10.125,18852,15712,3140,32.392,38.865,-13941,-28.741,20.249,77,78,1958
1992,3351,1143,1257,71246,71113,100,7.918,112,8.868,7572,1463,6109,2.057,10.648,7369,1788,5581,2.514,10.362,203,0.285,20.725,86,86,1073
1992,3352,335,411,99514,98116,40,9.627,49,11.793,9787,1387,8400,1.414,9.975,6815,1002,5813,1.021,6.946,2972,3.029,13.892,30,30,249
1992,3353,2188,2625,203741,206571,156,5.911,184,6.972,15685,4532,11153,2.194,7.593,21599,6213,15386,3.008,10.456,-5914,-2.863,15.186,108,108,1309
1992,3359,1825,2183,176766,179690,142,6.415,203,9.171,15375,4476,10899,2.491,8.556,21165,5846,15319,3.253,11.779,-5790,-3.222,17.113,119,120,1253
1992,3361,248,302,209298,201807,39,12.871,41,13.531,26182,962,25220,0.477,12.974,10786,2117,8669,1.049,5.345,15396,7.629,10.689,34,34,333
1992,3362,1705,1885,99562,96921,146,7.579,229,11.887,16585,2702,13883,2.788,17.112,11375,4223,7152,4.357,11.736,5210,5.376,23.473,174,177,2555
1992,3363,4203,5093,632689,616965,325,6.347,380,7.421,75662,12458,63204,2.019,12.264,44842,14265,30577,2.312,7.268,30820,4.995,14.536,257,258,3096
1992,3364,1468,1805,639337,658860,118,6.5,139,7.656,54406,35984,18422,5.462,8.258,93233,37850,55383,5.745,14.151,-38827,-5.893,16.515,98,98,837
1992,3365,166,218,23895,28389,7,3.111,21,9.333,2203,109,2094,0.384,7.76,10514,7509,3005,26.45,37.035,-8311,-29.275,15.52,16,16,534
1992,3366,1301,1398,150939,151613,124,8.813,142,10.092,15066,1347,13719,0.888,9.937,16479,3570,12909,2.355,10.869,-1413,-0.932,19.874,100,100,1426
1992,3369,480,497,30672,31291,60,12.208,49,9.969,3057,492,2565,1.572,9.77,4345,522,3823,1.668,13.886,-1288,-4.116,19.539,38,38,349
1992,3371,12852,13411,347228,348840,1490,10.941,1906,13.995,44383,10861,33522,3.113,12.723,47813,17085,30728,4.898,13.706,-3430,-0.983,25.446,1444,1451,10501
1992,3372,3055,3245,143616,146517,254,7.675,383,11.573,16416,4072,12344,2.779,11.204,22171,6099,16072,4.163,15.132,-5755,-3.928,22.408,301,303,3968
1992,3379,1081,1217,39095,39144,76,6.117,127,10.221,4507,680,3827,1.737,11.514,4641,1634,3007,4.174,11.856,-134,-0.342,23.028,101,101,977
1992,3391,10559,11122,265519,263150,953,8.594,888,8.008,33569,7544,26025,2.867,12.757,28741,10230,18511,3.888,10.922,4828,1.835,21.844,647,648,4433
1992,3399,15086,15603,388599,387281,1646,10.44,1974,12.52,56046,14860,41186,3.837,14.472,53349,17906,35443,4.624,13.775,2697,0.696,27.551,1584,1585,11395
1992,4231,20862,25891,291512,294690,2388,9.149,2806,10.751,42240,13729,28511,4.659,14.334,48588,17024,31564,5.777,16.488,-6348,-2.154,28.667,1697,1762,9116
1992,4232,9023,10268,119637,121493,1253,12.188,1278,12.431,20072,5988,14084,4.929,16.521,23773,9080,14693,7.474,19.567,-3701,-3.046,33.042,851,883,5628
1992,4233,8105,10793,131537,132159,1083,9.991,1176,10.849,20089,5659,14430,4.282,15.201,21398,7527,13871,5.695,16.191,-1309,-0.99,30.401,766,783,4702
1992,4234,26217,34855,596879,607528,4697,13.576,4181,12.085,108074,38348,69726,6.312,17.789,129567,51314,78253,8.446,21.327,-21493,-3.538,35.578,2126,2284,13523
1992,4235,6905,9315,130213,132862,720,7.652,908,9.65,15744,4700,11044,3.538,11.85,20926,6553,14373,4.932,15.75,-5182,-3.9,23.7,512,527,2708
1992,4236,17924,26441,337085,343815,2700,10.207,2721,10.287,56560,19218,37342,5.59,16.451,69776,23818,45958,6.928,20.295,-13216,-3.844,32.901,1436,1484,9407
1992,4237,11409,16135,176090,177033,1344,8.369,1191,7.417,22882,7006,15876,3.957,12.925,24618,6977,17641,3.941,13.906,-1736,-0.981,25.851,725,770,3905
1992,4238,47522,61694,637165,647068,5176,8.325,6133,9.864,82937,25136,57801,3.885,12.817,103350,35978,67372,5.56,15.972,-20413,-3.155,25.635,3458,3775,17582
1992,4239,25254,27249,272920,273216,3740,13.806,3422,12.632,49953,16713,33240,6.117,18.283,50394,18050,32344,6.607,18.445,-441,-0.161,36.567,2526,2555,11668
1992,4241,9766,12752,191087,187969,1048,8.164,1218,9.488,39173,5805,33368,3.088,20.84,33193,16709,16484,8.889,17.659,5980,3.181,35.318,674,706,3679
1992,4242,3479,4627,133496,130145,743,16.328,590,12.966,31776,11182,20594,8.592,24.416,25077,11435,13642,8.786,19.269,6699,5.147,38.537,330,336,2501
1992,4243,12565,13638,168627,162190,2170,16.06,1917,14.188,42185,13635,28550,8.407,26.01,29501,12439,17062,7.669,18.189,12684,7.82,36.378,1451,1477,7999
1992,4244,27546,33778,695433,695572,3680,10.874,3806,11.247,107997,29991,78006,4.312,15.526,107567,38556,69011,5.543,15.465,430,0.062,30.929,2548,2572,16839
1992,4245,6316,9168,80967,81662,524,5.581,965,10.279,12684,3329,9355,4.077,15.532,14087,5262,8825,6.444,17.25,-1403,-1.718,31.065,498,526,3057
1992,4246,8487,12419,139537,139724,1293,10.483,1124,9.113,25531,9782,15749,7.001,18.273,25885,10707,15178,7.663,18.526,-354,-0.253,36.545,530,549,2710
1992,4247,8709,11762,133117,134872,759,6.326,1231,10.26,22688,6400,16288,4.745,16.822,26076,8291,17785,6.147,19.334,-3388,-2.512,33.644,576,589,3578
1992,4248,3444,4453,133432,132996,280,6.222,375,8.332,13863,4038,9825,3.036,10.424,13053,4495,8558,3.38,9.815,810,0.609,19.629,224,225,2321
1992,4249,21668,26613,316757,315686,3127,11.691,3397,12.7,60730,23742,36988,7.521,19.237,59141,26785,32356,8.485,18.734,1589,0.503,37.468,2342,2378,12283
1992,4251,31850,34178,301493,303372,3826,11.27,3368,9.921,49958,16689,33269,5.501,16.468,53311,19426,33885,6.403,17.573,-3353,-1.105,32.935,2031,2061,9577
1992,4411,37361,39486,909677,911605,4137,10.415,4606,11.596,118419,42582,75837,4.671,12.99,122293,53799,68494,5.902,13.415,-3874,-0.425,25.98,3552,3593,42509
1992,4412,10353,11005,75547,75659,1028,9.264,1211,10.913,14363,4185,10178,5.531,18.984,14486,5990,8496,7.917,19.146,-123,-0.163,37.968,889,911,4508
1992,4413,40867,64005,475931,478075,4178,6.444,5836,9.001,71490,22273,49217,4.659,14.954,75376,28141,47235,5.886,15.767,-3886,-0.813,29.907,3202,3502,15611
1992,4421,21133,27691,227442,228866,2951,10.576,3376,12.099,39616,15113,24503,6.603,17.31,42616,16361,26255,7.149,18.621,-3000,-1.311,34.619,2077,2222,9499
1992,4422,23293,30662,189660,189883,3625,11.877,3345,10.959,36652,15487,21165,8.156,19.302,37277,11461,25816,6.036,19.632,-625,-0.329,38.605,2066,2206,7290
1992,4431,25331,36352,268810,264424,5273,14.568,4962,13.709,65580,32796,32784,12.403,24.801,57253,25913,31340,9.8,21.652,8327,3.149,43.304,2823,3033,13047
1992,4441,51940,68558,753448,752031,4681,6.753,6196,8.939,114677,37849,76828,5.033,15.249,113403,41052,72351,5.459,15.08,1274,0.169,30.159,3936,4070,20473
1992,4442,15836,19314,150193,150045,1510,7.776,1719,8.852,24555,6065,18490,4.042,16.365,24258,7185,17073,4.789,16.167,297,0.198,32.334,1111,1131,4263
1992,4451,60538,90660,2421362,2435749,9224,10.105,10464,11.464,277430,123097,154333,5.054,11.39,305791,95608,210183,3.925,12.554,-28361,-1.164,22.78,6741,6959,44159
1992,4452,17680,21390,131629,133510,3047,14.06,3609,16.654,29516,13592,15924,10.181,22.108,33064,16160,16904,12.104,24.765,-3548,-2.657,44.215,2328,2413,10353
1992,4453,24500,28830,133958,137311,2656,9.06,3628,12.375,22895,7847,15048,5.715,16.674,29498,13033,16465,9.492,21.483,-6603,-4.809,33.348,2481,2546,8204
1992,4461,45192,75843,746233,747972,7031,9.239,7543,9.912,113854,50289,63565,6.723,15.222,116771,46916,69855,6.272,15.612,-2917,-0.39,30.443,4248,4406,21656
1992,4471,75720,128240,892539,911762,11228,8.642,14597,11.235,154978,63477,91501,6.962,16.998,193222,76526,116696,8.393,21.192,-38244,-4.195,33.995,8242,8771,43518
1992,4481,47923,101564,982474,1028451,11605,11.286,14139,13.75,177229,84430,92799,8.209,17.233,273972,74598,199374,7.253,26.639,-96743,-9.407,34.465,7179,8132,31926
1992,4482,8757,34428,182870,188967,2926,8.358,4084,11.666,34152,15734,18418,8.326,18.073,45887,17793,28094,9.416,24.283,-11735,-6.21,36.146,1287,1550,5903
1992,4483,18914,28246,162216,164274,3172,11.157,3541,12.455,30321,13585,16736,8.27,18.458,34463,14327,20136,8.721,20.979,-4142,-2.521,36.915,1952,2142,7436
1992,4511,31625,42968,330085,327315,5419,12.547,5859,13.566,67242,28942,38300,8.842,20.544,61564,25638,35926,7.833,18.809,5678,1.735,37.618,3855,4104,13899
1992,4512,8725,14433,106280,105044,1714,11.978,1468,10.259,22300,7851,14449,7.474,21.229,19641,6007,13634,5.719,18.698,2659,2.531,37.396,983,1007,3866
1992,4522,145,6612,1064485,1084003,190,2.845,321,4.807,78003,27788,50215,2.563,7.196,117410,25512,91898,2.354,10.831,-39407,-3.635,14.392,15,20,2567
1992,4523,10832,27837,1004449,1002157,2985,10.694,3136,11.235,126975,68556,58419,6.841,12.67,124317,46069,78248,4.597,12.405,2658,0.265,24.81,1385,1467,8105
1992,4531,23432,24818,123022,126442,2692,10.685,3445,13.674,21707,8331,13376,6.589,17.168,28568,10707,17861,8.468,22.594,-6861,-5.426,34.335,2658,2696,8057
1992,4532,30215,38908,254699,255938,5463,13.999,5694,14.591,57937,25818,32119,10.088,22.637,60314,29186,31128,11.404,23.566,-2377,-0.929,45.274,3852,4023,14010
1992,4533,11332,14405,78202,74756,3260,23.694,1968,14.303,24665,15064,9601,20.151,32.994,17171,7666,9505,10.255,22.969,7494,10.025,45.939,1283,1295,3798
1992,4539,24614,28556,146045,146343,4686,16.352,4887,17.054,37184,17061,20123,11.658,25.409,37761,17359,20402,11.862,25.803,-577,-0.394,50.818,3460,3598,12623
1992,4541,6140,6981,133739,129639,850,11.787,1311,18.179,29818,7677,22141,5.922,23.001,21383,7008,14375,5.406,16.494,8435,6.507,32.989,616,625,3027
1992,4542,4249,5318,69518,67678,755,14.253,713,13.46,13287,7370,5917,10.89,19.633,9714,3335,6379,4.928,14.353,3573,5.279,28.707,465,467,2044
1992,4543,16609,23009,210230,215437,2129,9.258,2106,9.158,37719,12879,24840,5.978,17.508,47615,14189,33426,6.586,22.102,-9896,-4.593,35.016,1353,1386,8038
1992,4811,498,2802,439641,459020,229,8.08,293,10.339,33455,3782,29673,0.824,7.288,74333,6920,67413,1.508,16.194,-40878,-8.906,14.577,72,74,1730
1992,4812,1211,1392,20538,20035,223,16.26,182,13.27,5149,1388,3761,6.928,25.701,4160,1319,2841,6.584,20.764,989,4.936,41.528,107,108,427
1992,4831,387,694,39919,40014,82,11.971,64,9.343,7235,1913,5322,4.781,18.081,7386,793,6593,1.982,18.459,-151,-0.377,36.162,34,34,550
1992,4832,286,316,12371,12230,39,12.245,44,13.815,2033,607,1426,4.963,16.624,1690,1024,666,8.373,13.819,343,2.805,27.638,29,29,358
1992,4841,22538,29164,613757,602365,4583,15.865,4029,13.947,112638,36642,75996,6.083,18.699,89094,35323,53771,5.864,14.791,23544,3.909,29.581,2973,3024,20128
1992,4842,46460,50758,517576,520748,7592,14.955,7608,14.986,102123,33557,68566,6.444,19.611,108647,44021,64626,8.453,20.864,-6524,-1.253,39.222,5714,5760,29112
1992,4851,423,499,23610,23246,93,19.436,52,10.867,4303,2838,1465,12.209,18.511,3576,1715,1861,7.378,15.384,727,3.127,30.767,40,40,1584
1992,4852,307,570,19513,18852,129,23.757,75,13.812,4420,987,3433,5.236,23.446,3025,738,2287,3.915,16.046,1395,7.4,32.093,27,27,438
1992,4853,5139,5227,47623,48627,861,16.452,874,16.7,9898,4481,5417,9.215,20.355,11967,5130,6837,10.55,24.61,-2069,-4.255,40.71,725,726,4009
1992,4854,3202,4096,129678,128114,379,9.257,375,9.16,23803,8139,15664,6.353,18.58,20613,6194,14419,4.835,16.09,3190,2.49,32.179,251,251,2732
1992,4855,1089,1203,24402,23892,154,13.073,104,8.829,5096,1560,3536,6.529,21.329,4062,1144,2918,4.788,17.002,1034,4.328,34.003,75,76,579
1992,4859,1118,1204,25040,24497,211,17.776,177,14.912,5834,2120,3714,8.654,23.815,4622,2527,2095,10.316,18.868,1212,4.948,37.735,140,140,1510
1992,4861,44,382,9315,9532,59,15.547,54,14.229,1093,612,481,6.42,11.467,1563,537,1026,5.634,16.397,-470,-4.931,22.933,(D),(D),(D)
1992,4862,147,1302,42573,43766,178,13.836,147,11.426,7176,4949,2227,11.308,16.396,9406,3532,5874,8.07,21.492,-2230,-5.095,32.793,24,24,149
1992,4869,59,387,6179,6363,61,16.667,19,5.191,987,478,509,7.512,15.512,1420,399,1021,6.271,22.317,-433,-6.805,31.023,7,7,78
1992,4871,314,352,6343,6060,69,20.029,54,15.675,1458,329,1129,5.429,24.059,858,338,520,5.578,14.158,600,9.901,28.317,36,37,188
1992,4872,1074,1106,11160,10815,221,20.988,115,10.921,2744,1237,1507,11.438,25.373,2061,634,1427,5.862,19.058,683,6.316,38.115,86,86,505
1992,4879,128,139,947,937,25,18.051,24,17.329,275,74,201,7.902,29.365,255,58,197,6.193,27.229,20,2.136,54.458,19,19,40
1992,4881,2280,2925,76620,78418,437,14.986,419,14.369,15476,5072,10404,6.468,19.735,19425,6208,13217,7.917,24.771,-3949,-5.036,39.471,252,253,2519
1992,4882,451,704,16891,17013,119,17.526,69,10.162,3069,993,2076,5.837,18.039,3343,1410,1933,8.288,19.65,-274,-1.611,36.078,45,45,658
1992,4883,1946,2500,85639,83994,280,11.169,294,11.727,18534,5754,12780,6.851,22.066,15415,3916,11499,4.662,18.353,3119,3.713,36.705,180,186,1800
1992,4884,4105,4280,27791,27864,749,18.116,458,11.078,6343,3136,3207,11.255,22.764,6493,2126,4367,7.63,23.302,-150,-0.538,45.528,349,353,1644
1992,4885,8416,11212,107102,106322,1832,16.841,1164,10.7,22361,8079,14282,7.599,21.031,20651,8032,12619,7.554,19.423,1710,1.608,38.846,791,814,5074
1992,4889,763,813,8624,8605,139,17.386,112,14.009,2056,702,1354,8.158,23.893,2030,777,1253,9.03,23.591,26,0.302,47.182,86,86,577
1992,4921,1348,4169,361336,367295,587,14.328,443,10.813,27194,7172,20022,1.953,7.404,40896,9888,31008,2.692,11.134,-13702,-3.731,14.808,227,227,1872
1992,4922,3487,3826,53968,53534,703,18.655,588,15.603,13613,6367,7246,11.893,25.429,12543,4193,8350,7.832,23.43,1070,1.999,46.86,477,481,3174
1992,4931,6368,10567,448798,446006,1013,9.635,907,8.627,81411,34787,46624,7.8,18.253,76015,16828,59187,3.773,17.044,5396,1.21,34.087,317,326,3091
1992,5111,14832,17514,691704,744795,1882,10.769,1805,10.329,68270,17703,50567,2.377,9.166,177585,18136,159449,2.435,23.843,-109315,-14.677,18.333,1385,1391,9953
1992,5112,5189,6268,127751,122623,1089,17.982,665,10.981,33755,11480,22275,9.362,27.527,23679,11438,12241,9.328,19.31,10076,8.217,38.621,429,431,3993
1992,5121,9737,14337,208851,231124,2133,14.869,2150,14.987,42618,17634,24984,7.63,18.439,86736,53200,33536,23.018,37.528,-44118,-19.088,36.879,1133,1251,10476
1992,5122,1512,1554,12791,12502,267,16.835,331,20.87,4120,1246,2874,9.966,32.955,3520,1331,2189,10.646,28.155,600,4.799,56.311,261,261,1074
1992,5151,5901,7842,223107,226870,836,10.688,796,10.176,29189,12805,16384,5.644,12.866,36371,13312,23059,5.868,16.032,-7182,-3.166,25.732,527,530,5862
1992,5152,214,352,14866,15057,52,14.964,43,12.374,3681,1748,1933,11.609,24.447,4016,2527,1489,16.783,26.672,-335,-2.225,48.894,18,18,413
1992,5173,5172,27640,1029126,1040273,3229,11.784,2754,10.05,147687,57651,90036,5.542,14.197,168738,66562,102176,6.399,16.221,-21051,-2.024,28.394,570,583,12139
1992,5174,172,262,5106,6336,64,23.792,78,28.996,1294,819,475,12.926,20.423,3739,2891,848,45.628,59.012,-2445,-38.589,40.846,14,14,138
1992,5179,1096,1981,40038,40013,457,23.017,466,23.47,9185,5394,3791,13.481,22.955,9237,4451,4786,11.124,23.085,-52,-0.13,45.91,182,184,1243
1992,5182,5054,7340,269894,276938,1057,14.302,1158,15.669,55992,20522,35470,7.41,20.218,69068,29759,39309,10.746,24.94,-13076,-4.722,40.436,529,539,17345
1992,5191,2391,2810,32979,32551,248,8.843,237,8.451,4594,1364,3230,4.19,14.113,3824,1472,2352,4.522,11.748,770,2.366,23.495,169,169,853
1992,5211,15,45,24097,24215,(D),(D),11,22,624,(D),623,(D),2.577,858,342,516,1.412,3.543,-234,-0.966,5.154,3,3,10
1992,5221,23057,101359,2045295,2092159,6502,6.454,5283,5.244,307202,90157,217045,4.309,14.683,402955,86183,316772,4.119,19.26,-95753,-4.577,29.367,789,1062,21337
1992,5222,12301,33501,441247,430131,4203,12.603,3899,11.692,102596,35863,66733,8.338,23.852,80104,33632,46472,7.819,18.623,22492,5.229,37.246,1524,1532,8971
1992,5223,7540,9657,76028,72257,2130,23.219,1163,12.678,24436,10610,13826,14.684,33.818,16644,7749,8895,10.724,23.034,7792,10.784,46.069,745,747,3619
1992,5231,6364,18850,323989,319783,2869,15.716,1679,9.197,54333,18018,36315,5.634,16.991,45421,18821,26600,5.886,14.204,8912,2.787,28.407,792,812,5704
1992,5232,21,35,6418,6434,(D),(D),12,30,802,(D),778,(D),12.466,826,139,687,2.161,12.839,-24,-0.373,24.932,7,7,27
1992,5239,17663,19120,185730,177809,3884,21.121,2423,13.176,46700,17924,28776,10.08,26.264,30884,13660,17224,7.682,17.369,15816,8.895,34.738,1703,1712,7474
1992,5241,3686,37329,1548310,1552587,3489,9.248,4287,11.363,206530,76191,130339,4.907,13.302,213440,63339,150101,4.08,13.747,-6910,-0.445,26.605,590,608,4752
1992,5242,105291,115921,704357,716569,11847,10.246,11261,9.739,139766,44767,94999,6.247,19.505,164400,82389,82011,11.498,22.943,-24634,-3.438,39.01,7701,7747,53512
1992,5259,681,713,18046,18246,118,16.435,128,17.827,3031,607,2424,3.327,16.612,3274,813,2461,4.456,17.944,-243,-1.332,33.225,81,81,406
1992,5311,87617,95285,492649,495644,10876,11.412,10909,11.447,101552,44074,57478,8.892,20.489,106762,46443,60319,9.37,21.54,-5210,-1.051,40.978,8502,8559,32577
1992,5312,41232,46814,221956,222994,7470,16.053,6907,14.843,55787,23547,32240,10.56,25.017,58035,24924,33111,11.177,26.025,-2248,-1.008,50.035,4747,4828,15438
1992,5313,28425,31543,362628,356882,4977,16.124,3624,11.741,85023,34679,50344,9.717,23.824,73631,22455,51176,6.292,20.632,11392,3.192,41.264,2419,2465,13385
1992,5321,4822,9618,128207,130093,1067,10.972,1281,13.172,20570,8492,12078,6.528,15.812,24231,8674,15557,6.668,18.626,-3661,-2.814,31.624,644,674,4200
1992,5322,21332,29924,203268,208647,5114,17.295,4403,14.891,52789,26976,25813,12.929,25.301,62705,20508,42197,9.829,30.053,-9916,-4.753,50.601,3055,3319,14478
1992,5323,3843,5910,39115,40333,541,9.076,642,10.771,6377,2284,4093,5.663,15.811,8645,2924,5721,7.25,21.434,-2268,-5.623,31.622,347,399,1779
1992,5324,7153,9666,106172,109665,1096,11.169,1389,14.155,22562,7116,15446,6.489,20.574,28913,14699,14214,13.404,26.365,-6351,-5.791,41.147,829,894,3936
1992,5331,1312,1458,22019,21045,261,18.367,187,13.16,5497,1480,4017,7.033,26.121,3654,1208,2446,5.74,17.363,1843,8.758,34.726,116,116,875
1992,5411,139570,145839,989031,979980,14306,9.899,11666,8.072,141795,45581,96214,4.651,14.469,123612,37839,85773,3.861,12.614,18183,1.855,25.227,8402,8466,27217
1992,5412,75293,79475,705519,707216,9931,12.682,7596,9.7,137094,48904,88190,6.915,19.385,138042,74856,63186,10.585,19.519,-948,-0.134,38.77,5332,5382,60426
1992,5413,63580,71888,943946,946610,8977,12.535,8435,11.778,161020,49674,111346,5.248,17.01,166312,46022,120290,4.862,17.569,-5292,-0.559,34.02,5572,5642,24400
1992,5414,16812,17023,90431,92866,3137,18.477,3046,17.941,21937,9650,12287,10.391,23.622,26743,13714,13029,14.768,28.798,-4806,-5.175,47.245,2324,2329,9504
1992,5415,26830,30866,443345,430752,6861,22.82,5261,17.498,105257,40465,64792,9.394,24.436,80125,31695,48430,7.358,18.601,25132,5.834,37.202,3578,3616,16050
1992,5416,39586,42254,340365,339704,9439,22.949,7191,17.484,93929,38887,55042,11.447,27.65,92569,44572,47997,13.121,27.25,1360,0.4,54.5,5228,5265,32594
1992,5417,6644,8645,468033,466071,1358,16.1,938,11.12,74410,22502,51908,4.828,15.965,70549,16735,53814,3.591,15.137,3861,0.828,30.274,543,550,3675
1992,5418,27320,31153,349987,368681,4483,14.281,4961,15.803,67823,24835,42988,6.736,18.396,103021,64970,38051,17.622,27.943,-35198,-9.547,36.792,3806,3834,54780
1992,5419,35215,39883,330046,325085,4050,10.227,3487,8.805,68065,22278,45787,6.853,20.938,57364,20902,36462,6.43,17.646,10701,3.292,35.292,2244,2258,9742
1992,5511,28396,53475,3236929,3266986,4907,9.077,6072,11.232,583836,157267,426569,4.814,17.871,644366,179116,465250,5.483,19.724,-60530,-1.853,35.742,906,941,14708
1992,5611,12822,14244,276845,267010,3102,22.734,1904,13.954,81557,40365,41192,15.117,30.545,61442,25698,35744,9.624,23.011,20115,7.533,46.022,1379,1394,16092
1992,5612,475,912,76709,76299,107,11.895,82,9.116,9255,2993,6262,3.923,12.13,8378,3041,5337,3.986,10.981,877,1.149,21.961,32,37,490
1992,5613,19242,27413,1682749,1612967,4525,16.561,4346,15.906,551298,185742,365556,11.516,34.179,409178,146477,262701,9.081,25.368,142120,8.811,50.736,2840,2923,88413
1992,5614,23689,27103,366293,362577,4356,16.188,3967,14.743,81450,32035,49415,8.835,22.464,73232,25139,48093,6.933,20.198,8218,2.267,40.395,2918,2941,15619
1992,5615,24223,30931,234683,234747,3911,12.638,3941,12.735,45097,18717,26380,7.973,19.211,45206,19123,26083,8.146,19.257,-109,-0.046,38.422,2638,2696,12402
1992,5616,13249,16950,533413,540707,2405,14.31,2119,12.608,92280,31601,60679,5.844,17.067,107928,31368,76560,5.801,19.961,-15648,-2.894,34.133,1536,1556,17962
1992,5617,93092,97589,1141268,1131758,17439,18.01,15919,16.44,257384,85848,171536,7.585,22.742,237941,88832,149109,7.849,21.024,19443,1.718,42.048,12316,12335,56650
1992,5619,15787,17376,246578,240224,3068,17.811,2766,16.058,69269,28953,40316,12.053,28.835,57366,20898,36468,8.699,23.88,11903,4.955,47.761,2064,2071,13355
1992,5621,3999,4452,72140,70913,330,7.369,383,8.552,11063,3299,7764,4.652,15.601,8562,2525,6037,3.561,12.074,2501,3.527,24.148,295,295,1611
1992,5622,1578,2382,67792,68018,375,15.964,309,13.155,13376,5892,7484,8.662,19.666,13777,4838,8939,7.113,20.255,-401,-0.59,39.331,182,185,1993
1992,5629,4840,5172,60746,60555,712,13.769,710,13.73,14077,3978,10099,6.569,23.247,13810,4887,8923,8.07,22.806,267,0.441,45.611,512,516,3082
1992,6111,14153,16061,532252,522100,802,5.042,490,3.081,55564,11095,44469,2.125,10.642,35124,7940,27184,1.521,6.727,20440,3.915,13.455,350,351,6067
1992,6112,592,904,74603,72792,70,7.834,49,5.484,10221,2813,7408,3.864,14.041,6445,1229,5216,1.688,8.854,3776,5.187,17.708,25,31,633
1992,6113,2097,2482,1118741,1102666,98,3.956,89,3.592,85319,1090,84229,0.099,7.738,51634,2351,49283,0.213,4.683,33685,3.055,9.365,47,48,1190
1992,6114,3244,3729,47276,47515,697,19.23,488,13.464,10221,3290,6931,6.924,21.511,10640,4841,5799,10.188,22.393,-419,-0.882,43.023,335,341,3641
1992,6115,4611,5472,64662,64875,674,12.339,655,11.991,13056,3768,9288,5.808,20.125,13446,4630,8816,7.137,20.726,-390,-0.601,40.25,409,442,3168
1992,6116,14508,15431,117875,114419,2663,17.597,2067,13.659,29092,11439,17653,9.997,25.426,22226,9785,12441,8.552,19.425,6866,6.001,38.85,1618,1624,7996
1992,6117,2320,2409,19458,18715,490,21.035,331,14.209,5102,1826,3276,9.757,27.262,3640,1677,1963,8.961,19.45,1462,7.812,38.899,244,244,950
1992,6211,181693,193911,1517015,1469183,14058,7.268,13101,6.773,270789,80320,190469,5.467,18.431,174892,59288,115604,4.035,11.904,95897,6.527,23.808,9952,10102,39521
1992,6212,101286,104218,564805,554560,5160,4.966,4526,4.356,83837,18800,65037,3.39,15.118,63444,16394,47050,2.956,11.44,20393,3.677,22.881,3241,3296,11702
1992,6213,64761,68581,296438,282939,8313,12.396,5275,7.866,71392,28991,42401,10.246,25.232,44059,16696,27363,5.901,15.572,27333,9.66,31.144,3778,3854,11939
1992,6214,8411,13870,267910,258377,1795,13.321,1005,7.458,52665,15388,37277,5.956,20.383,33701,12231,21470,4.734,13.043,18964,7.34,26.087,476,486,6286
1992,6215,5597,7758,126087,125127,1201,15.827,862,11.359,25286,9476,15810,7.573,20.208,23500,8065,15435,6.445,18.781,1786,1.427,37.562,612,617,4488
1992,6216,5584,9365,517312,484493,1598,17.918,705,7.905,127605,32415,95190,6.691,26.338,61804,16439,45365,3.393,12.756,65801,13.581,25.513,378,388,7203
1992,6219,5721,7348,143298,137101,1126,15.756,723,10.117,34218,11024,23194,8.041,24.958,21944,9642,12302,7.033,16.006,12274,8.953,32.012,476,488,6041
1992,6221,3144,4654,4125312,4038022,156,3.338,195,4.172,378277,104749,273528,2.594,9.368,205942,60315,145627,1.494,5.1,172335,4.268,10.2,105,108,39607
1992,6222,574,983,320648,339000,64,6.547,53,5.422,34415,15405,19010,4.544,10.152,70081,6769,63312,1.997,20.673,-35666,-10.521,20.304,21,21,2733
1992,6223,219,321,120903,117069,37,11.821,21,6.709,16838,6843,9995,5.845,14.383,9483,2333,7150,1.993,8.1,7355,6.283,16.201,16,16,1996
1992,6231,8160,14281,1343058,1312226,1097,7.804,650,4.624,165348,66687,98661,5.082,12.601,104385,38190,66195,2.91,7.955,60963,4.646,15.91,397,413,23854
1992,6232,6452,13143,277217,268699,1658,13.113,659,5.212,51532,19509,32023,7.261,19.178,34575,10924,23651,4.066,12.868,16957,6.311,25.735,450,472,7742
1992,6233,10140,12251,308774,303935,1664,13.834,1219,10.134,46838,17534,29304,5.769,15.411,37156,15868,21288,5.221,12.225,9682,3.186,24.45,794,811,9843
1992,6239,3961,5409,133881,130156,613,11.646,322,6.118,22892,8423,14469,6.471,17.588,15339,4886,10453,3.754,11.785,7553,5.803,23.57,193,194,2678
1992,6241,20856,28442,421106,407871,3180,11.451,1837,6.615,75992,19716,56276,4.834,18.631,49891,12249,37642,3.003,12.232,26101,6.399,24.464,1093,1105,5710
1992,6242,5692,6773,73697,71288,646,9.69,433,6.495,13863,3489,10374,4.894,19.447,9103,2718,6385,3.813,12.769,4760,6.677,25.539,259,259,1561
1992,6243,5222,8195,297777,293999,817,10.172,491,6.113,48482,8351,40131,2.84,16.491,40607,5572,35035,1.895,13.812,7875,2.679,27.624,207,220,2465
1992,6244,38595,47177,464427,453799,6019,13.041,3972,8.606,87634,34636,52998,7.632,19.311,66169,22664,43505,4.994,14.581,21465,4.73,29.162,2933,3003,16466
1992,7111,6242,6312,93745,92717,1125,18.197,866,14.007,23781,6630,17151,7.151,25.649,21578,5653,15925,6.097,23.273,2203,2.376,46.546,599,600,3727
1992,7112,2641,2762,82085,78328,503,18.338,465,16.952,20848,5192,15656,6.629,26.616,13576,4313,9263,5.506,17.332,7272,9.284,34.664,334,336,2744
1992,7113,2608,2716,48131,46993,471,17.68,367,13.776,12927,4956,7971,10.546,27.509,10451,2592,7859,5.516,22.24,2476,5.269,44.479,270,271,1984
1992,7114,1467,1492,12845,12936,248,16.814,214,14.508,3555,1325,2230,10.243,27.481,3760,1487,2273,11.495,29.066,-205,-1.585,54.963,151,151,1038
1992,7115,6753,6799,39675,45554,1307,18.836,1587,22.871,14218,4665,9553,10.241,31.212,25484,18722,6762,41.099,55.943,-11266,-24.731,62.423,1161,1161,14437
1992,7121,3016,3312,69564,67014,251,7.664,177,5.405,11033,1448,9585,2.161,16.464,6034,1140,4894,1.701,9.004,4999,7.46,18.008,108,108,480
1992,7131,1609,2525,92571,85411,334,13.408,266,10.678,20990,3442,17548,4.03,24.575,6661,1768,4893,2.07,7.799,14329,16.777,15.598,182,187,979
1992,7132,921,1044,41727,35947,219,21.988,123,12.349,15684,6227,9457,17.323,43.631,3948,1746,2202,4.857,10.983,11736,32.648,21.966,92,92,1024
1992,7139,39129,42255,678091,665648,5295,12.638,4577,10.925,129383,47756,81627,7.174,19.437,104887,37697,67190,5.663,15.757,24496,3.68,31.514,3382,3424,27530
1992,7211,29519,36323,1429416,1437357,4031,11.099,4025,11.082,211565,93905,117660,6.533,14.719,227541,100999,126542,7.027,15.831,-15976,-1.111,29.438,2491,2546,58180
1992,7212,4337,4653,30102,29469,529,11.489,432,9.382,6977,2032,4945,6.895,23.676,5737,1821,3916,6.179,19.468,1240,4.208,38.936,229,230,914
1992,7213,3225,3316,15658,15989,285,8.513,349,10.424,2501,891,1610,5.573,15.642,3141,1623,1518,10.151,19.645,-640,-4.003,31.285,253,253,1170
1992,7223,17436,32688,559718,561242,6484,19.965,6063,18.668,150222,62536,87686,11.142,26.766,153345,88357,64988,15.743,27.322,-3123,-0.556,53.532,2434,2459,23998
1992,7224,48845,49391,307533,307155,6987,13.986,8116,16.246,82486,43598,38888,14.194,26.855,81648,41971,39677,13.664,26.582,838,0.273,53.164,6336,6352,32554
1992,7225,228178,311397,5813972,5731352,44837,14.54,38803,12.583,1174120,599665,574455,10.463,20.486,1013092,411743,601349,7.184,17.676,161028,2.81,35.353,27463,28324,270199
1992,8111,122063,132359,664053,668131,16903,12.821,15866,12.034,131490,59449,72041,8.898,19.68,139726,55284,84442,8.274,20.913,-8236,-1.233,39.361,11654,11753,41264
1992,8112,12644,15571,139329,139946,2275,14.78,1918,12.461,28636,13663,14973,9.763,20.462,29842,10651,19191,7.611,21.324,-1206,-0.862,40.924,1210,1224,4166
1992,8113,20911,22183,164105,166866,2469,11.127,2482,11.185,28286,9641,18645,5.778,16.951,33633,11476,22157,6.877,20.156,-5347,-3.204,33.903,1809,1815,7452
1992,8114,27085,28936,175656,176170,4213,14.574,4157,14.38,31502,12247,19255,6.952,17.882,32459,12159,20300,6.902,18.425,-957,-0.543,35.763,3121,3128,8538
1992,8121,75614,87411,460574,461806,11505,13.146,11713,13.384,94114,46444,47670,10.057,20.38,96955,41117,55838,8.904,20.995,-2841,-0.615,40.759,9042,9177,31137
1992,8122,16509,20303,129450,128764,1160,5.654,1589,7.745,21710,5093,16617,3.955,16.86,20320,7222,13098,5.609,15.781,1390,1.079,31.562,1039,1056,5123
1992,8123,34167,41158,372350,376792,4971,12.055,5125,12.429,62171,23101,39070,6.131,16.5,70531,28075,42456,7.451,18.719,-8360,-2.219,33,3469,3648,17635
1992,8129,13816,22953,160050,162005,3543,15.332,3855,16.682,35169,15900,19269,9.815,21.709,38926,17895,21031,11.046,24.028,-3757,-2.319,43.417,1759,1800,9404
1992,8131,137836,137931,1198331,1176500,7320,5.372,4000,2.935,147774,20682,127092,1.758,12.56,104302,12613,91689,1.072,8.865,43472,3.695,17.731,2300,2300,6978
1992,8132,10377,12144,149550,145340,1117,9.35,721,6.035,27483,7156,20327,4.924,18.91,19039,5240,13799,3.605,13.1,8444,5.81,26.199,424,427,3434
1992,8133,9514,11197,121355,121838,1100,9.981,748,6.787,21928,5078,16850,4.168,17.998,23573,3667,19906,3.01,19.348,-1645,-1.35,35.995,414,417,1954
1992,8134,31609,33386,312897,313140,2183,6.584,1726,5.205,44997,8906,36091,2.844,14.37,44623,7234,37389,2.31,14.25,374,0.119,28.5,1197,1199,4819
1992,8139,62795,65008,533413,531986,4072,6.276,3812,5.876,84106,17598,66508,3.308,15.81,81010,26427,54583,4.968,15.228,3096,0.582,30.456,2619,2631,21284
1993,1131,232,250,2076,2737,34,13.127,52,20.077,301,99,202,3.618,10.999,1651,944,707,34.497,60.333,-1350,-49.333,21.999,33,33,304
1993,1132,107,122,1366,1493,14,11.429,15,12.245,402,101,301,6.767,26.935,667,234,433,15.678,44.69,-265,-17.755,53.869,13,13,145
1993,1133,11463,11547,83582,83300,1757,15.371,1524,13.333,19118,6827,12291,8.196,22.951,18694,5765,12929,6.921,22.442,424,0.509,44.884,1118,1118,4137
1993,1141,1158,1169,10188,10100,160,13.669,163,13.926,2945,1233,1712,12.208,29.158,2760,1314,1446,13.01,27.327,185,1.832,54.653,115,116,1150
1993,1142,190,196,1592,1658,28,14.433,24,12.371,295,51,244,3.076,17.793,439,277,162,16.707,26.478,-144,-8.685,35.585,20,20,105
1993,1151,4322,4611,62231,63703,542,11.695,589,12.709,16772,5040,11732,7.912,26.329,19482,5391,14091,8.463,30.583,-2710,-4.254,52.657,387,388,3534
1993,1152,2306,2340,15321,15181,367,15.816,328,14.135,2925,1012,1913,6.666,19.268,2628,941,1687,6.199,17.312,297,1.956,34.623,243,243,726
1993,1153,985,1004,11218,11537,132,13.253,116,11.647,2896,657,2239,5.695,25.102,3471,776,2695,6.726,30.086,-575,-4.984,50.204,75,75,491
1993,2111,6879,8065,99342,108896,759,9.335,891,10.958,15853,6339,9514,5.821,14.558,35115,6158,28957,5.655,32.246,-19262,-17.688,29.116,565,566,1932
1993,2121,1433,1943,105469,110524,263,12.949,439,21.615,14744,6281,8463,5.683,13.34,24924,11942,12982,10.805,22.551,-10180,-9.211,26.68,309,314,5402
1993,2122,362,530,45063,45845,66,11.924,113,20.416,3512,872,2640,1.902,7.661,5074,1550,3524,3.381,11.068,-1562,-3.407,15.321,53,55,252
1993,2123,3367,4990,95466,96662,302,6,388,7.709,11406,2590,8816,2.679,11.8,13959,3205,10754,3.316,14.441,-2553,-2.641,23.6,221,230,1476
1993,2131,7422,8392,133562,136743,1178,13.86,1393,16.389,34774,11578,23196,8.467,25.43,40856,15210,25646,11.123,29.878,-6082,-4.448,50.861,934,937,6341
1993,2211,1514,6940,619643,626204,337,4.893,233,3.383,47669,13160,34509,2.102,7.612,60990,7939,53051,1.268,9.74,-13321,-2.127,15.225,48,52,713
1993,2212,605,2766,109151,108873,209,7.622,161,5.872,9042,3538,5504,3.25,8.305,8414,1602,6812,1.471,7.728,628,0.577,15.457,36,36,117
1993,2213,3962,4345,31835,31459,335,7.836,195,4.561,3738,1233,2505,3.919,11.882,2953,876,2077,2.785,9.387,785,2.495,18.774,137,137,515
1993,2361,113263,113671,577096,562802,22387,19.873,20349,18.064,189382,72661,116721,12.911,33.65,160618,67890,92728,12.063,28.539,28764,5.111,57.078,14361,14364,49938
1993,2362,35170,35800,573069,575960,4693,13.152,4457,12.491,126966,29683,97283,5.154,22.044,132573,30641,101932,5.32,23.018,-5607,-0.974,44.089,3319,3319,21128
1993,2371,14023,14324,309132,311855,1308,9.134,1300,9.078,62535,9510,53025,3.049,20.053,68340,10394,57946,3.333,21.914,-5805,-1.861,40.105,962,963,7210
1993,2372,6811,7008,54223,55613,1591,22.821,1518,21.774,13983,6176,7807,11.105,25.144,16634,7588,9046,13.644,29.911,-2651,-4.767,50.287,1215,1215,4623
1993,2373,9481,9882,222608,224770,977,9.922,907,9.211,45404,7326,38078,3.259,20.2,50215,8768,41447,3.901,22.341,-4811,-2.14,40.4,652,653,5432
1993,2379,4819,4893,70241,71806,688,13.971,751,15.25,16618,4297,12321,5.984,23.143,20129,4332,15797,6.033,28.032,-3511,-4.89,46.286,577,579,3338
1993,2381,77493,77914,663669,653703,12184,15.84,10196,13.255,192835,55442,137393,8.481,29.499,173340,54419,118921,8.325,26.517,19495,2.982,53.033,7650,7654,43507
1993,2382,120881,122837,1169031,1160267,14594,11.958,13012,10.662,241255,55402,185853,4.775,20.793,223484,57820,165664,4.983,19.261,17771,1.532,38.523,9804,9811,45350
1993,2383,81395,81842,587201,582490,14857,18.378,12854,15.9,169001,53051,115950,9.108,29.014,159584,54004,105580,9.271,27.397,9417,1.617,54.794,9425,9429,41777
1993,2389,40472,40693,329395,326477,5621,13.88,5230,12.914,85805,22939,62866,7.026,26.282,79771,25581,54190,7.835,24.434,6034,1.848,48.868,3910,3914,19422
1993,3111,1164,1775,48027,48354,92,5.201,80,4.522,4216,915,3301,1.892,8.719,4854,1026,3828,2.122,10.038,-638,-1.319,17.438,45,45,299
1993,3112,463,809,64311,64516,45,5.573,42,5.201,3727,868,2859,1.345,5.777,4021,1135,2886,1.759,6.233,-294,-0.456,11.554,21,22,212
1993,3113,1509,1721,85284,85078,180,10.551,150,8.792,9384,1125,8259,1.322,11.03,8700,1567,7133,1.842,10.226,684,0.804,20.452,107,110,713
1993,3114,1252,1702,178006,176182,145,8.603,112,6.645,20398,3439,16959,1.952,11.578,16964,4759,12205,2.701,9.629,3434,1.949,19.257,80,80,1645
1993,3115,1269,1844,132152,132999,66,3.535,112,5.999,10427,1293,9134,0.972,7.84,11895,2247,9648,1.689,8.944,-1468,-1.104,15.68,76,78,1176
1993,3116,3502,4098,408429,400912,253,6.127,316,7.652,40935,8927,32008,2.227,10.21,25847,9360,16487,2.335,6.447,15088,3.763,12.894,235,238,3368
1993,3117,643,758,45852,46957,59,7.647,86,11.147,7788,1933,5855,4.117,16.585,10043,2550,7493,5.431,21.388,-2255,-4.802,33.171,66,66,2114
1993,3118,9208,10291,304541,303861,1177,11.458,1139,11.088,34138,9935,24203,3.27,11.235,32491,10846,21645,3.569,10.693,1647,0.542,21.385,812,846,5641
1993,3119,2173,2555,131890,132046,236,9.299,202,7.959,15257,4813,10444,3.645,11.554,15679,4330,11349,3.279,11.874,-422,-0.32,23.109,160,160,2163
1993,3121,1669,2102,132297,132754,146,6.952,142,6.762,12419,1478,10941,1.113,9.355,13203,2551,10652,1.922,9.946,-784,-0.591,18.71,101,101,987
1993,3122,69,103,35372,36195,6,5.634,13,12.207,1460,342,1118,0.945,4.034,3043,286,2757,0.79,8.407,-1583,-4.374,8.067,6,6,105
1993,3131,341,585,92492,95244,32,5.461,34,5.802,7332,1058,6274,1.111,7.698,12596,6493,6103,6.817,13.225,-5264,-5.527,15.396,15,15,192
1993,3132,1614,1957,239620,241071,170,8.685,171,8.736,16809,2955,13854,1.226,6.973,19544,4833,14711,2.005,8.107,-2735,-1.135,13.945,135,138,1507
1993,3133,2087,2296,103835,103367,292,13.153,140,6.306,12025,3360,8665,3.251,11.633,11013,2413,8600,2.334,10.654,1012,0.979,21.309,98,100,1159
1993,3141,2920,3213,121778,121004,286,8.781,374,11.483,13363,3371,9992,2.786,11.043,11850,3802,8048,3.142,9.793,1513,1.25,19.586,295,296,1923
1993,3149,3946,4075,114978,115083,510,12.603,453,11.195,19120,5800,13320,5.04,16.614,19523,6866,12657,5.966,16.964,-403,-0.35,33.228,369,369,4858
1993,3151,1115,1247,119632,119028,133,10.691,127,10.209,13882,3679,10203,3.091,11.663,12692,3123,9569,2.624,10.663,1190,1,21.326,99,99,1736
1993,3152,11023,12134,666958,677217,2200,18.034,2330,19.1,104818,39381,65437,5.815,15.478,124749,57260,67489,8.455,18.421,-19931,-2.943,30.956,1964,1979,42142
1993,3159,1798,1895,61958,62197,257,13.623,240,12.722,8621,2051,6570,3.298,13.861,9086,3094,5992,4.975,14.609,-465,-0.748,27.722,207,208,1989
1993,3161,315,349,17466,17331,37,10.787,25,7.289,2439,498,1941,2.873,14.073,2200,400,1800,2.308,12.694,239,1.379,25.388,19,19,139
1993,3162,334,425,62628,62458,34,7.991,35,8.226,7689,3354,4335,5.37,12.311,7626,2103,5523,3.367,12.21,63,0.101,24.42,20,20,296
1993,3169,1051,1093,32217,31667,117,10.729,112,10.271,5483,1297,4186,4.096,17.315,4441,1391,3050,4.393,14.024,1042,3.29,28.048,89,89,740
1993,3211,4332,4827,129079,127690,454,9.396,464,9.603,15612,3898,11714,3.053,12.227,12837,3990,8847,3.125,10.053,2775,2.173,20.107,351,351,2107
1993,3212,1305,1604,96061,93998,121,7.591,101,6.336,10734,1877,8857,1.997,11.419,6625,2120,4505,2.255,7.048,4109,4.371,14.096,69,69,820
1993,3219,9124,9809,269972,262834,1087,11.133,996,10.201,46285,11770,34515,4.478,17.61,31955,11034,20921,4.198,12.158,14330,5.452,24.316,783,791,7952
1993,3221,215,521,185647,187661,21,4.05,16,3.086,7249,3377,3872,1.8,3.863,11123,4547,6576,2.423,5.927,-3874,-2.064,7.726,3,3,18
1993,3222,3521,5148,398263,395951,264,5.14,241,4.692,30827,4597,26230,1.161,7.786,26285,5995,20290,1.514,6.638,4542,1.147,13.277,163,167,2618
1993,3231,41651,43652,814456,814764,3537,8.062,3974,9.058,93382,23224,70158,2.85,11.461,94151,28510,65641,3.499,11.556,-769,-0.094,22.922,3288,3299,19047
1993,3241,1130,2080,129295,132488,154,7.478,113,5.487,8885,2265,6620,1.71,6.706,15199,2301,12898,1.737,11.472,-6314,-4.766,13.413,59,60,633
1993,3251,1148,2339,217724,219562,178,7.707,119,5.153,11964,3814,8150,1.737,5.449,15452,3280,12172,1.494,7.038,-3488,-1.589,10.898,45,47,399
1993,3252,357,646,132625,132552,54,8.551,25,3.959,8757,2373,6384,1.79,6.606,8342,1127,7215,0.85,6.293,415,0.313,12.587,7,8,272
1993,3253,642,863,40027,40870,63,7.338,54,6.29,2643,390,2253,0.954,6.467,4315,897,3418,2.195,10.558,-1672,-4.091,12.934,27,29,214
1993,3254,1130,1431,190178,191281,120,8.55,65,4.631,16887,2777,14110,1.452,8.828,19242,2298,16944,1.201,10.06,-2355,-1.231,17.657,45,45,539
1993,3255,1572,2025,71436,72032,103,5.043,138,6.756,6123,1309,4814,1.817,8.5,7243,1641,5602,2.278,10.055,-1120,-1.555,17.001,81,81,454
1993,3256,2049,2287,121440,119620,196,8.636,161,7.094,13835,1970,11865,1.647,11.566,10271,3457,6814,2.89,8.586,3564,2.979,17.173,117,117,1064
1993,3259,2248,2928,129550,129832,194,6.644,178,6.096,10597,2205,8392,1.698,8.162,10995,2187,8808,1.684,8.469,-398,-0.307,16.324,127,130,1400
1993,3261,10196,12284,694053,681171,876,7.155,794,6.485,88241,16771,71470,2.462,12.954,62497,17538,44959,2.575,9.175,25744,3.779,18.35,562,567,6934
1993,3262,2212,2719,190237,187593,191,7.041,178,6.562,16759,3401,13358,1.813,8.934,11426,2222,9204,1.184,6.091,5333,2.843,12.182,130,130,1133
1993,3271,1468,1750,75843,74824,167,9.636,133,7.675,9281,1851,7430,2.474,12.404,7306,1607,5699,2.148,9.764,1975,2.64,19.528,97,98,458
1993,3272,1720,1976,132223,132195,204,10.398,176,8.97,9829,1908,7921,1.443,7.435,9636,2692,6944,2.036,7.289,193,0.146,14.578,127,127,551
1993,3273,5945,8715,163900,163652,492,5.609,604,6.886,22841,5424,17417,3.314,13.957,22493,5975,16518,3.651,13.744,348,0.213,27.489,349,356,2939
1993,3274,248,350,16859,16851,24,6.828,27,7.681,1050,221,829,1.312,6.231,1018,435,583,2.582,6.041,32,0.19,12.083,20,20,188
1993,3279,1914,2201,67146,67147,173,7.826,192,8.686,6469,1659,4810,2.471,9.634,6468,1912,4556,2.847,9.633,1,0.001,19.265,139,140,1195
1993,3311,229,289,143600,145622,25,8.696,22,7.652,4764,2053,2711,1.41,3.271,8970,761,8209,0.523,6.16,-4206,-2.888,6.543,18,18,357
1993,3312,520,719,64984,64726,47,6.551,44,6.132,5067,747,4320,1.154,7.828,4668,653,4015,1.009,7.212,399,0.616,14.424,31,31,394
1993,3313,392,549,88043,88214,21,3.794,30,5.42,4799,263,4536,0.298,5.44,5125,1527,3598,1.731,5.81,-326,-0.37,10.88,14,14,336
1993,3314,777,933,76561,76814,59,6.277,73,7.766,5647,946,4701,1.232,7.352,6113,1770,4343,2.304,7.958,-466,-0.607,14.703,52,52,936
1993,3315,2379,2637,192498,191634,131,4.946,154,5.815,17915,3170,14745,1.654,9.349,16339,2668,13671,1.392,8.526,1576,0.822,17.052,109,109,1346
1993,3321,3118,3318,129196,128094,168,5.037,202,6.057,14515,3335,11180,2.604,11.332,12325,3993,8332,3.117,9.622,2190,1.71,19.244,151,151,1252
1993,3322,1329,1461,73735,73910,85,5.836,76,5.218,4786,485,4301,0.656,6.475,5205,698,4507,0.944,7.042,-419,-0.567,12.951,62,62,473
1993,3323,10323,11066,311676,310931,792,7.142,840,7.574,44187,8800,35387,2.83,14.211,42781,12763,30018,4.105,13.759,1406,0.452,27.518,657,662,6295
1993,3324,1527,1852,104883,107086,102,5.477,123,6.604,8991,1680,7311,1.569,8.396,13495,3322,10173,3.102,12.602,-4504,-4.206,16.792,80,81,967
1993,3325,886,973,65714,65249,58,5.918,72,7.347,5416,1056,4360,1.618,8.301,4536,862,3674,1.321,6.952,880,1.349,13.904,54,54,563
1993,3326,1527,1704,64687,63420,98,5.787,77,4.547,7196,1164,6032,1.835,11.347,4727,1255,3472,1.979,7.453,2469,3.893,14.907,51,56,886
1993,3327,22236,22562,332541,329048,2088,9.346,1645,7.363,46406,11279,35127,3.428,14.103,39419,10215,29204,3.104,11.98,6987,2.123,23.959,1225,1229,6659
1993,3328,5326,5726,130497,128996,365,6.378,358,6.256,17279,3081,14198,2.388,13.395,14358,3649,10709,2.829,11.131,2921,2.264,22.261,271,273,2195
1993,3329,5754,6248,310301,313026,505,8.072,522,8.343,28158,4675,23483,1.493,8.995,33900,9588,24312,3.063,10.83,-5742,-1.834,17.991,388,389,3451
1993,3331,2731,2973,186939,188656,195,6.529,222,7.433,17126,3262,13864,1.729,9.078,20744,5753,14991,3.049,10.996,-3618,-1.918,18.156,154,154,1239
1993,3332,4041,4283,151010,152455,302,7.059,293,6.848,16295,3330,12965,2.184,10.688,19027,4476,14551,2.936,12.48,-2732,-1.792,21.377,213,216,1604
1993,3333,2428,2551,138478,140222,196,7.679,199,7.796,11658,1459,10199,1.04,8.314,15193,3593,11600,2.562,10.835,-3535,-2.521,16.628,147,148,1406
1993,3334,1547,1789,147568,147643,124,6.937,121,6.769,14660,1466,13194,0.993,9.929,14796,4177,10619,2.829,10.021,-136,-0.092,19.859,81,82,863
1993,3335,9324,9650,206447,205400,609,6.325,565,5.868,25635,5756,19879,2.802,12.481,23477,8621,14856,4.197,11.43,2158,1.051,22.86,426,426,2925
1993,3336,762,915,114617,117054,50,5.473,47,5.145,9445,2151,7294,1.838,8.069,13922,3101,10821,2.649,11.894,-4477,-3.825,16.138,31,32,743
1993,3339,5451,6053,298949,298393,437,7.262,367,6.098,29592,6312,23280,2.115,9.917,28626,7813,20813,2.618,9.593,966,0.324,19.187,255,256,2672
1993,3341,1686,1783,189468,193298,246,13.863,229,12.905,18530,3184,15346,1.647,9.586,25842,6317,19525,3.268,13.369,-7312,-3.783,19.172,173,174,2359
1993,3342,1773,1965,218425,218852,167,8.529,153,7.814,22928,6512,16416,2.976,10.477,24239,6792,17447,3.103,11.076,-1311,-0.599,20.953,100,100,1609
1993,3343,405,440,34092,33023,53,12.34,32,7.451,3824,1257,2567,3.806,11.58,1703,475,1228,1.438,5.157,2121,6.423,10.314,21,21,231
1993,3344,5008,5556,475634,476397,547,9.892,494,8.934,50268,9986,40282,2.096,10.552,51161,14880,36281,3.123,10.739,-893,-0.187,21.103,368,369,4997
1993,3345,4563,5174,541457,559530,343,6.629,344,6.648,31247,9046,22201,1.617,5.585,67048,6007,61041,1.074,11.983,-35801,-6.398,11.169,231,234,2012
1993,3346,739,790,46027,43847,124,16.188,76,9.922,9284,1827,7457,4.167,21.174,5034,1256,3778,2.865,11.481,4250,9.693,22.962,56,56,417
1993,3351,1101,1212,69835,70531,72,5.847,111,9.013,6895,678,6217,0.961,9.776,8158,2115,6043,2.999,11.567,-1263,-1.791,19.552,85,86,1692
1993,3352,332,405,100703,100140,26,6.349,35,8.547,9357,1550,7807,1.548,9.344,7888,1359,6529,1.357,7.877,1469,1.467,15.754,22,22,338
1993,3353,2190,2609,199739,201549,159,6.077,174,6.65,16517,3030,13487,1.503,8.195,20132,5223,14909,2.591,9.989,-3615,-1.794,16.39,106,107,1247
1993,3359,1815,2174,179816,178264,134,6.157,139,6.386,18080,3345,14735,1.876,10.142,14784,3540,11244,1.986,8.293,3296,1.849,16.587,99,99,759
1993,3361,267,321,209402,206771,45,14.4,28,8.96,30122,11811,18311,5.712,14.568,25814,18182,7632,8.793,12.484,4308,2.083,24.969,24,24,392
1993,3362,1692,1848,110615,105042,169,9.062,203,10.885,19657,2708,16949,2.578,18.714,8578,3969,4609,3.779,8.166,11079,10.547,16.333,136,140,1932
1993,3363,4266,5160,662467,650105,400,7.8,336,6.552,70332,13354,56978,2.054,10.819,46275,14211,32064,2.186,7.118,24057,3.7,14.236,233,234,4437
1993,3364,1425,1743,591650,627880,106,5.992,158,8.932,21501,8545,12956,1.361,3.424,93596,4636,88960,0.738,14.907,-72095,-11.482,6.849,117,118,1306
1993,3365,171,219,26101,24963,11,5.011,12,5.467,4149,247,3902,0.989,16.621,1865,149,1716,0.597,7.471,2284,9.15,14.942,6,6,107
1993,3366,1340,1442,139887,145282,162,11.356,131,9.183,11944,2939,9005,2.023,8.221,22883,3069,19814,2.112,15.751,-10939,-7.529,16.443,91,91,1420
1993,3369,518,534,32744,31783,72,13.913,39,7.536,4430,467,3963,1.469,13.938,2400,411,1989,1.293,7.551,2030,6.387,15.103,31,31,133
1993,3371,13231,13762,359825,353528,1748,12.758,1627,11.875,52790,13447,39343,3.804,14.932,39946,15725,24221,4.448,11.299,12844,3.633,22.598,1232,1245,10364
1993,3372,3178,3366,146674,145790,353,10.621,268,8.064,18047,3368,14679,2.31,12.379,16319,4687,11632,3.215,11.194,1728,1.185,22.387,200,202,2629
1993,3379,1080,1216,38872,38951,98,8.069,95,7.822,4905,714,4191,1.833,12.593,5129,1399,3730,3.592,13.168,-224,-0.575,25.185,75,75,571
1993,3391,10681,11259,277533,271815,968,8.653,825,7.374,36195,9976,26219,3.67,13.316,24597,6020,18577,2.215,9.049,11598,4.267,18.098,627,628,3246
1993,3399,15510,16030,398972,393931,1937,12.228,1558,9.836,57370,13811,43559,3.506,14.563,47423,11600,35823,2.945,12.038,9947,2.525,24.077,1234,1239,7044
1993,4231,20417,25223,289827,290522,2101,8.225,2741,10.731,39970,10593,29377,3.646,13.758,41655,16005,25650,5.509,14.338,-1685,-0.58,27.516,1830,1944,8893
1993,4232,9090,10277,124163,121812,1163,11.31,1174,11.417,23232,6468,16764,5.31,19.072,18599,6059,12540,4.974,15.269,4633,3.803,30.537,844,865,3859
1993,4233,8244,11001,135110,133413,1149,10.498,1036,9.466,20870,6141,14729,4.603,15.643,17612,6911,10701,5.18,13.201,3258,2.442,26.402,741,749,4347
1993,4234,26971,35387,602298,597650,4414,12.575,3842,10.946,103011,30691,72320,5.135,17.236,93478,33449,60029,5.597,15.641,9533,1.595,31.282,2345,2418,15480
1993,4235,6876,9254,128985,128776,736,7.936,777,8.378,16767,4087,12680,3.174,13.02,16308,5171,11137,4.015,12.664,459,0.356,25.328,492,501,2671
1993,4236,18184,27057,341057,338538,3053,11.414,2434,9.1,60288,17156,43132,5.068,17.808,55349,17256,38093,5.097,16.349,4939,1.459,32.699,1474,1553,8736
1993,4237,11402,16166,178908,177304,1176,7.279,1158,7.167,24426,6440,17986,3.632,13.776,21064,6225,14839,3.511,11.88,3362,1.896,23.76,751,771,3651
1993,4238,47515,61454,643561,639843,4926,7.996,5232,8.493,90666,22698,67968,3.547,14.17,83291,29002,54289,4.533,13.017,7375,1.153,26.035,3372,3469,15788
1993,4239,25796,27835,283383,278500,3752,13.62,3179,11.54,53235,16160,37075,5.803,19.115,43520,16035,27485,5.758,15.627,9715,3.488,31.253,2451,2468,10869
1993,4241,9827,12686,190437,190298,1037,8.156,1095,8.612,23258,5680,17578,2.985,12.222,22742,7898,14844,4.15,11.951,516,0.271,23.901,709,739,4187
1993,4242,3636,4809,146163,140708,709,15.058,508,10.789,29519,12008,17511,8.534,20.979,18788,4698,14090,3.339,13.352,10731,7.626,26.705,339,341,2232
1993,4243,12994,14037,165927,166357,2241,16.192,1847,13.345,32887,12029,20858,7.231,19.769,33797,11054,22743,6.645,20.316,-910,-0.547,39.538,1452,1468,8377
1993,4244,27743,33799,702843,698574,3568,10.554,3584,10.601,103435,28939,74496,4.143,14.807,94728,32426,62302,4.642,13.56,8707,1.246,27.12,2704,2745,18129
1993,4245,6270,9070,80527,81087,495,5.402,683,7.453,11488,2643,8845,3.259,14.168,12642,3754,8888,4.63,15.591,-1154,-1.423,28.335,443,456,2649
1993,4246,8647,12434,142734,141126,1220,9.82,1198,9.643,24178,7755,16423,5.495,17.132,20882,8706,12176,6.169,14.797,3296,2.336,29.594,574,582,2976
1993,4247,8524,11610,128680,130308,729,6.24,874,7.481,19657,4979,14678,3.821,15.085,22731,6174,16557,4.738,17.444,-3074,-2.359,30.17,532,542,3759
1993,4248,3424,4412,136151,134686,233,5.26,269,6.072,12973,2949,10024,2.19,9.632,10169,3019,7150,2.242,7.55,2804,2.082,15.1,183,187,1606
1993,4249,22292,26967,322171,319983,3257,12.12,3068,11.417,54498,17067,37431,5.334,17.032,50022,18601,31421,5.813,15.633,4476,1.399,31.265,2104,2149,10699
1993,4251,32425,34737,305418,303342,3671,10.658,3085,8.957,51448,15502,35946,5.11,16.96,47305,14926,32379,4.921,15.595,4143,1.366,31.189,2103,2113,9283
1993,4411,37912,40191,943348,926526,4312,10.825,3598,9.032,126423,39031,87392,4.213,13.645,92731,35306,57425,3.811,10.008,33692,3.636,20.017,2907,2925,29470
1993,4412,10369,11046,77042,76306,1029,9.342,966,8.77,13954,4420,9534,5.792,18.287,12429,4670,7759,6.12,16.288,1525,1.999,32.577,744,755,3476
1993,4413,40698,63410,475271,475262,4066,6.383,4637,7.28,67864,21507,46357,4.525,14.279,68164,22212,45952,4.674,14.342,-300,-0.063,28.559,2776,3029,13243
1993,4421,21197,27540,236992,232615,2621,9.466,2916,10.532,44165,13670,30495,5.877,18.986,35296,14396,20900,6.189,15.174,8869,3.813,30.347,1882,2023,9219
1993,4422,23381,30860,200935,195395,3139,10.194,3007,9.765,43251,14336,28915,7.337,22.135,32295,10644,21651,5.447,16.528,10956,5.607,33.056,2011,2101,7103
1993,4431,26060,37226,284369,276251,5149,13.99,4305,11.697,64489,29912,34577,10.828,23.344,48486,19070,29416,6.903,17.551,16003,5.793,35.103,2826,2954,12436
1993,4441,51635,68303,770876,761637,4671,6.819,5069,7.4,115549,39068,76481,5.129,15.171,97554,29481,68073,3.871,12.808,17995,2.363,25.617,3566,3702,17275
1993,4442,16033,19529,149931,149881,1549,7.955,1436,7.375,23604,6520,17084,4.35,15.748,23541,6290,17251,4.197,15.706,63,0.042,31.413,1001,1010,3819
1993,4451,61344,91225,2503939,2463151,9668,10.627,9175,10.085,345457,141473,203984,5.744,14.025,262405,87617,174788,3.557,10.653,83052,3.372,21.306,6006,6168,38899
1993,4452,17565,21278,133298,132608,2741,12.844,2865,13.425,30923,12768,18155,9.628,23.319,29441,12034,17407,9.075,22.202,1482,1.118,44.403,2054,2122,8757
1993,4453,24264,28485,137960,138174,2547,8.89,2880,10.052,25474,11403,14071,8.253,18.436,25865,9075,16790,6.568,18.719,-391,-0.283,36.872,2057,2086,6111
1993,4461,44987,75826,751896,749060,6485,8.553,6483,8.55,106750,44916,61834,5.996,14.251,102572,39696,62876,5.299,13.693,4178,0.558,27.387,3763,3998,20157
1993,4471,74231,124702,881061,886481,9915,7.846,13241,10.478,159790,56725,103065,6.399,18.025,170912,75928,94984,8.565,19.28,-11122,-1.255,36.05,7279,7670,38897
1993,4481,46655,99007,1013600,997553,10497,10.471,12986,12.953,214014,74192,139822,7.437,21.454,181418,71369,110049,7.154,18.186,32596,3.268,36.373,6478,7125,28141
1993,4482,8489,33581,182062,182939,2751,8.093,3576,10.52,35707,13623,22084,7.447,19.519,36513,14720,21793,8.046,19.959,-806,-0.441,39.037,1033,1173,4299
1993,4483,19085,27839,160593,161301,2695,9.617,3066,10.94,29421,10484,18937,6.5,18.24,31223,12158,19065,7.537,19.357,-1802,-1.117,36.48,1595,1711,5210
1993,4511,31789,42816,337527,333729,5152,12.011,5310,12.379,67951,28839,39112,8.641,20.361,60098,25836,34262,7.742,18.008,7853,2.353,36.016,3455,3695,13248
1993,4512,8953,14671,110453,108453,1565,10.757,1321,9.08,24791,9386,15405,8.654,22.859,20804,6010,14794,5.542,19.183,3987,3.676,38.365,839,871,3775
1993,4522,139,6442,1074279,1061726,283,4.422,198,3.094,103617,34868,68749,3.284,9.759,76906,15826,61080,1.491,7.243,26711,2.516,14.487,5,6,366
1993,4523,10681,28410,1116306,1067821,2749,9.735,2405,8.517,190417,93210,97207,8.729,17.832,97667,31512,66155,2.951,9.146,92750,8.686,18.293,1245,1339,6955
1993,4531,23342,24668,121017,122139,2642,10.67,2829,11.425,21739,8041,13698,6.583,17.799,24050,8308,15742,6.802,19.691,-2311,-1.892,35.597,2261,2290,6636
1993,4532,30621,39388,265661,260417,5299,13.53,4853,12.391,62355,29931,32424,11.493,23.944,52089,19823,32266,7.612,20.002,10266,3.942,40.004,3455,3578,13037
1993,4533,11868,14954,86526,82359,2207,15.032,1664,11.333,19435,6678,12757,8.108,23.598,10990,4491,6499,5.453,13.344,8445,10.254,26.688,1315,1328,3413
1993,4539,25366,29255,155540,150901,4731,16.361,4055,14.023,40924,18704,22220,12.395,27.12,31441,13487,17954,8.938,20.836,9483,6.284,41.671,2949,3075,10217
1993,4541,6250,6934,134909,133582,950,13.687,964,13.888,26074,7453,18621,5.579,19.519,23504,9998,13506,7.485,17.595,2570,1.924,35.19,641,650,3834
1993,4542,4374,5292,65743,67591,698,13.149,731,13.77,9161,3171,5990,4.691,13.554,12830,6122,6708,9.057,18.982,-3669,-5.428,27.107,418,422,2242
1993,4543,16811,23129,212502,211602,2067,8.96,1947,8.44,35202,10676,24526,5.045,16.636,33189,10145,23044,4.794,15.685,2013,0.951,31.369,1284,1302,6327
1993,4811,544,2822,438692,439494,296,10.539,269,9.578,38727,6244,32483,1.421,8.812,39487,9116,30371,2.074,8.985,-760,-0.173,17.623,52,55,3541
1993,4812,1188,1361,21165,20226,160,11.662,182,13.265,4853,954,3899,4.717,23.994,2777,1000,1777,4.944,13.73,2076,10.264,27.46,120,122,592
1993,4831,411,725,37497,38491,90,12.685,59,8.316,6014,1529,4485,3.972,15.625,7727,1337,6390,3.474,20.075,-1713,-4.45,31.249,32,32,571
1993,4832,290,320,11102,11723,52,16.378,47,14.803,1309,487,822,4.154,11.167,2544,1334,1210,11.38,21.702,-1235,-10.535,22.333,31,31,484
1993,4841,23753,30363,625746,619844,5082,17.064,3920,13.162,100524,30178,70346,4.869,16.218,89065,32846,56219,5.299,14.369,11459,1.849,28.738,2899,2946,18499
1993,4842,47386,51552,527590,523894,7933,15.485,7291,14.232,110175,35349,74826,6.747,21.03,102727,42478,60249,8.108,19.608,7448,1.422,39.217,5533,5584,31660
1993,4851,411,497,24977,24294,65,13.065,66,13.266,4707,2453,2254,10.097,19.375,3314,873,2441,3.593,13.641,1393,5.734,27.282,53,53,653
1993,4852,298,570,19710,19627,42,7.362,43,7.537,2879,394,2485,2.007,14.669,2686,826,1860,4.208,13.685,193,0.983,27.37,30,31,357
1993,4853,5308,5397,49042,48356,937,17.623,777,14.614,11493,4919,6574,10.173,23.768,10064,4705,5359,9.73,20.813,1429,2.955,41.625,659,660,3823
1993,4854,3247,4152,135006,132281,348,8.44,290,7.034,20742,6228,14514,4.708,15.68,15180,5385,9795,4.071,11.476,5562,4.205,22.951,201,216,3218
1993,4855,1107,1220,25652,25104,124,10.21,113,9.304,4310,814,3496,3.243,17.169,3146,931,2215,3.709,12.532,1164,4.637,25.064,89,89,795
1993,4859,1301,1389,27235,26244,275,21.17,95,7.313,5808,2079,3729,7.922,22.131,3851,1394,2457,5.312,14.674,1957,7.457,29.348,74,74,668
1993,4861,47,390,8642,9001,33,8.483,31,7.969,1128,211,917,2.344,12.532,1895,379,1516,4.211,21.053,-767,-8.521,25.064,0,0,0
1993,4862,152,1306,39927,41162,89,6.823,86,6.593,3055,1477,1578,3.588,7.422,5595,1051,4544,2.553,13.593,-2540,-6.171,14.844,17,19,147
1993,4869,59,363,5775,5953,46,12.399,62,16.712,990,638,352,10.717,16.63,1278,827,451,13.892,21.468,-288,-4.838,33.261,8,11,192
1993,4871,338,374,6869,6619,60,16.438,42,11.507,1310,328,982,4.956,19.793,812,179,633,2.705,12.269,498,7.524,24.537,32,32,151
1993,4872,1128,1160,11349,11349,175,15.304,142,12.418,2625,680,1945,5.992,23.131,2669,788,1881,6.944,23.519,-44,-0.388,46.262,112,112,651
1993,4879,121,129,863,908,17,12.639,28,20.818,193,29,164,3.196,21.267,269,85,184,9.366,29.642,-76,-8.375,42.534,20,20,58
1993,4881,2413,3049,84081,80871,465,15.492,370,12.327,17167,5309,11858,6.565,21.228,11107,3614,7493,4.469,13.734,6060,7.493,27.468,226,228,1100
1993,4882,491,750,17938,17519,101,13.751,70,9.53,3873,1381,2492,7.883,22.108,2999,1722,1277,9.83,17.119,874,4.989,34.238,37,37,783
1993,4883,1975,2536,82597,84213,260,10.299,237,9.388,15169,3092,12077,3.672,18.013,17983,3928,14055,4.664,21.354,-2814,-3.342,36.026,163,164,1470
1993,4884,4224,4396,30335,29170,670,15.427,564,12.986,7760,3635,4125,12.461,26.603,5417,2325,3092,7.971,18.57,2343,8.032,37.141,424,429,1570
1993,4885,8894,11658,109803,108828,1634,14.268,1223,10.679,20672,7097,13575,6.521,18.995,18736,6235,12501,5.729,17.216,1936,1.779,34.432,802,836,3945
1993,4889,796,850,9196,8843,135,16.148,107,12.799,2321,923,1398,10.438,26.247,1627,422,1205,4.772,18.399,694,7.848,36.797,85,86,354
1993,4921,1488,4387,383263,372804,499,11.647,294,6.862,39834,4135,35699,1.109,10.685,17400,2931,14469,0.786,4.667,22434,6.018,9.335,162,163,1258
1993,4922,3704,4039,59041,56413,681,17.33,462,11.757,14583,4323,10260,7.663,25.851,9429,4359,5070,7.727,16.714,5154,9.136,33.429,386,389,3238
1993,4931,6387,10470,430147,439774,845,8.016,989,9.382,66692,15063,51629,3.425,15.165,86571,24074,62497,5.474,19.685,-19879,-4.52,30.33,325,333,3289
1993,5111,14944,17760,686962,688386,1917,10.868,1676,9.501,70592,26788,43804,3.891,10.255,74169,28965,45204,4.208,10.774,-3577,-0.52,20.509,1315,1318,14242
1993,5112,5569,6685,137414,132687,1127,17.422,695,10.744,29985,8511,21474,6.414,22.598,20764,6959,13805,5.245,15.649,9221,6.949,31.298,431,433,4162
1993,5121,9956,14512,213347,211035,2026,14.042,1858,12.878,45608,13696,31912,6.49,21.612,41376,15790,25586,7.482,19.606,4232,2.005,39.212,1134,1168,10843
1993,5122,1607,1649,12376,12615,321,20.037,227,14.17,3250,1548,1702,12.272,25.764,3806,2274,1532,18.027,30.172,-556,-4.408,51.528,173,173,1995
1993,5151,6064,7958,237746,230643,791,10.004,688,8.702,41241,11139,30102,4.83,17.881,27722,10659,17063,4.621,12.019,13519,5.861,24.039,474,499,5571
1993,5152,220,363,15018,14809,56,15.642,46,12.849,2813,853,1960,5.76,18.996,2429,1372,1057,9.265,16.403,384,2.593,32.805,17,17,267
1993,5173,5562,27708,1015944,1023892,3218,11.63,3143,11.359,155375,55976,99399,5.467,15.175,169826,54095,115731,5.283,16.586,-14451,-1.411,30.35,525,548,4874
1993,5174,211,274,6054,5597,63,23.551,50,18.692,1956,456,1500,8.148,34.95,1067,547,520,9.774,19.065,889,15.885,38.131,14,14,55
1993,5179,1272,2015,36301,38066,454,22.66,431,21.512,6385,2555,3830,6.712,16.774,9850,3714,6136,9.757,25.876,-3465,-9.103,33.547,136,136,952
1993,5182,5061,7192,280237,275348,855,11.764,1007,13.855,53506,13524,39982,4.912,19.432,43596,13747,29849,4.993,15.833,9910,3.599,31.666,507,513,5345
1993,5191,2507,2913,33931,33505,321,11.144,256,8.887,4716,1763,2953,5.262,14.076,3866,1383,2483,4.128,11.539,850,2.537,23.077,148,217,1278
1993,5211,16,46,23159,23629,3,6.522,3,6.522,440,20,420,0.085,1.862,1371,70,1301,0.296,5.802,-931,-3.94,3.724,(D),(D),(D)
1993,5221,22245,96302,1911056,1973306,4488,4.546,9343,9.463,285749,77384,208365,3.922,14.481,414459,184025,230434,9.326,21.003,-128710,-6.523,28.961,770,1157,14502
1993,5222,13373,34574,457065,448780,5069,14.867,4112,12.06,115221,37122,78099,8.272,25.674,98303,46067,52236,10.265,21.905,16918,3.77,43.809,1159,1302,9635
1993,5223,7971,10388,91381,84160,2002,19.968,1278,12.747,29168,11889,17279,14.127,34.658,14274,6029,8245,7.164,16.961,14894,17.697,33.921,868,909,3755
1993,5231,6936,19229,330324,325539,3198,16.779,2859,15,65139,24104,41035,7.404,20.01,57131,24432,32699,7.505,17.55,8008,2.46,35.099,637,658,5209
1993,5232,37,51,6437,6458,7,14.583,(D),(D),267,41,226,0.635,4.135,313,(D),312,(D),4.847,-46,-0.712,8.269,(D),(D),(D)
1993,5239,18893,20480,171190,169383,3611,17.921,2950,14.641,43761,19780,23981,11.678,25.836,40031,19495,20536,11.509,23.633,3730,2.202,47.267,2088,2098,8654
1993,5241,3949,36327,1519079,1532853,3180,8.62,4307,11.675,200711,53659,147052,3.501,13.094,228829,76104,152725,4.965,14.928,-28118,-1.834,26.188,177,235,2799
1993,5242,108090,118386,725808,719252,12819,10.934,10517,8.971,141558,54893,86665,7.632,19.681,127786,51004,76782,7.091,17.767,13772,1.915,35.533,7244,7371,29597
1993,5259,633,671,19611,18562,51,7.359,95,13.709,4056,724,3332,3.9,21.851,1985,1318,667,7.101,10.694,2071,11.157,21.388,69,69,364
1993,5311,88946,96467,504385,500265,11313,11.787,10334,10.767,104634,44350,60284,8.865,20.916,96008,40543,55465,8.104,19.191,8626,1.724,38.383,7876,7964,29087
1993,5312,42410,47969,223737,222599,7705,16.243,6637,13.992,53512,23869,29643,10.723,24.04,51741,20954,30787,9.413,23.244,1771,0.796,46.488,4594,4698,13373
1993,5313,30358,33652,373929,367947,4908,15.04,2869,8.792,80350,29131,51219,7.917,21.837,68467,18808,49659,5.112,18.608,11883,3.23,37.216,1977,2010,11563
1993,5321,4785,9433,135527,131926,860,9.025,1053,11.05,27820,5417,22403,4.106,21.088,20508,8178,12330,6.199,15.545,7312,5.543,31.09,575,621,3926
1993,5322,21281,30028,215450,209664,4068,13.566,3985,13.289,55485,21491,33994,10.25,26.464,44526,19464,25062,9.283,21.237,10959,5.227,42.474,2795,2892,12499
1993,5323,3876,5986,38965,39046,544,9.128,491,8.239,7061,2173,4888,5.565,18.084,7159,3489,3670,8.936,18.335,-98,-0.251,36.168,289,303,1520
1993,5324,7224,9707,106206,106387,1073,11.006,1158,11.878,23782,7106,16676,6.679,22.354,23826,9400,14426,8.836,22.396,-44,-0.041,44.709,711,718,3838
1993,5331,1410,1553,18839,19895,275,18.212,189,12.517,4598,1447,3151,7.273,23.112,6649,3867,2782,19.438,33.421,-2051,-10.309,46.224,132,132,1359
1993,5411,143682,150093,1004976,996793,15341,10.368,11075,7.485,139432,46773,92659,4.692,13.988,123060,32530,90530,3.263,12.346,16372,1.642,24.691,8205,8271,24247
1993,5412,77388,81673,768787,758590,9723,12.067,7531,9.346,130600,43988,86612,5.799,17.216,112127,32648,79479,4.304,14.781,18473,2.435,29.562,5448,5501,21761
1993,5413,65723,73985,946926,944138,9635,13.19,7759,10.622,159961,43990,115971,4.659,16.943,154775,38589,116186,4.087,16.393,5186,0.549,32.787,5242,5296,20792
1993,5414,17669,17878,94825,92993,3385,19.344,2627,15.012,24884,11176,13708,12.018,26.759,21334,9988,11346,10.741,22.942,3550,3.818,45.883,2038,2043,8222
1993,5415,29714,33900,475487,462821,7837,24.2,4806,14.84,116734,45012,71722,9.726,25.222,92028,30678,61350,6.628,19.884,24706,5.338,39.768,3160,3194,13901
1993,5416,41380,44027,370978,356510,8818,20.415,7152,16.558,103755,44452,59303,12.469,29.103,74370,30723,43647,8.618,20.861,29385,8.242,41.721,5356,5382,21292
1993,5417,7009,8907,471629,473344,1210,13.768,973,11.071,67447,16975,50472,3.586,14.249,71813,21681,50132,4.58,15.171,-4366,-0.922,28.498,511,519,2709
1993,5418,28276,30869,370718,361363,4729,15.245,5029,16.213,91142,36329,54813,10.053,25.222,71442,24222,47220,6.703,19.77,19700,5.452,39.54,2876,4238,19457
1993,5419,35867,40786,346993,337146,4246,10.571,3010,7.494,68985,18748,50237,5.561,20.461,49246,14004,35242,4.154,14.607,19739,5.855,29.213,2071,2251,9257
1993,5511,28222,51384,3179832,3213262,4463,8.517,6497,12.399,533056,132087,400969,4.111,16.589,600677,158793,441884,4.942,18.694,-67621,-2.104,33.179,854,895,12059
1993,5611,14377,15623,299339,289338,3299,21.963,2095,13.947,77117,36947,40170,12.769,26.653,56935,24469,32466,8.457,19.678,20182,6.975,39.355,1453,1465,14549
1993,5612,552,978,75752,72137,194,20.378,142,14.916,15240,7039,8201,9.758,21.127,7940,2948,4992,4.087,11.007,7300,10.12,22.014,30,30,602
1993,5613,19664,28070,1919963,1799866,4601,16.585,3945,14.22,662873,192373,470500,10.688,36.829,420678,145663,275015,8.093,23.373,242195,13.456,46.745,2459,2586,93611
1993,5614,24343,27781,398067,382112,4301,15.668,3641,13.264,96725,34160,62565,8.94,25.313,64473,21894,42579,5.73,16.873,32252,8.44,33.746,2802,2841,15544
1993,5615,24629,31286,246169,240771,3887,12.492,3548,11.402,51585,18681,32904,7.759,21.425,41143,16167,24976,6.715,17.088,10442,4.337,34.176,2254,2460,10060
1993,5616,13706,17349,555594,544738,2436,14.176,2105,12.25,109645,31363,78282,5.757,20.128,87742,30169,57573,5.538,16.107,21903,4.021,32.214,1432,1457,17708
1993,5617,96510,100847,1190937,1166117,17851,18.023,14250,14.387,287699,83297,204402,7.143,24.672,239280,79450,159830,6.813,20.519,48419,4.152,41.039,10996,11027,54253
1993,5619,16616,18190,269998,258548,3479,19.578,2639,14.851,72294,21777,50517,8.423,27.962,49930,17363,32567,6.716,19.312,22364,8.65,38.623,2154,2160,13253
1993,5621,4481,4938,77379,74385,610,12.979,134,2.851,12713,3556,9157,4.781,17.091,6726,1489,5237,2.002,9.042,5987,8.049,18.084,78,78,734
1993,5622,1651,2491,86278,82029,320,13.067,236,9.637,17346,5471,11875,6.67,21.146,9002,3310,5692,4.035,10.974,8344,10.172,21.948,146,148,1304
1993,5629,4938,5303,65219,63652,727,13.882,595,11.361,17153,5306,11847,8.336,26.948,13889,3962,9927,6.224,21.82,3264,5.128,43.64,437,438,2264
1993,6111,14218,16120,550401,538618,692,4.305,597,3.714,61521,11092,50429,2.059,11.422,38013,6655,31358,1.236,7.058,23508,4.365,14.115,367,382,4636
1993,6112,587,874,73478,72337,46,5.16,81,9.086,9754,2100,7654,2.903,13.484,7350,2003,5347,2.769,10.161,2404,3.323,20.322,23,31,963
1993,6113,2091,2500,1133601,1114091,114,4.592,79,3.182,91808,12343,79465,1.108,8.241,52750,2402,50348,0.216,4.735,39058,3.506,9.47,46,46,1465
1993,6114,3481,3918,48249,47516,729,19.064,541,14.147,10874,3117,7757,6.56,22.885,9327,4194,5133,8.827,19.629,1547,3.256,39.258,371,397,3122
1993,6115,4733,5566,63006,63347,647,11.744,533,9.675,11186,2978,8208,4.701,17.658,11994,4704,7290,7.426,18.934,-808,-1.276,35.317,360,361,2498
1993,6116,15576,16588,130653,124763,3008,18.771,1881,11.738,34788,13368,21420,10.715,27.883,22959,8889,14070,7.125,18.402,11829,9.481,36.804,1415,1479,7397
1993,6117,2481,2568,20731,20110,490,19.639,344,13.788,4998,1778,3220,8.842,24.854,3832,1973,1859,9.811,19.056,1166,5.798,38.111,265,269,1783
1993,6211,180932,193541,1558788,1537296,13069,6.747,13386,6.911,253575,77307,176268,5.029,16.495,211660,61114,150546,3.975,13.768,41915,2.727,27.537,10732,10933,45683
1993,6212,102210,105144,576680,570609,4876,4.658,3953,3.776,78265,18489,59776,3.24,13.716,66099,13585,52514,2.381,11.584,12166,2.132,23.168,3126,3171,10679
1993,6213,67488,71247,311775,304168,8107,11.596,5433,7.771,67140,25327,41813,8.327,22.073,52499,20625,31874,6.781,17.26,14641,4.813,34.52,4001,4099,12510
1993,6214,8650,14316,294757,282650,1635,11.595,1206,8.552,60855,19623,41232,6.943,21.53,36560,13120,23440,4.642,12.935,24295,8.595,25.869,599,633,6401
1993,6215,5497,7773,133401,130194,1073,13.819,1056,13.6,28641,9752,18889,7.49,21.999,22278,9488,12790,7.288,17.111,6363,4.887,34.223,701,715,4724
1993,6216,6125,10604,596222,558267,2214,22.173,976,9.775,162296,56407,105889,10.104,29.071,87480,34263,53217,6.137,15.67,74816,13.401,31.34,499,515,12517
1993,6219,5717,7368,158085,151532,835,11.359,801,10.896,38636,15022,23614,9.913,25.497,25618,9893,15725,6.529,16.906,13018,8.591,33.812,537,556,5571
1993,6221,3093,4645,4178223,4154340,116,2.492,135,2.9,248785,36222,212563,0.872,5.989,202532,61110,141422,1.471,4.875,46253,1.113,9.75,57,57,19349
1993,6222,584,961,307271,313805,50,5.149,70,7.209,17242,2689,14553,0.857,5.494,30233,14909,15324,4.751,9.634,-12991,-4.14,10.989,20,21,3665
1993,6223,224,340,125857,123946,22,6.587,10,2.994,9560,991,8569,0.8,7.713,5884,930,4954,0.75,4.747,3676,2.966,9.494,4,4,396
1993,6231,8257,14360,1385503,1364267,780,5.447,701,4.895,150638,45774,104864,3.355,11.042,108622,42824,65798,3.139,7.962,42016,3.08,15.924,371,390,20490
1993,6232,6858,14282,297113,287086,1582,11.537,442,3.223,57434,19669,37765,6.851,20.006,37304,7418,29886,2.584,12.994,20130,7.012,25.988,181,183,2458
1993,6233,10355,12370,316565,312183,1552,12.614,1419,11.533,46572,14837,31735,4.753,14.918,37710,18528,19182,5.935,12.079,8862,2.839,24.159,835,848,10543
1993,6239,3998,5561,140096,136435,536,9.782,373,6.807,22355,6626,15729,4.857,16.385,15088,4750,10338,3.482,11.059,7267,5.326,22.118,209,213,2321
1993,6241,22114,30032,453673,436626,3466,11.852,1890,6.463,86637,25577,61060,5.858,19.842,52575,11863,40712,2.717,12.041,34062,7.801,24.082,1033,1055,5528
1993,6242,6081,7247,75392,74355,866,12.357,388,5.537,15071,5878,9193,7.905,20.269,12916,2733,10183,3.676,17.371,2155,2.898,34.741,221,221,1869
1993,6243,5372,8296,300843,299181,732,8.878,630,7.641,49300,6667,42633,2.228,16.478,46232,5892,40340,1.969,15.453,3068,1.025,30.906,248,265,2144
1993,6244,40226,48993,510113,487351,6228,12.955,4387,9.126,108931,35782,73149,7.342,22.352,63150,25126,38024,5.156,12.958,45781,9.394,25.916,3235,3301,18047
1993,7111,6395,6466,98336,96022,1095,17.135,944,14.772,25712,6561,19151,6.833,26.777,21152,5885,15267,6.129,22.028,4560,4.749,44.057,705,705,3744
1993,7112,2704,2826,80855,81727,473,16.875,427,15.234,17188,4922,12266,6.022,21.031,18548,3832,14716,4.689,22.695,-1360,-1.664,42.062,343,344,2796
1993,7113,2695,2804,54606,51376,440,15.954,348,12.618,15244,3735,11509,7.27,29.671,8825,2362,6463,4.597,17.177,6419,12.494,34.355,275,277,1948
1993,7114,1548,1583,12981,12895,277,18.005,188,12.22,3617,1885,1732,14.619,28.051,3395,1281,2114,9.934,26.329,222,1.722,52.658,134,134,862
1993,7115,6723,6761,55019,56592,1242,18.336,1267,18.705,16092,3881,12211,6.858,28.435,19063,7619,11444,13.463,33.685,-2971,-5.25,56.87,819,820,5591
1993,7121,3202,3509,72142,70796,353,10.347,158,4.631,10824,1788,9036,2.526,15.289,7809,728,7081,1.028,11.03,3015,4.259,22.061,100,100,412
1993,7131,1628,2541,94257,93508,292,11.528,276,10.896,11166,3239,7927,3.464,11.941,9532,1345,8187,1.438,10.194,1634,1.747,20.388,185,185,849
1993,7132,1081,1233,52001,45349,288,25.285,100,8.78,17737,11152,6585,24.592,39.112,4304,1020,3284,2.249,9.491,13433,29.621,18.982,66,67,727
1993,7139,40484,43621,712174,696149,5440,12.656,4166,9.692,135275,48299,86976,6.938,19.432,103181,33260,69921,4.778,14.822,32094,4.61,29.643,3153,3211,23706
1993,7211,30124,36750,1423897,1423472,3872,10.601,3425,9.377,197243,82602,114641,5.803,13.856,195759,83333,112426,5.854,13.752,1484,0.104,27.504,2264,2335,44179
1993,7212,4451,4763,31294,30645,518,11.011,401,8.524,7026,2036,4990,6.644,22.927,5695,1536,4159,5.012,18.584,1331,4.343,37.168,264,264,897
1993,7213,3172,3260,15451,15631,237,7.218,284,8.649,2471,682,1789,4.363,15.809,2859,850,2009,5.438,18.291,-388,-2.482,31.618,199,202,595
1993,7223,16723,29917,544828,552219,4676,14.937,7450,23.799,133281,63223,70058,11.449,24.136,149219,79705,69514,14.434,27.022,-15938,-2.886,48.271,3075,3145,27864
1993,7224,49657,50181,319734,313954,7311,14.68,6552,13.156,86492,46116,40376,14.689,27.549,75420,32764,42656,10.436,24.023,11072,3.527,48.045,5391,5406,27579
1993,7225,235772,318801,5919622,5865426,42717,13.557,35305,11.205,1133341,545090,588251,9.293,19.322,1023376,382475,640901,6.521,17.448,109965,1.875,34.895,25400,26368,247144
1993,8111,124674,134803,686690,675728,16694,12.493,14344,10.734,140084,55649,84435,8.235,20.731,118001,46919,71082,6.943,17.463,22083,3.268,34.926,10659,10794,35952
1993,8112,12972,15731,135522,137642,1953,12.464,1828,11.667,21872,7843,14029,5.698,15.891,26048,9321,16727,6.772,18.925,-4176,-3.034,31.781,1164,1173,4567
1993,8113,21153,22399,167117,165519,2390,10.686,2325,10.395,30838,9582,21256,5.789,18.631,27814,8468,19346,5.116,16.804,3024,1.827,33.608,1723,1728,5898
1993,8114,27004,28780,173073,174488,3801,13.16,4009,13.88,30054,11641,18413,6.672,17.224,32698,10797,21901,6.188,18.739,-2644,-1.515,34.448,3092,3121,8241
1993,8121,76006,87485,459937,460038,10813,12.367,10712,12.251,96170,41096,55074,8.933,20.905,97550,38915,58635,8.459,21.205,-1380,-0.3,41.81,8278,8457,27492
1993,8122,16535,20119,128801,129167,1109,5.486,1303,6.445,20221,4571,15650,3.539,15.655,20985,7653,13332,5.925,16.246,-764,-0.591,31.31,713,786,3668
1993,8123,34520,41400,385311,379496,4424,10.718,4180,10.126,64486,20190,44296,5.32,16.993,53295,18671,34624,4.92,14.044,11191,2.949,28.087,3084,3190,13938
1993,8129,14316,23416,168356,164108,3482,15.047,2933,12.674,40115,14831,25284,9.037,24.444,31063,14750,16313,8.988,18.928,9052,5.516,37.857,1423,1551,7125
1993,8131,140246,140352,1244510,1221424,7406,5.322,4995,3.59,152621,20256,132365,1.658,12.495,106354,13401,92953,1.097,8.707,46267,3.788,17.415,3347,3347,9209
1993,8132,10331,12061,149947,148293,946,7.906,755,6.31,23960,4257,19703,2.871,16.157,20774,3802,16972,2.564,14.009,3186,2.148,28.018,442,447,2030
1993,8133,9715,11391,124712,121977,943,8.355,734,6.503,22298,3592,18706,2.945,18.281,16947,3642,13305,2.986,13.894,5351,4.387,27.787,425,431,1923
1993,8134,31439,33205,319277,315251,1674,5.029,1834,5.51,44568,7321,37247,2.322,14.137,36457,6717,29740,2.131,11.564,8111,2.573,23.129,1314,1314,4738
1993,8139,63007,65141,518075,520013,4040,6.211,3860,5.934,75087,16623,58464,3.197,14.439,78759,19317,59442,3.715,15.146,-3672,-0.706,28.879,2737,2763,14513
1994,1131,237,269,2635,2355,49,18.846,31,11.923,858,534,324,22.68,36.441,318,101,217,4.29,13.506,540,22.935,27.012,25,25,85
1994,1132,118,133,1259,1305,25,19.763,12,9.486,224,103,121,7.896,17.171,325,86,239,6.593,24.914,-101,-7.742,34.343,9,9,67
1994,1133,11945,12032,84768,84187,1987,16.839,1523,12.907,19625,7667,11958,9.107,23.311,18190,6100,12090,7.246,21.607,1435,1.705,43.213,1156,1156,4549
1994,1141,1143,1153,10253,10074,180,15.755,159,13.917,3943,651,3292,6.462,39.14,3512,905,2607,8.984,34.862,431,4.278,69.724,118,118,811
1994,1142,199,204,1539,1494,36,18.182,24,12.121,235,98,137,6.56,15.73,152,86,66,5.756,10.174,83,5.556,20.348,18,18,71
1994,1151,4357,4650,59802,60988,555,12.009,498,10.776,13200,4112,9088,6.742,21.644,15367,4652,10715,7.628,25.197,-2167,-3.553,43.288,341,341,2676
1994,1152,2410,2436,15516,15129,405,16.974,305,12.783,3294,1228,2066,8.117,21.773,2529,1056,1473,6.98,16.716,765,5.057,33.432,238,238,866
1994,1153,1038,1065,13036,12737,172,16.618,112,10.821,3060,865,2195,6.792,24.025,2485,774,1711,6.077,19.511,575,4.515,39.022,77,77,649
1994,2111,6729,8011,100311,100240,801,9.942,893,11.084,18522,7901,10621,7.882,18.478,18594,6898,11696,6.882,18.55,-72,-0.072,36.955,595,601,2407
1994,2121,1357,1874,102285,103967,273,14.267,352,18.396,17332,8056,9276,7.749,16.671,20644,9221,11423,8.869,19.856,-3312,-3.186,33.342,232,235,3982
1994,2122,356,515,42852,44160,64,12.284,76,14.587,3178,721,2457,1.633,7.197,5832,910,4922,2.061,13.207,-2654,-6.01,14.393,43,43,151
1994,2123,3320,4979,96347,96371,314,6.279,358,7.159,11995,2849,9146,2.956,12.447,12168,3510,8658,3.642,12.626,-173,-0.18,24.894,227,230,1688
1994,2131,7426,8450,145933,141310,1095,12.938,1122,13.257,36515,10724,25791,7.589,25.84,27174,9168,18006,6.488,19.23,9341,6.61,38.46,773,777,5087
1994,2211,1527,7058,601882,611726,317,4.526,209,2.984,29303,10126,19177,1.655,4.79,49077,5782,43295,0.945,8.023,-19774,-3.232,9.58,50,52,403
1994,2212,594,2745,107181,107802,163,5.927,173,6.291,8634,3671,4963,3.405,8.009,9731,1580,8151,1.466,9.027,-1097,-1.018,16.018,46,58,506
1994,2213,3942,4333,31879,31611,335,7.829,227,5.305,3445,1187,2258,3.755,10.898,2951,910,2041,2.879,9.335,494,1.563,18.671,162,162,534
1994,2361,117506,117996,603444,589368,24086,20.847,19173,16.594,190436,79379,111057,13.468,32.312,162363,64967,97396,11.023,27.549,28073,4.763,55.097,13714,13719,49213
1994,2362,35622,36263,588097,580384,4863,13.547,4129,11.503,135856,27430,108426,4.726,23.408,120691,27120,93571,4.673,20.795,15165,2.613,41.59,3040,3041,19594
1994,2371,14134,14438,317424,313111,1413,9.837,1264,8.8,67419,11295,56124,3.607,21.532,59564,10158,49406,3.244,19.023,7855,2.509,38.047,959,959,7164
1994,2372,7454,7655,57485,55970,1939,26.433,1300,17.722,17481,8509,8972,15.203,31.233,14529,6506,8023,11.624,25.959,2952,5.274,51.917,980,986,4573
1994,2373,9653,10072,223603,223675,1001,10.014,850,8.503,44619,7543,37076,3.372,19.948,44670,8910,35760,3.983,19.971,-51,-0.023,39.896,614,621,6272
1994,2379,4768,4836,70456,70205,652,13.416,700,14.403,17834,3710,14124,5.285,25.403,17003,4253,12750,6.058,24.219,831,1.184,48.438,536,536,2474
1994,2381,80274,80686,688269,678219,12485,15.719,9963,12.544,198461,56004,142457,8.258,29.262,178007,55218,122789,8.142,26.246,20454,3.016,52.492,7499,7503,44339
1994,2382,124951,126883,1247709,1210422,15682,12.547,11887,9.511,271200,61431,209769,5.075,22.405,196747,55173,141574,4.558,16.254,74453,6.151,32.509,8949,8951,41137
1994,2383,84318,84778,619600,603838,15515,18.615,12657,15.186,181819,57364,124455,9.5,30.111,150710,53272,97438,8.822,24.959,31109,5.152,49.917,9463,9468,42675
1994,2389,42146,42367,333950,331537,6222,14.939,4784,11.487,87162,24253,62909,7.315,26.29,82071,22818,59253,6.883,24.755,5091,1.536,49.509,3582,3583,17170
1994,3111,1145,1769,48845,48385,83,4.673,97,5.462,4716,1198,3518,2.476,9.747,3838,1224,2614,2.53,7.932,878,1.815,15.864,63,63,732
1994,3112,457,809,63341,64134,41,5.059,44,5.429,4163,1927,2236,3.005,6.491,5861,917,4944,1.43,9.139,-1698,-2.648,12.982,27,27,185
1994,3113,1535,1742,84396,84914,176,10.168,154,8.897,7008,1285,5723,1.513,8.253,8058,1672,6386,1.969,9.49,-1050,-1.237,16.506,105,106,693
1994,3114,1258,1701,175783,178034,110,6.446,121,7.091,16468,1954,14514,1.098,9.25,20876,5408,15468,3.038,11.726,-4408,-2.476,18.5,80,80,1517
1994,3115,1275,1829,132707,132924,101,5.486,125,6.79,10429,2172,8257,1.634,7.846,11007,2866,8141,2.156,8.281,-578,-0.435,15.692,78,78,716
1994,3116,3446,4050,419641,415716,256,6.285,303,7.438,36300,6963,29337,1.675,8.732,28181,6526,21655,1.57,6.779,8119,1.953,13.558,230,231,3882
1994,3117,628,737,44364,45437,60,7.958,94,12.467,6693,1763,4930,3.88,14.73,8663,2348,6315,5.168,19.066,-1970,-4.336,29.461,64,66,1311
1994,3118,9352,10395,309615,307265,1257,12.117,1214,11.703,37168,12376,24792,4.028,12.096,32507,10856,21651,3.533,10.579,4661,1.517,21.159,889,914,6466
1994,3119,2214,2582,134336,134808,242,9.387,234,9.077,16722,5221,11501,3.873,12.404,17656,8239,9417,6.112,13.097,-934,-0.693,24.809,159,159,2423
1994,3121,1692,2114,127133,129212,179,8.524,151,7.19,10996,2845,8151,2.202,8.51,15103,2963,12140,2.293,11.689,-4107,-3.179,17.02,107,107,1215
1994,3122,75,109,33290,34573,11,10.329,6,5.634,1611,135,1476,0.39,4.66,4200,272,3928,0.787,12.148,-2589,-7.489,9.319,3,3,8
1994,3131,356,598,91543,92350,40,6.74,31,5.223,7196,1509,5687,1.634,7.792,8980,3558,5422,3.853,9.724,-1784,-1.932,15.584,12,12,782
1994,3132,1669,2015,243341,242729,173,8.659,139,6.957,19982,4454,15528,1.835,8.232,18592,3086,15506,1.271,7.66,1390,0.573,15.319,112,112,1930
1994,3133,2400,2615,109940,108759,467,18.857,190,7.672,14332,4744,9588,4.362,13.178,12013,4202,7811,3.864,11.046,2319,2.132,22.091,133,137,2688
1994,3141,2873,3165,127041,124660,314,9.82,379,11.853,14612,2028,12584,1.627,11.721,9907,3359,6548,2.695,7.947,4705,3.774,15.894,300,303,1804
1994,3149,4080,4215,119040,117169,567,13.681,426,10.279,21367,7827,13540,6.68,18.236,17593,5742,11851,4.901,15.015,3774,3.221,30.03,348,349,4172
1994,3151,1127,1264,118843,120143,153,12.201,133,10.606,14411,4551,9860,3.788,11.995,16783,4569,12214,3.803,13.969,-2372,-1.974,23.99,116,117,2906
1994,3152,11022,12083,626317,648967,2284,18.817,2394,19.723,94398,41165,53233,6.343,14.546,139877,60479,79398,9.319,21.554,-45479,-7.008,29.092,2026,2040,44090
1994,3159,1829,1936,60016,61278,256,13.313,230,11.96,7416,2507,4909,4.091,12.102,9985,3050,6935,4.977,16.295,-2569,-4.192,24.204,188,188,2157
1994,3161,323,356,16926,16968,33,9.322,29,8.192,1584,694,890,4.09,9.335,1666,687,979,4.049,9.818,-82,-0.483,18.67,19,19,122
1994,3162,332,416,59571,61216,33,7.82,45,10.664,4901,531,4370,0.867,8.006,8262,3016,5246,4.927,13.496,-3361,-5.49,16.012,29,29,2088
1994,3169,997,1038,31869,31985,96,9.023,148,13.91,4629,608,4021,1.901,14.472,4924,1794,3130,5.609,15.395,-295,-0.922,28.945,119,119,1101
1994,3211,4346,4858,135802,133711,414,8.531,404,8.325,17131,4341,12790,3.247,12.812,12933,3565,9368,2.666,9.672,4198,3.14,19.345,334,334,2387
1994,3212,1329,1634,103141,100094,116,7.154,91,5.612,12228,2256,9972,2.254,12.217,6075,1862,4213,1.86,6.069,6153,6.147,12.139,60,69,1241
1994,3219,9309,10023,286855,279171,1125,11.329,940,9.466,46198,12307,33891,4.408,16.548,30565,10862,19703,3.891,10.949,15633,5.6,21.897,739,740,7199
1994,3221,227,542,183035,184726,20,3.711,14,2.597,4652,774,3878,0.419,2.518,8065,1349,6716,0.73,4.366,-3413,-1.848,5.037,6,6,77
1994,3222,3562,5196,401408,401180,282,5.439,260,5.014,32040,7758,24282,1.934,7.986,31763,8792,22971,2.192,7.917,277,0.069,15.835,166,171,3232
1994,3231,41066,43042,819474,819369,3340,7.703,3979,9.176,96072,26099,69973,3.185,11.725,95308,32849,62459,4.009,11.632,764,0.093,23.264,3281,3292,21011
1994,3241,1107,2032,126409,127660,112,5.479,136,6.654,7644,1913,5731,1.499,5.988,10349,3515,6834,2.753,8.107,-2705,-2.119,11.976,61,62,923
1994,3251,1162,2356,206282,212062,137,5.845,113,4.821,11288,4797,6491,2.262,5.323,22539,8634,13905,4.071,10.629,-11251,-5.306,10.646,42,42,672
1994,3252,377,659,135839,134505,54,8.289,39,5.986,19010,14881,4129,11.064,14.133,16427,9288,7139,6.905,12.213,2583,1.92,24.426,19,19,135
1994,3253,636,888,38520,39084,71,8.041,61,6.908,2754,923,1831,2.362,7.046,3891,858,3033,2.195,9.956,-1137,-2.909,14.093,43,43,352
1994,3254,1143,1441,193844,191045,128,9.056,73,5.164,19226,2905,16321,1.521,10.064,14106,1731,12375,0.906,7.384,5120,2.68,14.767,41,41,727
1994,3255,1561,2019,72102,71783,116,5.727,129,6.369,6299,1191,5108,1.659,8.775,5731,1484,4247,2.067,7.984,568,0.791,15.968,87,89,541
1994,3256,2067,2298,120069,121458,198,8.654,178,7.78,11714,3501,8213,2.882,9.644,14500,4820,9680,3.968,11.938,-2786,-2.294,19.289,131,132,1568
1994,3259,2230,2936,128017,128820,185,6.313,174,5.938,9249,1460,7789,1.133,7.18,10973,2185,8788,1.696,8.518,-1724,-1.338,14.36,124,124,1224
1994,3261,10409,12603,731572,715894,1008,8.076,765,6.129,94266,18900,75366,2.64,13.168,63148,19379,43769,2.707,8.821,31118,4.347,17.642,558,563,9484
1994,3262,2223,2732,194970,192826,181,6.624,182,6.661,17093,3826,13267,1.984,8.864,12838,3340,9498,1.732,6.658,4255,2.207,13.316,132,132,1261
1994,3271,1493,1766,77936,77434,192,10.909,180,10.227,8409,2080,6329,2.686,10.86,7328,2355,4973,3.041,9.464,1081,1.396,18.927,133,134,1257
1994,3272,1724,1985,133572,133526,189,9.538,182,9.185,10233,2287,7946,1.713,7.664,10029,3802,6227,2.847,7.511,204,0.153,15.022,136,136,1154
1994,3273,5874,8757,169755,166997,515,5.885,502,5.737,27535,6360,21175,3.808,16.488,21884,6068,15816,3.634,13.104,5651,3.384,26.209,280,291,2992
1994,3274,258,357,16997,17000,29,8.169,25,7.042,1163,202,961,1.188,6.841,1156,220,936,1.294,6.8,7,0.041,13.6,16,16,108
1994,3279,1953,2255,69637,68588,194,8.682,153,6.847,8102,2602,5500,3.794,11.813,6000,1747,4253,2.547,8.748,2102,3.065,17.496,106,107,831
1994,3311,251,317,141858,143161,44,14.57,14,4.636,4136,646,3490,0.451,2.889,6868,414,6454,0.289,4.797,-2732,-1.908,5.778,10,10,41
1994,3312,519,717,68102,67733,34,4.703,46,6.362,5404,1144,4260,1.689,7.978,4765,1272,3493,1.878,7.035,639,0.943,14.07,29,29,217
1994,3313,381,547,84866,86103,30,5.489,29,5.306,4584,861,3723,1,5.324,7251,1142,6109,1.326,8.421,-2667,-3.097,10.648,15,15,280
1994,3314,760,919,76519,76499,55,5.917,76,8.176,5678,1143,4535,1.494,7.422,5610,1423,4187,1.86,7.333,68,0.089,14.667,51,51,450
1994,3315,2408,2669,201749,197484,154,5.773,151,5.661,22239,4415,17824,2.236,11.261,13803,4567,9236,2.313,6.989,8436,4.272,13.979,104,104,1694
1994,3321,3104,3309,135569,133506,158,4.75,193,5.802,15984,2589,13395,1.939,11.973,11755,2891,8864,2.165,8.805,4229,3.168,17.61,145,145,1415
1994,3322,1353,1488,76425,75409,104,7.046,80,5.42,6881,1665,5216,2.208,9.125,4816,848,3968,1.125,6.387,2065,2.738,12.773,53,53,481
1994,3323,10425,11180,325665,320035,837,7.496,808,7.237,48004,9830,38174,3.072,15,36721,9835,26886,3.073,11.474,11283,3.526,22.948,608,614,6004
1994,3324,1545,1876,107527,107183,121,6.467,111,5.933,11351,3101,8250,2.893,10.59,10722,2654,8068,2.476,10.003,629,0.587,20.007,61,62,768
1994,3325,914,997,66423,66013,71,7.183,54,5.463,6170,1234,4936,1.869,9.347,5430,2174,3256,3.293,8.226,740,1.121,16.451,32,34,410
1994,3326,1560,1740,68113,66661,118,6.843,87,5.045,7928,1357,6571,2.036,11.893,5012,1398,3614,2.097,7.519,2916,4.374,15.037,65,65,448
1994,3327,22471,22819,347659,340558,1864,8.216,1603,7.065,50447,11460,38987,3.365,14.813,36514,11924,24590,3.501,10.722,13933,4.091,21.444,1284,1287,8459
1994,3328,5389,5802,136272,133525,391,6.764,349,6.037,18271,4140,14131,3.101,13.684,12898,3558,9340,2.665,9.66,5373,4.024,19.319,277,279,2331
1994,3329,5777,6271,303257,305096,458,7.299,465,7.411,27360,4897,22463,1.605,8.968,30939,8372,22567,2.744,10.141,-3579,-1.173,17.935,334,335,3479
1994,3331,2775,3027,196111,192837,243,8.056,222,7.36,21137,2847,18290,1.476,10.961,14856,5004,9852,2.595,7.704,6281,3.257,15.408,160,161,1641
1994,3332,4046,4292,158130,156091,300,6.974,319,7.416,19653,4698,14955,3.01,12.591,15648,5442,10206,3.486,10.025,4005,2.566,20.05,242,243,3402
1994,3333,2439,2567,134878,136432,191,7.449,185,7.215,14616,3080,11536,2.258,10.713,17391,1911,15480,1.401,12.747,-2775,-2.034,21.426,141,141,1005
1994,3334,1572,1820,155790,152429,135,7.44,124,6.834,17927,3144,14783,2.063,11.761,11286,2562,8724,1.681,7.404,6641,4.357,14.808,90,91,1286
1994,3335,9436,9766,214501,211520,654,6.723,578,5.942,26644,6447,20197,3.048,12.596,20660,6015,14645,2.844,9.767,5984,2.829,19.535,448,449,3310
1994,3336,758,911,120052,117716,41,4.483,48,5.249,9890,1110,8780,0.943,8.402,5228,618,4610,0.525,4.441,4662,3.96,8.882,34,34,313
1994,3339,5513,6132,307280,304620,437,7.157,385,6.305,32142,4904,27238,1.61,10.552,26735,8205,18530,2.694,8.777,5407,1.775,17.553,263,263,2501
1994,3341,1665,1760,188237,189162,257,14.703,233,13.33,24455,5323,19132,2.814,12.928,26779,9000,17779,4.758,14.157,-2324,-1.229,25.856,178,180,3448
1994,3342,1784,1991,211559,213555,175,8.841,152,7.679,21477,3030,18447,1.419,10.057,25269,9265,16004,4.338,11.833,-3792,-1.776,20.114,118,118,1554
1994,3343,430,463,34181,34277,64,14.128,44,9.713,3433,647,2786,1.888,10.015,3574,1222,2352,3.565,10.427,-141,-0.411,20.031,32,33,673
1994,3344,5124,5665,483693,481654,577,10.276,477,8.495,58805,15491,43314,3.216,12.209,55011,16161,38850,3.355,11.421,3794,0.788,22.843,339,340,4808
1994,3345,4614,5223,514548,529772,351,6.718,354,6.776,36054,9812,26242,1.852,6.806,65834,14632,51202,2.762,12.427,-29780,-5.621,13.611,212,212,2483
1994,3346,742,794,45054,45305,111,14.131,94,11.967,5364,2153,3211,4.752,11.84,5768,1586,4182,3.501,12.732,-404,-0.892,23.68,61,61,672
1994,3351,1137,1254,72291,71730,121,9.758,93,7.5,7285,1689,5596,2.355,10.156,6269,1544,4725,2.153,8.74,1016,1.416,17.479,68,68,814
1994,3352,322,393,104880,103186,21,5.257,34,8.511,9663,474,9189,0.459,9.365,6479,1625,4854,1.575,6.279,3184,3.086,12.558,23,23,1470
1994,3353,2234,2651,203837,201796,193,7.334,154,5.852,18396,3227,15169,1.599,9.116,14209,3134,11075,1.553,7.041,4187,2.075,14.083,101,102,996
1994,3359,1820,2174,184236,181563,127,5.834,133,6.109,19674,3841,15833,2.116,10.836,14234,4626,9608,2.548,7.84,5440,2.996,15.679,88,88,1390
1994,3361,280,334,219223,214385,47,14.286,37,11.246,22191,4255,17936,1.985,10.351,13061,1853,11208,0.864,6.092,9130,4.259,12.185,30,30,483
1994,3362,1709,1878,122402,117057,192,10.262,178,9.514,21053,3137,17916,2.68,17.985,10651,4957,5694,4.235,9.099,10402,8.886,18.198,145,147,3280
1994,3363,4347,5273,705425,685196,435,8.317,350,6.692,83104,16271,66833,2.375,12.129,43739,16049,27690,2.342,6.383,39365,5.745,12.767,255,255,4049
1994,3364,1365,1673,527017,567311,110,6.495,151,8.916,31182,16245,14937,2.864,5.496,111289,25289,86000,4.458,19.617,-80107,-14.12,10.993,96,96,779
1994,3365,171,221,27237,26726,12,5.455,10,4.545,2916,489,2427,1.83,10.911,1946,663,1283,2.481,7.281,970,3.629,14.563,7,7,118
1994,3366,1372,1474,139565,140060,154,10.508,137,9.348,14319,1952,12367,1.394,10.223,15757,2756,13001,1.968,11.25,-1438,-1.027,20.447,100,100,2039
1994,3369,541,561,32855,32852,82,14.95,57,10.392,3945,1071,2874,3.26,12.008,3986,445,3541,1.355,12.133,-41,-0.125,24.017,46,46,359
1994,3371,13255,13787,373145,367869,1702,12.338,1718,12.454,52719,15803,36916,4.296,14.331,42473,15605,26868,4.242,11.546,10246,2.785,23.091,1323,1325,10479
1994,3372,3262,3457,154862,151751,338,9.873,271,7.916,20668,3719,16949,2.451,13.62,14505,4192,10313,2.762,9.558,6163,4.061,19.117,208,208,2959
1994,3379,1068,1204,39413,39178,96,7.931,109,9.005,4879,1273,3606,3.249,12.453,4352,1398,2954,3.568,11.108,527,1.345,22.217,85,86,831
1994,3391,10735,11308,273474,275550,914,8.1,865,7.666,25613,4900,20713,1.778,9.295,29868,7512,22356,2.726,10.839,-4255,-1.544,18.59,635,637,3652
1994,3399,15804,16339,405251,402980,1923,11.884,1609,9.943,55275,14607,40668,3.625,13.717,50382,18785,31597,4.662,12.502,4893,1.214,25.005,1277,1281,10197
1994,4231,20237,25026,299634,295696,2207,8.773,2470,9.818,44838,12764,32074,4.317,15.164,37042,15326,21716,5.183,12.527,7796,2.636,25.054,1721,1794,8427
1994,4232,9073,10242,127172,126401,1111,10.811,1180,11.483,20943,5266,15677,4.166,16.569,19506,8275,11231,6.547,15.432,1437,1.137,30.864,889,912,5462
1994,4233,8427,11270,144223,140618,1136,10.162,954,8.534,23036,5771,17265,4.104,16.382,15788,5139,10649,3.655,11.228,7248,5.154,22.455,693,711,3804
1994,4234,28083,36286,593505,599865,4847,13.471,4235,11.77,95996,28793,67203,4.8,16.003,108963,38237,70726,6.374,18.165,-12967,-2.162,32.006,2646,2814,17249
1994,4235,6948,9333,136072,133737,764,8.197,740,7.939,18325,4413,13912,3.3,13.702,13555,4418,9137,3.304,10.136,4770,3.567,20.271,466,488,2470
1994,4236,18656,27900,359955,351863,3093,11.238,2339,8.498,64725,21294,43431,6.052,18.395,48338,15289,33049,4.345,13.738,16387,4.657,27.476,1436,1491,7015
1994,4237,11448,16450,187180,183934,1275,7.799,1073,6.563,26207,7627,18580,4.147,14.248,19713,6575,13138,3.575,10.717,6494,3.531,21.435,747,775,4882
1994,4238,47780,61895,656133,651550,5034,8.149,4790,7.754,88351,23957,64394,3.677,13.56,78921,25518,53403,3.917,12.113,9430,1.447,24.226,3165,3267,15245
1994,4239,26428,28467,292579,289488,3834,13.593,3310,11.736,55630,17736,37894,6.127,19.217,49137,19396,29741,6.7,16.974,6493,2.243,33.948,2577,2616,12409
1994,4241,9919,12850,198221,194820,1148,8.967,1052,8.217,26396,6447,19949,3.309,13.549,19546,6287,13259,3.227,10.033,6850,3.516,20.066,711,732,3853
1994,4242,3885,5102,142269,144807,790,15.865,545,10.945,20006,6740,13266,4.654,13.816,25336,6984,18352,4.823,17.496,-5330,-3.681,27.631,377,382,3358
1994,4243,12981,14062,167777,167692,2025,14.404,2019,14.361,32663,11121,21542,6.632,19.478,32291,11388,20903,6.791,19.256,372,0.222,38.512,1642,1656,8266
1994,4244,27880,33923,722753,715636,3640,10.724,3679,10.839,102023,29313,72710,4.096,14.256,87262,34204,53058,4.78,12.194,14761,2.063,24.387,2681,2703,17528
1994,4245,6059,8933,78846,80171,512,5.666,718,7.946,10183,2688,7495,3.353,12.702,12830,4396,8434,5.483,16.003,-2647,-3.302,25.403,446,495,2884
1994,4246,8811,12682,144253,144197,1232,9.789,1040,8.263,22376,7002,15374,4.856,15.518,22301,7861,14440,5.452,15.466,75,0.052,30.931,602,612,3340
1994,4247,8298,11486,130361,129813,707,6.114,861,7.446,18906,5620,13286,4.329,14.564,17897,4825,13072,3.717,13.787,1009,0.777,27.574,496,519,2474
1994,4248,3399,4380,140498,139360,212,4.801,284,6.431,14890,3329,11561,2.389,10.685,12425,4964,7461,3.562,8.916,2465,1.769,17.832,184,203,2791
1994,4249,22536,27261,335049,330805,3292,12.124,3074,11.321,55315,16260,39055,4.915,16.721,46802,17079,29723,5.163,14.148,8513,2.573,28.296,2269,2298,11015
1994,4251,33305,35604,310059,309543,3825,10.859,3065,8.701,48460,16980,31480,5.486,15.655,47569,16085,31484,5.196,15.368,891,0.288,30.735,2084,2112,9671
1994,4411,38838,41281,1009793,980974,4363,10.685,3466,8.488,136277,38300,97977,3.904,13.892,78714,29684,49030,3.026,8.024,57563,5.868,16.048,2734,2763,22689
1994,4412,10617,11337,83588,80698,1115,9.932,893,7.955,16206,4888,11318,6.057,20.082,10387,3557,6830,4.408,12.871,5819,7.211,25.743,671,676,2660
1994,4413,40574,63990,499940,489112,4785,7.498,4443,6.962,80928,29082,51846,5.946,16.546,58856,21843,37013,4.466,12.033,22072,4.513,24.066,2819,3013,12777
1994,4421,21272,27864,246650,242439,2937,10.576,2749,9.899,43085,16512,26573,6.811,17.771,35191,12941,22250,5.338,14.515,7894,3.256,29.031,1908,2055,8750
1994,4422,23708,31737,210188,206259,3696,11.792,2908,9.278,42840,18238,24602,8.842,20.77,35097,11347,23750,5.501,17.016,7743,3.754,34.032,2001,2079,6818
1994,4431,27249,39091,314752,300402,5852,15.307,4134,10.813,77946,38080,39866,12.676,25.947,48559,20547,28012,6.84,16.165,29387,9.783,32.329,2893,2979,13381
1994,4441,51830,68906,814380,795004,5290,7.694,4987,7.253,134372,56088,78284,7.055,16.902,95991,37351,58640,4.698,12.074,38381,4.828,24.149,3496,3598,17212
1994,4442,16245,19790,155516,153699,1586,8.045,1434,7.274,24847,7063,17784,4.595,16.166,21187,6168,15019,4.013,13.785,3660,2.381,27.57,1056,1069,4062
1994,4451,61620,91433,2533504,2523337,9176,10.04,9096,9.953,308269,146152,162117,5.792,12.217,291467,89945,201522,3.565,11.551,16802,0.666,23.102,6231,6356,40119
1994,4452,17457,21904,133955,133642,3385,15.644,2851,13.177,28869,13260,15609,9.922,21.602,28414,11750,16664,8.792,21.261,455,0.34,42.523,2148,2188,8664
1994,4453,23820,27964,134739,135255,2340,8.293,2844,10.079,23116,7612,15504,5.628,17.091,24294,9353,14941,6.915,17.962,-1178,-0.871,34.181,2125,2149,6435
1994,4461,44858,77041,769980,762362,7050,9.21,6062,7.919,118425,48142,70283,6.315,15.534,102911,43094,59817,5.653,13.499,15514,2.035,26.998,3670,4034,22029
1994,4471,73043,123199,903215,893968,9702,7.819,11461,9.237,169302,59105,110197,6.612,18.938,149267,60685,88582,6.788,16.697,20035,2.241,33.394,7043,7336,35270
1994,4481,45332,98474,1000769,1010402,10772,10.894,11579,11.71,171008,84615,86393,8.374,16.925,190671,58941,131730,5.833,18.871,-19663,-1.946,33.849,6556,7169,27506
1994,4482,8112,32502,179886,180745,2716,8.221,3785,11.457,35145,16459,18686,9.106,19.445,36163,15390,20773,8.515,20.008,-1018,-0.563,38.889,1045,1349,4694
1994,4483,18989,27589,154181,157656,2601,9.378,2893,10.431,26112,11477,14635,7.28,16.563,33676,11314,22362,7.176,21.36,-7564,-4.798,33.125,1738,1896,6096
1994,4511,32051,43035,344742,342542,5334,12.418,5174,12.045,66335,32183,34152,9.395,19.366,62056,24809,37247,7.243,18.116,4279,1.249,36.233,3492,3686,14018
1994,4512,9068,14699,113515,112223,1552,10.546,1588,10.79,23005,8519,14486,7.591,20.499,20569,7940,12629,7.075,18.329,2436,2.171,36.657,934,966,3468
1994,4522,124,6344,1066355,1063643,236,3.742,160,2.537,94115,28942,65173,2.721,8.848,90265,15250,75015,1.434,8.486,3850,0.362,16.973,4,6,192
1994,4523,10644,28760,1183601,1156970,2891,10.082,2721,9.489,174841,90167,84674,7.793,15.112,123439,42453,80986,3.669,10.669,51402,4.443,21.338,1291,1398,5750
1994,4531,23134,24497,120435,120946,2574,10.46,2795,11.358,21671,7871,13800,6.508,17.918,22819,7947,14872,6.571,18.867,-1148,-0.949,35.836,2253,2288,6465
1994,4532,30222,39856,281808,275406,4786,12.002,4829,12.11,60597,25381,35216,9.216,22.003,47764,18258,29506,6.629,17.343,12833,4.66,34.686,3678,3791,12670
1994,4533,12187,15322,90461,88756,2176,14.364,1829,12.074,17206,7254,9952,8.173,19.386,13798,4640,9158,5.228,15.546,3408,3.84,31.092,1445,1455,3384
1994,4539,26418,30766,169489,163132,5124,17.031,3764,12.511,45491,21972,23519,13.469,27.886,32589,13017,19572,7.979,19.977,12902,7.909,39.954,2846,2938,9834
1994,4541,5497,6152,145351,140711,943,14.433,1706,26.112,32377,8836,23541,6.28,23.01,22716,9975,12741,7.089,16.144,9661,6.866,32.288,1442,1448,6975
1994,4542,4603,5470,69781,69616,742,13.728,612,11.323,9532,2729,6803,3.92,13.692,9093,3368,5725,4.838,13.062,439,0.631,26.123,405,406,1736
1994,4543,17309,23553,216987,214422,2454,10.528,1966,8.435,36947,13511,23436,6.301,17.231,31792,11857,19935,5.53,14.827,5155,2.404,29.654,1301,1319,7624
1994,4811,606,3050,444758,441894,442,14.981,243,8.236,28721,6504,22217,1.472,6.5,23014,3286,19728,0.744,5.208,5707,1.291,10.416,44,55,1000
1994,4812,1237,1414,25113,23241,198,14.281,143,10.314,6229,1344,4885,5.783,26.802,2438,612,1826,2.633,10.49,3791,16.312,20.981,95,95,292
1994,4831,438,755,36850,37271,97,13.242,52,7.099,5544,1651,3893,4.43,14.875,6649,1565,5084,4.199,17.84,-1105,-2.965,29.75,31,31,236
1994,4832,301,330,11797,11650,50,15.314,43,13.17,1847,613,1234,5.262,15.855,1573,399,1174,3.425,13.503,274,2.352,27.005,25,25,142
1994,4841,25369,32447,678724,652796,5909,18.79,3910,12.433,129649,41232,88417,6.316,19.861,77506,29554,47952,4.527,11.873,52143,7.988,23.746,2915,2968,16544
1994,4842,47890,52037,522785,525280,7970,15.379,7541,14.552,103829,33362,70467,6.351,19.766,108228,48104,60124,9.158,20.604,-4399,-0.837,39.533,5918,6000,29292
1994,4851,413,499,26832,26253,66,13.32,59,11.907,3769,1037,2732,3.95,14.356,2564,1160,1404,4.419,9.767,1205,4.59,19.533,48,48,567
1994,4852,288,503,20110,19747,81,15.197,141,26.454,4483,508,3975,2.573,22.703,3731,2996,735,15.172,18.894,752,3.808,37.789,20,20,60
1994,4853,5439,5548,53065,51218,978,17.842,845,15.415,12988,5266,7722,10.282,25.359,9348,4145,5203,8.093,18.252,3640,7.107,36.503,716,720,3598
1994,4854,3273,4243,137551,136437,395,9.4,313,7.449,18803,7854,10949,5.757,13.781,17247,5899,11348,4.324,12.641,1556,1.14,25.282,230,240,3312
1994,4855,1149,1263,26611,26255,168,13.505,130,10.45,4862,1536,3326,5.85,18.519,4159,1573,2586,5.991,15.841,703,2.678,31.682,98,101,1202
1994,4859,1481,1582,30881,29212,317,21.311,128,8.605,6605,2502,4103,8.565,22.611,3240,1036,2204,3.546,11.091,3365,11.519,22.183,103,103,617
1994,4861,49,372,9610,9676,36,9.511,49,12.946,1436,825,611,8.526,14.841,1572,142,1430,1.468,16.246,-136,-1.406,29.682,(D),(D),(D)
1994,4862,151,1443,38334,39068,180,12.834,99,7.059,3771,1617,2154,4.139,9.653,5226,1405,3821,3.596,13.377,-1455,-3.724,19.305,17,17,97
1994,4869,57,423,6184,6114,93,23.515,38,9.608,1655,1534,121,25.09,27.069,1502,795,707,13.003,24.567,153,2.502,49.133,5,5,25
1994,4871,338,377,7014,6955,59,15.691,57,15.16,1268,322,946,4.63,18.233,1150,237,913,3.408,16.536,118,1.697,33.072,46,47,195
1994,4872,1165,1199,11649,11504,187,15.868,146,12.389,3212,844,2368,7.337,27.922,2888,711,2177,6.181,25.105,324,2.817,50.211,113,113,527
1994,4879,124,130,1038,956,25,19.084,27,20.611,363,186,177,19.456,37.971,213,139,74,14.54,22.28,150,15.69,44.561,20,20,121
1994,4881,2561,3220,89358,87045,506,16.043,374,11.858,19081,6556,12525,7.532,21.921,14518,3975,10543,4.567,16.679,4563,5.242,33.358,236,238,1208
1994,4882,474,725,18232,17704,86,11.854,87,11.992,3451,1353,2098,7.643,19.493,2407,945,1462,5.338,13.596,1044,5.897,27.192,54,62,535
1994,4883,2012,2575,82042,82257,272,10.644,233,9.118,14437,3549,10888,4.315,17.551,14727,3907,10820,4.75,17.904,-290,-0.353,35.102,166,167,2275
1994,4884,4401,4570,31789,30970,765,17.105,570,12.745,7196,2762,4434,8.918,23.236,5566,2666,2900,8.608,17.973,1630,5.263,35.945,450,454,1829
1994,4885,9275,12263,115084,112480,1807,15.085,1238,10.335,23879,9326,14553,8.291,21.23,18759,6475,12284,5.757,16.678,5120,4.552,33.355,883,942,4509
1994,4889,779,836,9681,9500,114,13.547,125,14.854,2091,752,1339,7.916,22.011,1734,932,802,9.811,18.253,357,3.758,36.505,105,105,828
1994,4921,1601,4387,385330,384212,476,10.853,474,10.807,27772,4720,23052,1.228,7.228,26955,3974,22981,1.034,7.016,817,0.213,14.031,217,220,1650
1994,4922,3844,4219,62962,61095,692,16.719,532,12.853,12914,3791,9123,6.205,21.138,9417,3622,5795,5.928,15.414,3497,5.724,30.827,440,446,2791
1994,4931,6533,10695,437772,435697,1071,10.091,908,8.555,72447,27013,45434,6.2,16.628,68168,21306,46862,4.89,15.646,4279,0.982,31.291,327,337,3680
1994,5111,15404,18174,680938,686398,2077,11.541,1722,9.569,63190,19524,43666,2.844,9.206,72635,25109,47526,3.658,10.582,-9445,-1.376,18.412,1316,1325,9300
1994,5112,5773,6981,149570,143974,1144,16.755,838,12.273,32431,8362,24069,5.808,22.526,20849,10085,10764,7.005,14.481,11582,8.045,28.962,541,550,4402
1994,5121,10470,14893,218913,217285,2159,14.636,1875,12.711,47397,14628,32769,6.732,21.813,44371,15288,29083,7.036,20.421,3026,1.393,40.841,1081,1143,9130
1994,5122,1781,1823,12880,12553,380,21.839,214,12.299,3416,1574,1842,12.539,27.213,2692,1054,1638,8.396,21.445,724,5.768,42.89,160,160,647
1994,5151,6222,8128,244767,242966,921,11.442,764,9.491,33946,12850,21096,5.289,13.972,30648,11203,19445,4.611,12.614,3298,1.357,25.228,547,581,6767
1994,5152,230,395,15997,15504,71,18.66,42,11.038,2578,833,1745,5.373,16.629,1535,480,1055,3.096,9.901,1043,6.728,19.802,23,24,150
1994,5173,6014,28688,1012233,1015045,3804,13.486,2842,10.076,161596,59998,101598,5.911,15.92,168961,59644,109317,5.876,16.646,-7365,-0.726,31.84,656,703,5843
1994,5174,239,304,6426,6380,63,21.837,32,11.092,1791,932,859,14.609,28.074,1661,873,788,13.684,26.037,130,2.038,52.073,16,16,188
1994,5179,1525,2269,41766,39312,612,28.591,355,16.585,11976,5716,6260,14.54,30.464,7045,2532,4513,6.441,17.921,4931,12.543,35.842,145,150,766
1994,5182,4971,7110,286333,285319,855,11.945,951,13.286,48745,18412,30333,6.453,17.084,47065,18629,28436,6.529,16.496,1680,0.589,32.991,549,552,4035
1994,5191,2525,2971,35110,34485,265,9.017,201,6.839,4568,1738,2830,5.04,13.247,3349,676,2673,1.96,9.712,1219,3.535,19.423,147,147,488
1994,5211,15,45,22982,23404,(D),(D),(D),(D),406,(D),360,(D),1.735,1236,(D),1234,(D),5.281,-830,-3.546,3.469,(D),(D),(D)
1994,5221,21389,98238,1962778,1936502,8400,8.638,6404,6.586,360933,188144,172789,9.716,18.638,306218,112526,193692,5.811,15.813,54715,2.825,31.626,743,1050,15492
1994,5222,14993,37161,491639,475734,6744,18.774,4266,11.876,125674,52667,73007,11.071,26.417,94722,46984,47738,9.876,19.911,30952,6.506,39.821,1117,1197,5974
1994,5223,8883,11643,108706,99480,2457,22.282,1225,11.109,36587,13959,22628,14.032,36.778,18046,6971,11075,7.007,18.14,18541,18.638,36.281,824,877,3887
1994,5231,7786,22644,383317,357955,6149,29.359,2750,13.13,94486,39109,55377,10.926,26.396,42612,20037,22575,5.598,11.904,51874,14.492,23.809,663,674,3949
1994,5232,34,48,6439,6438,8,16.495,9,18.557,300,140,160,2.175,4.66,298,50,248,0.777,4.629,2,0.031,9.258,5,5,12
1994,5239,17852,19683,174558,169191,3821,19.752,3145,16.257,44674,20901,23773,12.353,26.404,33986,17378,16608,10.271,20.087,10688,6.317,40.175,2355,2368,12426
1994,5241,4129,36920,1506858,1513429,4437,12.118,3825,10.447,216517,78546,137971,5.19,14.306,226828,79645,147183,5.263,14.988,-10311,-0.681,28.613,260,279,4913
1994,5242,105948,116635,683874,693908,11711,10.038,11774,10.092,111538,39404,72134,5.679,16.074,130940,63808,67132,9.195,18.87,-19402,-2.796,32.148,8807,8954,48135
1994,5259,613,655,19752,19681,59,8.879,78,11.738,3063,225,2838,1.143,15.563,2813,468,2345,2.378,14.293,250,1.27,28.586,55,56,281
1994,5311,88300,95959,498113,499690,10263,10.681,10520,10.948,94947,43116,51831,8.629,19.001,98341,42764,55577,8.558,19.68,-3394,-0.679,38.002,8133,8259,30175
1994,5312,44366,50018,230163,227677,7955,16.198,6138,12.499,53187,22912,30275,10.063,23.361,48522,20749,27773,9.113,21.312,4665,2.049,42.624,4387,4527,13690
1994,5313,32957,36802,389074,380892,6257,17.691,3388,9.579,84947,39735,45212,10.432,22.302,69167,24243,44924,6.365,18.159,15780,4.143,36.318,2396,2489,15576
1994,5321,4848,9734,129053,132810,1453,15.118,1207,12.559,20742,6430,14312,4.842,15.618,28860,7346,21514,5.531,21.73,-8118,-6.113,31.236,512,556,3101
1994,5322,20763,30204,231637,223602,4100,13.6,3987,13.225,57932,22811,35121,10.202,25.909,42649,18348,24301,8.206,19.074,15283,6.835,38.147,2959,3117,12639
1994,5323,3882,6177,41486,40509,624,10.271,421,6.929,7471,2756,4715,6.804,18.443,5466,1829,3637,4.515,13.493,2005,4.95,26.987,296,310,1264
1994,5324,7299,9910,110936,109871,1226,12.473,1065,10.835,22387,8292,14095,7.547,20.376,20124,8304,11820,7.558,18.316,2263,2.06,36.632,699,735,4750
1994,5331,1547,1689,19070,18860,341,20.965,216,13.28,4570,2392,2178,12.683,24.231,4130,2059,2071,10.917,21.898,440,2.333,43.796,139,143,649
1994,5411,147281,153997,1014802,1012529,15522,10.202,11827,7.773,131846,44741,87105,4.419,13.021,127193,36469,90724,3.602,12.562,4653,0.46,25.124,8765,8860,28336
1994,5412,79067,83486,752866,738817,9652,11.682,7923,9.59,151178,67488,83690,9.135,20.462,121449,37795,83654,5.116,16.438,29729,4.024,32.877,5690,5747,23992
1994,5413,67980,76553,972644,963057,10067,13.37,7557,10.036,167270,44880,122390,4.66,17.369,149021,41918,107103,4.353,15.474,18249,1.895,30.948,5248,5313,21951
1994,5414,18504,18712,96121,95498,3456,18.889,2625,14.347,23934,10883,13051,11.396,25.062,22650,10552,12098,11.049,23.718,1284,1.345,47.436,2034,2035,7759
1994,5415,33085,37478,494982,482576,8905,24.993,5209,14.62,119739,42595,77144,8.827,24.812,94948,39336,55612,8.151,19.675,24791,5.137,39.351,3461,3505,20187
1994,5416,43927,46705,420028,406380,9626,21.146,7258,15.944,109302,39145,70157,9.633,26.897,81701,35692,46009,8.783,20.105,27601,6.792,40.209,5455,5505,25653
1994,5417,7456,9369,458263,466514,1343,14.655,933,10.181,45880,11160,34720,2.392,9.835,62433,22053,40380,4.727,13.383,-16553,-3.548,19.669,538,548,2691
1994,5418,29288,31983,377127,374284,4822,15.344,3709,11.802,66624,23145,43479,6.184,17.8,61232,22133,39099,5.913,16.36,5392,1.441,32.72,2907,2934,15133
1994,5419,36793,42132,361724,355531,4340,10.463,3032,7.31,66387,22832,43555,6.422,18.673,53880,14603,39277,4.107,15.155,12507,3.518,30.31,2132,2156,9794
1994,5511,28463,51469,3153872,3177155,4847,9.417,4854,9.43,463385,143162,320223,4.506,14.585,511581,147605,363976,4.646,16.102,-48196,-1.517,29.17,936,989,12793
1994,5611,15775,17218,320393,309916,3613,21.9,2173,13.171,85068,37808,47260,12.199,27.449,64242,29551,34691,9.535,20.729,20826,6.72,41.458,1664,1680,21511
1994,5612,608,1074,73489,74941,205,20,107,10.439,12111,4609,7502,6.15,16.161,15230,3861,11369,5.152,20.323,-3119,-4.162,32.322,34,40,495
1994,5613,20228,29549,2212558,2069458,5071,17.573,3687,12.777,731064,198796,532268,9.606,35.326,444247,147407,296840,7.123,21.467,286817,13.86,42.934,2460,2606,104187
1994,5614,25120,28695,418206,408789,4470,15.829,3559,12.603,98415,35580,62835,8.704,24.075,79995,31304,48691,7.658,19.569,18420,4.506,39.138,2835,2859,19324
1994,5615,25224,31855,259975,254062,3775,11.946,3266,10.335,51148,16554,34594,6.516,20.132,39223,17804,21419,7.008,15.438,11925,4.694,30.877,2152,2219,9067
1994,5616,14082,17372,567736,562477,2564,14.961,2096,12.23,97570,32019,65551,5.692,17.346,87121,34981,52140,6.219,15.489,10449,1.858,30.978,1536,1565,18370
1994,5617,100252,104850,1195218,1194674,18708,18.202,14570,14.176,271007,98611,172396,8.254,22.685,269659,89198,180461,7.466,22.572,1348,0.113,45.144,11597,11644,56145
1994,5619,17879,19615,289299,281484,3758,19.763,2558,13.453,73997,26483,47514,9.408,26.288,57815,24500,33315,8.704,20.539,16182,5.749,41.079,1999,2008,12208
1994,5621,4987,5488,86150,81876,743,14.234,207,3.966,15329,4666,10663,5.699,18.722,6747,1584,5163,1.935,8.241,8582,10.482,16.481,144,144,1102
1994,5622,1709,2617,87921,87504,322,12.522,231,8.983,13294,3781,9513,4.321,15.192,12500,4618,7882,5.277,14.285,794,0.907,28.57,135,138,2448
1994,5629,5006,5405,78668,75068,731,13.67,616,11.519,21239,4779,16460,6.366,28.293,14177,5156,9021,6.868,18.886,7062,9.408,37.771,448,451,3353
1994,6111,14441,16478,566557,554503,776,4.754,465,2.849,59431,10109,49322,1.823,10.718,35329,6576,28753,1.186,6.371,24102,4.347,12.743,321,321,4633
1994,6112,571,844,73598,73478,30,3.494,59,6.872,7807,419,7388,0.57,10.625,7576,1356,6220,1.845,10.311,231,0.314,20.621,24,39,838
1994,6113,2110,2540,1167537,1158951,113,4.472,87,3.443,75249,5603,69646,0.483,6.493,58041,4908,53133,0.423,5.008,17208,1.485,10.016,52,52,4562
1994,6114,3856,4279,50244,49496,912,22.222,562,13.694,11408,3705,7703,7.485,23.048,9833,4825,5008,9.748,19.866,1575,3.182,39.733,384,424,3615
1994,6115,4935,5768,62080,62680,727,12.828,526,9.281,10600,3494,7106,5.574,16.911,11895,3995,7900,6.374,18.977,-1295,-2.066,33.823,346,358,2044
1994,6116,16648,17693,135837,133191,3218,18.79,2084,12.169,32053,13958,18095,10.48,24.066,26899,8895,18004,6.678,20.196,5154,3.87,40.392,1633,1691,7398
1994,6117,2718,2816,23721,22973,597,22.144,357,13.242,5430,2624,2806,11.422,23.636,3955,1126,2829,4.901,17.216,1475,6.421,34.432,253,260,845
1994,6211,178280,191994,1569011,1559007,12903,6.688,14745,7.643,231118,74967,156151,4.809,14.825,211246,76286,134960,4.893,13.55,19872,1.275,27.1,11887,12091,55082
1994,6212,103005,106060,590504,584001,4961,4.696,4147,3.925,78532,19105,59427,3.271,13.447,65489,15746,49743,2.696,11.214,13043,2.233,22.428,3263,3318,12727
1994,6213,69374,73312,319229,316164,8139,11.257,6115,8.458,66436,25926,40510,8.2,21.013,60511,19519,40992,6.174,19.139,5925,1.874,38.278,4629,4771,15572
1994,6214,8769,15056,318254,306537,1813,12.329,1111,7.555,60165,24709,35456,8.061,19.627,36152,10311,25841,3.364,11.794,24013,7.834,23.587,692,744,7026
1994,6215,5422,8116,142332,139341,1274,16.012,955,12.003,26831,11756,15075,8.437,19.256,20623,9975,10648,7.159,14.8,6208,4.455,29.601,647,680,5144
1994,6216,6811,12136,678328,638157,2382,20.899,905,7.94,166194,61433,104761,9.627,26.043,87534,22913,64621,3.59,13.717,78660,12.326,27.433,530,577,10904
1994,6219,5606,7402,163650,161851,788,10.666,760,10.287,28468,8888,19580,5.491,17.589,24978,9441,15537,5.833,15.433,3490,2.156,30.865,557,580,6259
1994,6221,3012,4635,4167246,4169414,137,2.96,125,2.7,166717,26076,140641,0.625,3.999,169137,42592,126545,1.022,4.057,-2420,-0.058,7.997,78,80,27622
1994,6222,604,942,302302,304437,44,4.646,54,5.702,9711,1648,8063,0.541,3.19,14261,4129,10132,1.356,4.684,-4550,-1.495,6.38,9,10,1051
1994,6223,245,369,127721,127143,35,9.887,5,1.412,7278,1532,5746,1.205,5.724,6149,313,5836,0.246,4.836,1129,0.888,9.673,3,3,200
1994,6231,8239,14492,1415165,1402746,847,5.856,791,5.469,153325,57774,95551,4.119,10.93,127916,49847,78069,3.554,9.119,25409,1.811,18.238,456,502,28032
1994,6232,7120,15704,318134,307839,1869,12.456,470,3.132,53083,21356,31727,6.937,17.244,32808,7076,25732,2.299,10.658,20275,6.586,21.315,275,287,4723
1994,6233,10677,12773,323870,320755,1725,13.7,1361,10.809,44142,15195,28947,4.737,13.762,38008,17591,20417,5.484,11.85,6134,1.912,23.699,891,940,10905
1994,6239,4074,5830,147682,144359,572,10.021,328,5.746,20576,5467,15109,3.787,14.253,13989,3846,10143,2.664,9.69,6587,4.563,19.381,224,234,2470
1994,6241,23347,32082,488516,474857,3713,11.914,1878,6.026,80522,26253,54269,5.529,16.957,53378,11384,41994,2.397,11.241,27144,5.716,22.482,1263,1286,6225
1994,6242,6343,7692,80786,78589,792,10.54,436,5.803,14095,4113,9982,5.234,17.935,9691,2659,7032,3.383,12.331,4404,5.604,24.663,294,295,1657
1994,6243,5434,8481,312005,309502,651,7.712,571,6.765,45858,7647,38211,2.471,14.817,40917,5756,35161,1.86,13.22,4941,1.596,26.441,305,319,2832
1994,6244,41959,51408,536624,525182,6622,13.176,4320,8.596,99378,37666,61712,7.172,18.923,75882,31013,44869,5.905,14.449,23496,4.474,28.897,3318,3405,17452
1994,7111,6596,6668,101458,100339,1169,17.793,973,14.81,23972,7245,16727,7.221,23.891,21641,6725,14916,6.702,21.568,2331,2.323,43.136,709,712,4683
1994,7112,2815,2934,79175,80493,541,18.733,449,15.547,13439,3950,9489,4.907,16.696,16211,4649,11562,5.776,20.14,-2772,-3.444,33.392,326,328,2401
1994,7113,2752,2869,55602,55062,466,16.461,390,13.776,13038,6039,6999,10.968,23.679,12196,3677,8519,6.678,22.15,842,1.529,44.299,308,310,2003
1994,7114,1680,1715,13574,13313,322,19.503,194,11.75,3280,1223,2057,9.187,24.638,2794,1351,1443,10.148,20.988,486,3.651,41.976,149,149,1178
1994,7115,6899,6926,33179,36837,1337,19.53,1177,17.193,10935,4338,6597,11.776,29.685,18022,11385,6637,30.907,48.924,-7087,-19.239,59.37,771,773,8977
1994,7121,3398,3724,74334,73704,354,9.766,156,4.303,8081,1328,6753,1.802,10.964,6915,961,5954,1.304,9.382,1166,1.582,18.764,99,99,487
1994,7131,1608,2606,101367,96634,337,13.108,267,10.385,16997,4727,12270,4.892,17.589,7997,2389,5608,2.472,8.276,9000,9.313,16.551,205,212,2018
1994,7132,1238,1451,79829,65957,311,23.08,104,7.718,34623,15988,18635,24.24,52.494,6442,1833,4609,2.779,9.767,28181,42.727,19.534,64,64,916
1994,7139,41692,44974,732944,724462,5661,12.769,4379,9.878,130599,50445,80154,6.963,18.027,113469,36082,77387,4.981,15.663,17130,2.365,31.325,3414,3505,28924
1994,7211,30789,37491,1472133,1456487,4122,11.082,3531,9.493,228167,100484,127683,6.899,15.666,194644,87019,107625,5.975,13.364,33523,2.302,26.728,2444,2503,51986
1994,7212,4597,4975,32059,31940,590,12.108,386,7.921,6480,2255,4225,7.06,20.288,6327,1458,4869,4.565,19.809,153,0.479,39.618,259,259,1039
1994,7213,3152,3243,15508,15441,250,7.69,266,8.182,2455,910,1545,5.893,15.899,2333,762,1571,4.935,15.109,122,0.79,30.218,191,191,595
1994,7223,15233,28318,528728,537525,3520,12.085,5137,17.637,106371,50500,55871,9.395,19.789,125729,60815,64914,11.314,23.39,-19358,-3.601,39.578,3167,3215,29596
1994,7224,49702,50211,321719,321308,7093,14.111,7199,14.322,83877,45507,38370,14.163,26.105,83081,37163,45918,11.566,25.857,796,0.248,51.714,5911,5935,31686
1994,7225,242013,328334,6172828,6056614,46145,14.245,37356,11.532,1231059,672227,558832,11.099,20.326,998417,389974,608443,6.439,16.485,232642,3.841,32.969,27821,28914,269396
1994,8111,127798,138320,723309,706706,17175,12.564,13938,10.196,149418,59164,90254,8.372,21.143,115942,45256,70686,6.404,16.406,33476,4.737,32.812,10730,10875,35913
1994,8112,13255,15907,132019,133446,2005,12.664,1856,11.723,24721,9306,15415,6.974,18.525,27741,11110,16631,8.325,20.788,-3020,-2.263,37.05,1246,1291,3975
1994,8113,21180,22393,173389,171364,2314,10.343,2274,10.164,30293,8009,22284,4.674,17.678,26282,9516,16766,5.553,15.337,4011,2.341,30.674,1721,1722,6216
1994,8114,26433,28111,169664,171155,3456,12.168,4040,14.224,29869,9403,20466,5.494,17.451,32801,13084,19717,7.645,19.165,-2932,-1.713,34.903,3159,3173,9441
1994,8121,75680,86651,450219,456214,10934,12.548,11913,13.671,87492,44163,43329,9.68,19.178,99428,42948,56480,9.414,21.794,-11936,-2.616,38.356,8766,9050,29941
1994,8122,16532,20721,138204,133891,1651,8.073,1113,5.442,27958,12282,15676,9.173,20.881,19075,5583,13492,4.17,14.247,8883,6.635,28.493,682,724,3429
1994,8123,34691,41695,377946,381411,4537,10.905,4357,10.472,57165,21387,35778,5.607,14.988,63504,22861,40643,5.994,16.65,-6339,-1.662,29.976,3231,3401,16758
1994,8129,14756,23574,170017,169430,3272,13.92,3134,13.333,35491,15796,19695,9.323,20.947,34054,14442,19612,8.524,20.099,1437,0.848,40.198,1560,1610,7073
1994,8131,143233,143348,1271589,1259073,7745,5.46,4747,3.347,152278,23038,129240,1.83,12.094,127834,15547,112287,1.235,10.153,24444,1.941,20.306,2979,2979,9786
1994,8132,10858,12608,154841,153301,942,7.554,667,5.349,19988,3471,16517,2.264,13.038,16749,3379,13370,2.204,10.926,3239,2.113,21.851,462,463,2091
1994,8133,9907,11610,128781,126995,918,7.972,729,6.331,19493,4189,15304,3.299,15.349,15817,2852,12965,2.246,12.455,3676,2.895,24.91,456,458,1764
1994,8134,31282,33126,320676,321182,1676,5.05,1794,5.406,39075,7378,31697,2.297,12.166,39930,7598,32332,2.366,12.432,-855,-0.266,24.332,1297,1298,4787
1994,8139,64248,66369,511496,514440,4752,7.222,3606,5.481,73178,20570,52608,3.999,14.225,78875,18585,60290,3.613,15.332,-5697,-1.107,28.45,2575,2590,12868
1995,1131,232,271,2872,2733,37,13.755,33,12.268,761,419,342,15.334,27.85,476,92,384,3.367,17.42,285,10.43,34.84,28,28,77
1995,1132,117,141,1416,1340,26,18.909,19,13.818,324,184,140,13.736,24.188,172,53,119,3.957,12.841,152,11.348,25.681,13,13,45
1995,1133,12128,12206,84901,84737,1791,14.785,1607,13.266,18782,6894,11888,8.136,22.165,18426,7917,10509,9.343,21.745,356,0.42,43.49,1188,1188,5506
1995,1141,1198,1208,8876,9464,229,19.39,175,14.818,3033,1737,1296,18.355,32.049,4194,1123,3071,11.867,44.318,-1161,-12.268,64.099,125,125,806
1995,1142,217,222,1698,1620,37,17.371,19,8.92,278,97,181,5.99,17.166,130,33,97,2.038,8.027,148,9.139,16.054,16,16,30
1995,1151,4443,4735,59035,59503,578,12.304,503,10.708,11674,3255,8419,5.47,19.619,12618,3959,8659,6.653,21.206,-944,-1.586,39.238,381,384,3330
1995,1152,2474,2508,15669,15329,426,17.223,357,14.433,3098,1264,1834,8.246,20.211,2412,933,1479,6.087,15.735,686,4.475,31.471,277,277,676
1995,1153,1139,1172,14050,13546,237,21.208,128,11.454,3103,927,2176,6.843,22.907,2135,502,1633,3.706,15.761,968,7.146,31.522,92,92,408
1995,2111,6481,7677,99496,99336,597,7.615,922,11.761,16417,6608,9809,6.652,16.527,15662,5184,10478,5.219,15.767,755,0.76,31.534,621,630,2207
1995,2121,1249,1739,96004,99133,230,12.718,369,20.404,15160,4907,10253,4.95,15.293,21603,9499,12104,9.582,21.792,-6443,-6.499,30.585,252,253,4209
1995,2122,337,491,43213,42880,48,9.552,71,14.129,4000,585,3415,1.364,9.328,3354,509,2845,1.187,7.822,646,1.507,15.644,46,46,329
1995,2123,3345,5039,99630,97876,365,7.288,304,6.07,14367,4047,10320,4.135,14.679,10826,2244,8582,2.293,11.061,3541,3.618,22.122,170,170,1231
1995,2131,7384,8386,147704,146746,1038,12.329,1104,13.113,33704,8458,25246,5.764,22.968,31990,12216,19774,8.325,21.8,1714,1.168,43.599,740,743,5114
1995,2211,1537,7288,580865,591928,460,6.414,228,3.179,30148,9642,20506,1.629,5.093,52634,3737,48897,0.631,8.892,-22486,-3.799,10.186,43,44,609
1995,2212,597,2734,104996,106064,155,5.66,164,5.989,6777,2309,4468,2.177,6.39,8896,1486,7410,1.401,8.387,-2119,-1.998,12.779,28,29,161
1995,2213,4067,4475,32990,32585,354,8.036,214,4.858,3788,1311,2477,4.023,11.625,3013,1077,1936,3.305,9.247,775,2.378,18.493,164,164,496
1995,2361,122328,122912,640584,621797,24348,20.208,19492,16.178,194461,79373,115088,12.765,31.274,156897,65612,91285,10.552,25.233,37564,6.041,50.466,14125,14126,48785
1995,2362,37136,37815,630235,608172,5498,14.841,3959,10.687,148409,34745,113664,5.713,24.402,104390,29599,74791,4.867,17.165,44019,7.238,34.329,2989,2999,23806
1995,2371,14422,14720,334658,325866,1461,10.024,1171,8.034,68521,11509,57012,3.532,21.027,50713,11467,39246,3.519,15.563,17808,5.465,31.125,881,887,8049
1995,2372,8052,8248,62856,60366,1856,23.292,1297,16.277,18158,7511,10647,12.442,30.08,13243,5757,7486,9.537,21.938,4915,8.142,43.876,983,987,4395
1995,2373,9801,10208,233540,228467,984,9.709,837,8.259,45931,6968,38963,3.05,20.104,35585,7727,27858,3.382,15.576,10346,4.528,31.151,623,629,5552
1995,2379,4756,4825,71034,69800,641,13.286,640,13.266,15697,3502,12195,5.017,22.489,13106,3892,9214,5.576,18.777,2591,3.712,37.553,491,491,2872
1995,2381,83662,84057,736765,712923,13411,16.287,9978,12.118,204195,59375,144820,8.328,28.642,156207,49399,106808,6.929,21.911,47988,6.731,43.822,7622,7626,39635
1995,2382,130009,131955,1344442,1296093,16796,12.976,11758,9.084,291005,66014,224991,5.093,22.452,193984,54443,139541,4.201,14.967,97021,7.486,29.934,8915,8939,41851
1995,2383,88033,88526,664422,641930,16469,19.015,12637,14.591,187976,61326,126650,9.553,29.283,143138,51613,91525,8.04,22.298,44838,6.985,44.596,9695,9698,41025
1995,2389,44133,44368,353903,344183,6898,15.919,4826,11.137,91229,27896,63333,8.105,26.506,72474,22740,49734,6.607,21.057,18755,5.449,42.114,3700,3700,16994
1995,3111,1124,1758,47489,47918,92,5.233,92,5.233,3754,961,2793,2.006,7.834,4635,1376,3259,2.872,9.673,-881,-1.839,15.668,69,69,373
1995,3112,456,815,64090,63809,57,7.05,44,5.442,4746,966,3780,1.514,7.438,4271,1317,2954,2.064,6.693,475,0.744,13.387,23,23,175
1995,3113,1515,1696,84554,84460,144,8.384,187,10.888,9072,2683,6389,3.177,10.741,8547,2292,6255,2.714,10.12,525,0.622,20.239,120,125,850
1995,3114,1272,1698,178718,177586,111,6.527,116,6.822,17923,2344,15579,1.32,10.093,15523,2413,13110,1.359,8.741,2400,1.351,17.482,79,81,1035
1995,3115,1261,1789,133661,133226,85,4.717,111,6.16,10283,1997,8286,1.499,7.718,9583,2840,6743,2.132,7.193,700,0.525,14.386,68,68,716
1995,3116,3403,4017,440528,430827,255,6.335,271,6.733,38604,4390,34214,1.019,8.96,18952,4659,14293,1.081,4.399,19652,4.561,8.798,215,215,2980
1995,3117,644,758,43288,43826,77,10.336,51,6.846,6261,1822,4439,4.157,14.286,7488,1396,6092,3.185,17.086,-1227,-2.8,28.572,36,36,532
1995,3118,9438,10402,313356,311051,1257,12.082,1260,12.111,38053,10644,27409,3.422,12.234,33570,12798,20772,4.114,10.792,4483,1.441,21.585,936,950,7055
1995,3119,2209,2582,135204,134720,224,8.689,216,8.379,14614,3324,11290,2.467,10.848,13714,3970,9744,2.947,10.18,900,0.668,20.359,156,158,1925
1995,3121,1777,2180,130519,128386,215,10.047,135,6.308,14585,2216,12369,1.726,11.36,10347,3671,6676,2.859,8.059,4238,3.301,16.119,90,90,819
1995,3122,70,101,29004,31113,5,4.762,13,12.381,874,118,756,0.379,2.809,5079,617,4462,1.983,16.324,-4205,-13.515,5.618,9,9,31
1995,3131,369,612,89645,90498,40,6.628,23,3.811,5728,1234,4494,1.364,6.329,7391,1132,6259,1.251,8.167,-1663,-1.838,12.659,13,13,121
1995,3132,1688,2042,240121,240812,176,8.668,153,7.535,19283,5222,14061,2.168,8.007,20289,7922,12367,3.29,8.425,-1006,-0.418,16.015,121,121,2731
1995,3133,2647,2863,114422,112398,464,16.885,234,8.515,13895,3623,10272,3.223,12.362,9951,2617,7334,2.328,8.853,3944,3.509,17.707,190,192,1699
1995,3141,2880,3175,128964,127955,346,10.92,333,10.51,15205,4127,11078,3.225,11.883,12938,4046,8892,3.162,10.111,2267,1.772,20.223,272,272,3184
1995,3149,4207,4350,122085,120157,556,12.988,418,9.764,21411,5949,15462,4.951,17.819,17451,6789,10662,5.65,14.524,3960,3.296,29.047,335,335,3787
1995,3151,1121,1246,116679,118002,132,10.497,155,12.326,13149,1947,11202,1.65,11.143,15572,6306,9266,5.344,13.196,-2423,-2.053,22.286,127,127,2380
1995,3152,10998,11981,608967,616665,2143,17.814,2241,18.628,98018,38650,59368,6.268,15.895,112619,52291,60328,8.48,18.263,-14601,-2.368,31.79,1892,1898,34916
1995,3159,1858,1973,60568,60310,256,13.091,221,11.301,8759,2394,6365,3.97,14.523,8270,2225,6045,3.689,13.713,489,0.811,27.425,197,197,1825
1995,3161,310,339,16578,16658,20,5.772,35,10.101,1972,448,1524,2.689,11.839,2157,1056,1101,6.339,12.949,-185,-1.111,23.677,23,23,366
1995,3162,332,413,56506,58204,31,7.488,33,7.971,4646,790,3856,1.357,7.982,8109,2083,6026,3.579,13.932,-3463,-5.95,15.965,21,22,553
1995,3169,1013,1052,31652,31781,110,10.511,99,9.46,4159,870,3289,2.738,13.087,4464,1417,3047,4.459,14.046,-305,-0.96,26.173,76,76,613
1995,3211,4311,4828,136287,135738,430,8.909,427,8.847,15439,4406,11033,3.246,11.374,14360,4697,9663,3.46,10.579,1079,0.795,21.158,329,330,2212
1995,3212,1374,1691,107515,105389,148,8.91,88,5.298,12010,3498,8512,3.319,11.396,7727,3024,4703,2.869,7.332,4283,4.064,14.664,62,63,1121
1995,3219,9444,10160,309617,297616,1137,11.304,933,9.276,51537,14466,37071,4.861,17.317,27638,10645,16993,3.577,9.286,23899,8.03,18.573,749,753,7103
1995,3221,226,549,180652,181694,28,5.176,12,2.218,4926,1768,3158,0.973,2.711,7081,632,6449,0.348,3.897,-2155,-1.186,5.422,7,7,210
1995,3222,3559,5228,410755,406171,281,5.393,245,4.702,35525,7324,28201,1.803,8.746,26442,6209,20233,1.529,6.51,9083,2.236,13.02,174,174,2405
1995,3231,40407,42327,838321,826645,3168,7.434,3748,8.795,102683,27751,74932,3.357,12.422,79639,29516,50123,3.571,9.634,23044,2.788,19.268,3147,3158,19811
1995,3241,1090,2021,122591,124899,90,4.451,92,4.55,6941,1043,5898,0.835,5.557,11617,850,10767,0.681,9.301,-4676,-3.744,11.115,43,43,287
1995,3251,1176,2365,205905,206312,129,5.463,122,5.166,12512,2634,9878,1.277,6.065,12982,2950,10032,1.43,6.292,-470,-0.228,12.129,55,55,977
1995,3252,394,677,134218,134777,46,6.891,27,4.045,6439,1463,4976,1.086,4.778,7568,618,6950,0.459,5.615,-1129,-0.838,9.555,19,19,220
1995,3253,642,900,37967,38244,66,7.395,51,5.714,2794,705,2089,1.843,7.306,3407,861,2546,2.251,8.909,-613,-1.603,14.612,32,32,244
1995,3254,1140,1426,191687,192338,122,8.649,91,6.452,13929,2919,11010,1.518,7.242,15564,1983,13581,1.031,8.092,-1635,-0.85,14.484,56,56,482
1995,3255,1584,2045,73769,72911,121,5.956,94,4.627,7214,1173,6041,1.609,9.894,5482,1634,3848,2.241,7.519,1732,2.375,15.038,65,65,478
1995,3256,2054,2278,119402,119407,170,7.455,175,7.674,11007,2432,8575,2.037,9.218,10923,2730,8193,2.286,9.148,84,0.07,18.295,122,122,927
1995,3259,2221,2920,129646,128557,197,6.744,199,6.813,12734,2258,10476,1.756,9.905,10423,2585,7838,2.011,8.108,2311,1.798,16.215,124,124,763
1995,3261,10604,12874,769422,749731,1033,8.105,775,6.081,100850,19394,81456,2.587,13.451,61255,19157,42098,2.555,8.17,39595,5.281,16.341,531,536,10546
1995,3262,2244,2771,201886,198649,196,7.126,155,5.635,16851,3237,13614,1.63,8.483,10347,2136,8211,1.075,5.209,6504,3.274,10.417,116,116,1123
1995,3271,1528,1802,81555,79760,205,11.491,169,9.473,9778,2107,7671,2.642,12.259,6326,2367,3959,2.968,7.931,3452,4.328,15.863,130,131,963
1995,3272,1735,1999,136370,134888,195,9.811,172,8.654,11745,1748,9997,1.296,8.707,8539,2075,6464,1.538,6.33,3206,2.377,12.661,131,132,905
1995,3273,5756,8736,175877,172460,516,5.907,516,5.907,26637,5556,21081,3.222,15.445,19799,4865,14934,2.821,11.48,6838,3.965,22.961,322,325,2436
1995,3274,262,367,17725,17223,42,11.65,29,8.044,1946,980,966,5.69,11.299,918,315,603,1.829,5.33,1028,5.969,10.66,24,24,281
1995,3279,1959,2274,72039,70900,189,8.354,166,7.337,8555,1602,6953,2.26,12.066,6112,2543,3569,3.587,8.621,2443,3.446,17.241,125,126,938
1995,3311,233,299,141667,141880,29,9.699,29,9.699,4793,562,4231,0.396,3.378,5016,2096,2920,1.477,3.535,-223,-0.157,6.756,17,17,149
1995,3312,526,724,70282,69066,49,6.825,37,5.153,5861,917,4944,1.328,8.486,3501,1491,2010,2.159,5.069,2360,3.417,10.138,23,23,692
1995,3313,366,533,86882,85857,20,3.711,32,5.937,6797,851,5946,0.991,7.917,4798,1313,3485,1.529,5.588,1999,2.328,11.177,23,23,332
1995,3314,757,927,80057,78050,73,7.948,56,6.097,7987,1056,6931,1.353,10.233,3891,587,3304,0.752,4.985,4096,5.248,9.971,46,47,544
1995,3315,2400,2669,216409,208990,152,5.708,140,5.257,24738,1976,22762,0.946,11.837,9904,3435,6469,1.644,4.739,14834,7.098,9.478,106,106,1511
1995,3321,3086,3293,141928,138044,171,5.191,173,5.252,18505,3589,14916,2.6,13.405,10679,3630,7049,2.63,7.736,7826,5.669,15.472,133,133,1554
1995,3322,1363,1500,79992,78078,83,5.548,75,5.013,8121,969,7152,1.241,10.401,4378,1532,2846,1.962,5.607,3743,4.794,11.214,54,54,382
1995,3323,10480,11251,346386,335588,869,7.759,766,6.84,52535,9792,42743,2.918,15.655,30902,8188,22714,2.44,9.208,21633,6.446,18.417,617,622,5620
1995,3324,1542,1879,110476,108694,98,5.221,94,5.008,12384,2140,10244,1.969,11.393,8893,2550,6343,2.346,8.182,3491,3.212,16.363,64,64,979
1995,3325,914,1006,69780,68349,68,6.783,61,6.085,6497,1272,5225,1.861,9.506,3690,1162,2528,1.7,5.399,2807,4.107,10.798,50,50,759
1995,3326,1574,1757,73990,70918,134,7.668,115,6.581,9924,1363,8561,1.922,13.994,3807,1043,2764,1.471,5.368,6117,8.625,10.736,91,91,746
1995,3327,23042,23403,380304,363506,2066,8.946,1447,6.266,60502,10803,49699,2.972,16.644,26803,8582,18221,2.361,7.373,33699,9.271,14.747,1155,1156,5993
1995,3328,5418,5843,145225,140396,411,7.074,345,5.938,21116,4770,16346,3.398,15.04,11497,3887,7610,2.769,8.189,9619,6.851,16.378,253,253,2260
1995,3329,5753,6249,310486,305565,451,7.228,432,6.924,34674,6867,27807,2.247,11.348,24954,6929,18025,2.268,8.167,9720,3.181,16.333,337,338,3384
1995,3331,2776,3036,202265,198557,224,7.405,202,6.678,20773,3805,16968,1.916,10.462,13578,3559,10019,1.792,6.838,7195,3.624,13.677,146,146,1926
1995,3332,4049,4294,172682,165541,272,6.344,259,6.041,25333,2986,22347,1.804,15.303,11114,2846,8268,1.719,6.714,14219,8.589,13.427,190,191,1635
1995,3333,2427,2553,128201,129974,212,8.302,213,8.341,13380,2511,10869,1.932,10.294,17269,4070,13199,3.131,13.287,-3889,-2.992,20.589,162,163,1890
1995,3334,1569,1824,165579,160356,113,6.216,101,5.556,19983,2533,17450,1.58,12.462,9375,3436,5939,2.143,5.846,10608,6.615,11.693,75,75,866
1995,3335,9599,9941,231599,222330,725,7.363,537,5.453,32849,6486,26363,2.917,14.775,14358,4641,9717,2.087,6.458,18491,8.317,12.916,413,413,2778
1995,3336,742,899,120596,120199,39,4.317,48,5.313,10006,1443,8563,1.201,8.325,8999,1238,7761,1.03,7.487,1007,0.838,14.974,31,31,283
1995,3339,5620,6250,326235,316132,471,7.61,350,5.655,39881,6946,32935,2.197,12.615,19789,6170,13619,1.952,6.26,20092,6.356,12.519,265,265,2270
1995,3341,1615,1706,199387,193391,202,11.796,215,12.555,31451,4336,27115,2.242,16.263,19267,5152,14115,2.664,9.963,12184,6.3,19.925,165,165,2277
1995,3342,1811,2124,230605,220825,298,14.526,153,7.458,37637,12904,24733,5.844,17.044,17965,4564,13401,2.067,8.135,19672,8.908,16.271,107,107,1497
1995,3343,452,486,37742,35981,61,12.856,38,8.008,5432,466,4966,1.295,15.097,1879,450,1429,1.251,5.222,3553,9.875,10.444,31,31,417
1995,3344,5190,5750,514587,497660,587,10.325,457,8.039,70949,12586,58363,2.529,14.257,37082,9855,27227,1.98,7.451,33867,6.805,14.903,340,341,4264
1995,3345,4594,5198,486069,498610,380,7.312,378,7.273,35478,7497,27981,1.504,7.115,60354,16054,44300,3.22,12.104,-24876,-4.989,14.231,246,246,3754
1995,3346,765,818,49878,47442,116,14.428,88,10.945,7633,912,6721,1.922,16.089,2829,952,1877,2.007,5.963,4804,10.126,11.926,69,69,524
1995,3351,1153,1271,75339,73688,120,9.531,96,7.625,8459,1300,7159,1.764,11.48,5058,1514,3544,2.055,6.864,3401,4.615,13.728,71,72,609
1995,3352,335,404,107479,106184,42,10.553,30,7.538,8997,1741,7256,1.64,8.473,6348,1824,4524,1.718,5.978,2649,2.495,11.957,20,20,212
1995,3353,2249,2659,206525,204468,192,7.241,177,6.675,21456,4756,16700,2.326,10.494,17214,6265,10949,3.064,8.419,4242,2.075,16.838,116,116,1106
1995,3359,1780,2152,193265,188158,122,5.655,133,6.165,22927,3663,19264,1.947,12.185,13061,2687,10374,1.428,6.942,9866,5.243,13.883,93,94,1121
1995,3361,278,334,225434,222431,33,9.865,34,10.164,22482,5999,16483,2.697,10.107,16612,9487,7125,4.265,7.468,5870,2.639,14.937,27,28,234
1995,3362,1729,1896,135427,128497,186,9.883,158,8.395,21135,2517,18618,1.959,16.448,7416,1568,5848,1.22,5.771,13719,10.677,11.543,128,128,1152
1995,3363,4384,5361,743501,723511,421,7.927,321,6.044,87941,14246,73695,1.969,12.155,48745,10173,38572,1.406,6.737,39196,5.417,13.475,226,226,4062
1995,3364,1343,1626,474883,500427,113,6.888,142,8.656,14729,2680,12049,0.536,2.943,64889,12105,52784,2.419,12.967,-50160,-10.023,5.887,77,78,997
1995,3365,170,227,29884,28444,21,9.459,11,4.955,4935,1559,3376,5.481,17.35,2032,255,1777,0.896,7.144,2903,10.206,14.288,9,9,252
1995,3366,1384,1489,142857,142591,139,9.382,124,8.37,14789,1663,13126,1.166,10.372,13898,3610,10288,2.532,9.747,891,0.625,19.494,100,100,2767
1995,3369,567,587,34364,33514,79,13.787,51,8.901,5784,1523,4261,4.544,17.259,4099,360,3739,1.074,12.231,1685,5.028,24.462,39,39,277
1995,3371,13287,13816,382874,378678,1678,12.16,1644,11.914,48869,12465,36404,3.292,12.905,40372,14018,26354,3.702,10.661,8497,2.244,21.323,1274,1280,10887
1995,3372,3343,3550,160946,157622,319,9.088,239,6.809,19721,3717,16004,2.358,12.512,12996,3336,9660,2.116,8.245,6725,4.267,16.49,192,193,2308
1995,3379,1062,1194,40335,39544,96,8.05,93,7.799,5623,1567,4056,3.963,14.22,4095,1486,2609,3.758,10.356,1528,3.864,20.711,67,67,686
1995,3391,10789,11354,271189,272185,962,8.494,904,7.982,31351,8183,23168,3.006,11.518,33309,13067,20242,4.801,12.238,-1958,-0.719,23.037,667,668,4316
1995,3399,16033,16577,422264,412832,1885,11.476,1582,9.631,62387,17689,44698,4.285,15.112,43091,13690,29401,3.316,10.438,19296,4.674,20.876,1295,1300,9344
1995,4231,20074,24916,311849,305840,2292,9.181,2391,9.577,47982,14280,33702,4.669,15.689,36022,15084,20938,4.932,11.778,11960,3.911,23.556,1691,1771,9193
1995,4232,9194,10390,134824,131476,1179,11.431,1027,9.957,23144,5957,17187,4.531,17.603,16514,6457,10057,4.911,12.561,6630,5.043,25.121,793,802,4982
1995,4233,8648,11607,155400,149861,1224,10.676,939,8.191,26092,6596,19496,4.401,17.411,15225,4954,10271,3.306,10.159,10867,7.251,20.319,679,696,3380
1995,4234,28903,37244,608994,600986,4955,13.471,4033,10.964,105524,32842,72682,5.465,17.558,89892,31615,58277,5.261,14.957,15632,2.601,29.915,2691,2833,18811
1995,4235,7177,9582,144730,140598,831,8.764,632,6.665,20617,5392,15225,3.835,14.664,12507,4112,8395,2.925,8.896,8110,5.768,17.791,389,399,2442
1995,4236,19038,28480,388606,373675,3061,10.858,2485,8.815,77471,28189,49282,7.544,20.732,47919,18213,29706,4.874,12.824,29552,7.908,25.647,1427,1486,8389
1995,4237,11522,16674,194670,191099,1177,7.106,954,5.76,25398,4924,20474,2.577,13.291,18213,5818,12395,3.045,9.531,7185,3.76,19.061,658,685,3492
1995,4238,48387,62710,688027,672382,5158,8.275,4406,7.068,100043,25590,74453,3.806,14.879,69007,25165,43842,3.743,10.263,31036,4.616,20.526,2951,3097,14962
1995,4239,27122,29280,314548,303753,3925,13.605,3064,10.621,60893,18458,42435,6.077,20.047,39085,14700,24385,4.839,12.867,21808,7.18,25.735,2452,2468,10883
1995,4241,9927,12927,201161,200034,1184,9.193,1090,8.463,28656,8507,20149,4.253,14.326,26718,9510,17208,4.754,13.357,1938,0.969,26.714,704,713,4698
1995,4242,4096,5464,149997,145916,895,16.941,533,10.089,27481,12226,15255,8.379,18.833,19422,6974,12448,4.779,13.31,8059,5.523,26.621,390,394,2685
1995,4243,13332,14441,173752,170653,2277,15.966,1919,13.455,34827,10963,23864,6.424,20.408,28756,10564,18192,6.19,16.851,6071,3.558,33.701,1588,1609,8518
1995,4244,27969,33933,738582,731160,3600,10.608,3606,10.626,104923,28134,76789,3.848,14.35,89542,35870,53672,4.906,12.247,15381,2.104,24.493,2668,2741,20324
1995,4245,5818,8664,78315,78554,423,4.809,688,7.821,10406,2522,7884,3.211,13.247,10885,3914,6971,4.983,13.857,-479,-0.61,26.494,422,446,2653
1995,4246,9074,12926,151302,147597,1210,9.45,966,7.545,24481,7675,16806,5.2,16.586,16809,5407,11402,3.663,11.388,7672,5.198,22.777,548,556,2197
1995,4247,8160,11420,134280,132242,654,5.713,709,6.193,19630,7146,12484,5.404,14.844,15835,4224,11611,3.194,11.974,3795,2.87,23.949,445,467,2543
1995,4248,3379,4356,142531,141559,219,5.009,251,5.741,13905,3176,10729,2.244,9.823,11799,3773,8026,2.665,8.335,2106,1.488,16.67,180,202,2488
1995,4249,23099,27885,353690,344121,3606,13.073,3002,10.884,63495,20157,43338,5.858,18.451,44457,15534,28923,4.514,12.919,19038,5.532,25.838,2216,2274,10681
1995,4251,34450,36804,318549,313363,4182,11.559,2934,8.109,54518,17398,37120,5.552,17.398,43940,14955,28985,4.772,14.022,10578,3.376,28.044,2057,2063,9185
1995,4411,39857,42589,1062110,1036685,4422,10.53,3229,7.689,128926,38818,90108,3.744,12.436,78190,25726,52464,2.482,7.542,50736,4.894,15.085,2564,2587,20511
1995,4412,10847,11627,91328,87464,1131,9.847,848,7.383,16964,4398,12566,5.028,19.396,9274,3364,5910,3.846,10.603,7690,8.792,21.207,689,698,2805
1995,4413,40294,64629,519602,509230,4924,7.665,4141,6.446,79673,31026,48647,6.093,15.646,59872,19898,39974,3.907,11.757,19801,3.888,23.515,2730,2893,11941
1995,4421,21383,28156,255954,250980,2947,10.521,2657,9.486,44345,16955,27390,6.756,17.669,34403,13791,20612,5.495,13.707,9942,3.961,27.415,1833,1939,8690
1995,4422,24039,32276,218998,214472,3701,11.574,3105,9.71,44533,18912,25621,8.818,20.764,35123,12978,22145,6.051,16.376,9410,4.388,32.753,2005,2243,8100
1995,4431,28474,40898,356649,335280,6056,15.139,4265,10.662,92519,44695,47824,13.331,27.595,50238,20202,30036,6.025,14.984,42281,12.611,29.968,2876,3065,12831
1995,4441,51980,70001,868773,841634,5855,8.428,4787,6.891,147022,66881,80141,7.947,17.469,93044,34635,58409,4.115,11.055,53978,6.413,22.11,3357,3496,16218
1995,4442,16406,19999,160877,158146,1557,7.826,1349,6.781,24954,6891,18063,4.357,15.779,19448,5693,13755,3.6,12.298,5506,3.482,24.595,982,1001,3697
1995,4451,62077,91587,2594637,2563247,9260,10.122,9051,9.894,340938,143219,197719,5.587,13.301,274951,102275,172676,3.99,10.727,65987,2.574,21.453,6100,6214,35313
1995,4452,17347,21725,136595,135373,2757,12.645,2913,13.361,29113,12516,16597,9.246,21.506,26757,11924,14833,8.808,19.765,2356,1.74,39.531,2079,2121,8238
1995,4453,23635,27700,134872,135512,2420,8.699,2659,9.558,21267,7617,13650,5.621,15.694,22474,8269,14205,6.102,16.585,-1207,-0.891,31.388,2032,2066,6291
1995,4461,44392,77936,800407,784071,7569,9.768,6675,8.614,140029,58129,81900,7.414,17.859,106859,47331,59528,6.037,13.629,33170,4.23,27.257,3823,4098,21096
1995,4471,71763,121858,905990,903960,8979,7.333,10171,8.306,155104,55675,99429,6.159,17.158,151277,60904,90373,6.737,16.735,3827,0.423,33.47,6522,6906,35063
1995,4481,43716,94241,961858,981221,10289,10.681,14470,15.021,170272,83010,87262,8.46,17.353,206138,109558,96580,11.165,21.008,-35866,-3.655,34.706,6355,7361,29675
1995,4482,7817,31541,187244,185929,2917,9.114,3849,12.025,40155,18673,21482,10.043,21.597,38133,16749,21384,9.008,20.509,2022,1.088,41.019,962,1064,4103
1995,4483,18993,28413,158118,156084,3395,12.124,2573,9.189,29067,12864,16203,8.242,18.623,24885,8993,15892,5.762,15.943,4182,2.679,31.887,1650,1722,5068
1995,4511,32225,43127,368265,356642,5147,11.946,5066,11.758,77219,30605,46614,8.581,21.652,53023,24594,28429,6.896,14.867,24196,6.784,29.735,3493,3641,13152
1995,4512,9068,14729,121837,117525,1768,12.008,1757,11.933,28592,16117,12475,13.714,24.328,19846,6764,13082,5.755,16.887,8746,7.442,33.773,995,1039,3815
1995,4522,106,6304,1097613,1079864,210,3.335,195,3.097,107504,35370,72134,3.275,9.955,71270,17771,53499,1.646,6.6,36234,3.355,13.2,(D),(D),(D)
1995,4523,10626,28548,1284741,1236345,3032,10.567,3320,11.571,187382,106154,81228,8.586,15.156,91710,38973,52737,3.152,7.418,95672,7.738,14.836,1235,1404,6163
1995,4531,23194,24566,123822,122486,2596,10.578,2548,10.382,23089,8066,15023,6.585,18.85,20566,7145,13421,5.833,16.79,2523,2.06,33.581,2029,2062,5775
1995,4532,30173,40131,294473,288111,5064,12.667,4758,11.902,61895,28900,32995,10.031,21.483,49351,19369,29982,6.723,17.129,12544,4.354,34.258,3500,3653,13197
1995,4533,12572,15763,93892,92248,2288,14.719,1852,11.914,17170,7675,9495,8.32,18.613,13869,5653,8216,6.128,15.034,3301,3.578,30.069,1512,1537,4357
1995,4539,27428,32396,185036,177897,5491,17.36,3958,12.514,48278,22913,25365,12.88,27.138,33910,14218,19692,7.992,19.062,14368,8.077,38.123,3066,3181,11023
1995,4541,5874,6511,153044,149704,1096,17.316,733,11.581,27351,9340,18011,6.239,18.27,20783,6902,13881,4.61,13.883,6568,4.387,27.766,527,531,3930
1995,4542,4767,5572,71380,70331,700,12.662,613,11.088,9179,2929,6250,4.165,13.051,7019,2835,4184,4.031,9.98,2160,3.071,19.96,415,419,1676
1995,4543,17994,24444,226477,221068,2681,11.174,1780,7.419,39463,12286,27177,5.558,17.851,28578,10753,17825,4.864,12.927,10885,4.924,25.855,1264,1278,6426
1995,4811,643,3144,446449,444629,376,12.111,297,9.567,36429,7015,29414,1.578,8.193,32885,4368,28517,0.982,7.396,3544,0.797,14.792,76,88,1456
1995,4812,1293,1457,25163,25374,205,14.296,159,11.088,5380,1267,4113,4.993,21.203,6091,780,5311,3.074,24.005,-711,-2.802,42.406,107,107,605
1995,4831,459,775,38717,37713,86,11.264,63,8.251,6589,1789,4800,4.744,17.471,4376,980,3396,2.599,11.603,2213,5.868,23.207,31,34,520
1995,4832,306,344,12125,12043,43,12.703,32,9.453,1702,418,1284,3.471,14.133,1512,116,1396,0.963,12.555,190,1.578,25.11,24,24,81
1995,4841,27917,35373,747174,712479,6769,19.946,3895,11.477,149815,50783,99032,7.128,21.027,80827,27152,53675,3.811,11.344,68988,9.683,22.689,2883,2943,15889
1995,4842,49002,53080,531085,527273,8479,16.125,7485,14.235,104704,34123,70581,6.472,19.858,97347,40904,56443,7.758,18.462,7357,1.395,36.925,5906,5942,27603
1995,4851,419,504,28155,27656,68,13.6,60,12,4666,1510,3156,5.46,16.872,3637,2090,1547,7.557,13.151,1029,3.721,26.302,38,39,815
1995,4852,274,482,19368,19699,29,5.888,50,10.152,1841,559,1282,2.838,9.346,2536,333,2203,1.69,12.874,-695,-3.528,18.692,28,28,181
1995,4853,5500,5596,54727,53821,987,17.734,926,16.638,12491,4729,7762,8.787,23.208,10614,5147,5467,9.563,19.721,1877,3.487,39.442,796,804,4404
1995,4854,3257,4253,143094,140128,344,8.095,337,7.93,21771,5541,16230,3.954,15.537,15515,7040,8475,5.024,11.072,6256,4.464,22.144,265,272,2968
1995,4855,1164,1275,28040,27336,136,10.7,128,10.071,4989,1429,3560,5.228,18.251,3618,1179,2439,4.313,13.236,1371,5.015,26.471,93,93,834
1995,4859,1662,1775,34868,32753,369,21.932,184,10.936,8727,3941,4786,12.033,26.645,4595,2002,2593,6.113,14.029,4132,12.616,28.059,147,149,1455
1995,4861,51,399,9328,9482,51,13.212,25,6.477,1712,750,962,7.91,18.056,2008,250,1758,2.637,21.178,-296,-3.122,36.112,(D),(D),(D)
1995,4862,157,1432,37397,37865,68,4.726,82,5.698,3064,1577,1487,4.165,8.092,4098,623,3475,1.645,10.823,-1034,-2.731,16.184,11,12,157
1995,4869,59,565,6402,6143,165,33.537,19,3.862,1329,1067,262,17.369,21.634,845,123,722,2.002,13.755,484,7.879,27.511,4,4,10
1995,4871,341,378,7140,6956,54,14.362,50,13.298,1356,274,1082,3.939,19.495,993,442,551,6.355,14.276,363,5.219,28.553,36,36,288
1995,4872,1202,1235,12098,11846,194,15.941,158,12.983,2551,767,1784,6.475,21.536,2087,925,1162,7.809,17.619,464,3.917,35.237,121,121,632
1995,4879,129,133,1215,1126,25,19.011,22,16.73,335,148,187,13.15,29.765,153,56,97,4.976,13.594,182,16.171,27.188,17,17,42
1995,4881,2641,3432,96062,92580,586,17.624,372,11.188,20006,8312,11694,8.978,21.609,13089,5142,7947,5.554,14.138,6917,7.471,28.276,243,246,2015
1995,4882,476,755,19702,18977,111,15.02,79,10.69,4558,2168,2390,11.425,24.019,3071,1229,1842,6.476,16.183,1487,7.836,32.366,50,52,493
1995,4883,2010,2571,82559,82269,246,9.568,246,9.568,13309,3254,10055,3.955,16.178,12609,3263,9346,3.966,15.327,700,0.851,30.653,171,175,2278
1995,4884,4617,4789,33602,32640,760,16.246,538,11.501,7650,3292,4358,10.086,23.438,5700,2775,2925,8.502,17.463,1950,5.974,34.926,420,421,1527
1995,4885,9682,12871,126127,120564,1766,14.038,1184,9.412,27010,9658,17352,8.011,22.403,15952,6498,9454,5.39,13.231,11058,9.172,26.462,859,894,4270
1995,4889,789,838,10239,10155,129,15.366,132,15.724,1985,698,1287,6.873,19.547,1859,847,1012,8.341,18.306,126,1.241,36.613,97,108,710
1995,4921,1647,4634,427436,406632,690,15.289,448,9.927,58941,8764,50177,2.155,14.495,17469,7021,10448,1.727,4.296,41472,10.199,8.592,266,270,2225
1995,4922,4038,4426,64600,63878,818,18.935,606,14.028,13403,4505,8898,7.053,20.982,11941,5913,6028,9.257,18.694,1462,2.289,37.387,506,508,4448
1995,4931,6598,10921,463262,450123,1039,9.611,819,7.576,80860,24212,56648,5.379,17.964,54568,15004,39564,3.333,12.123,26292,5.841,24.246,329,333,3730
1995,5111,15719,18501,691203,685729,2085,11.387,1705,9.311,68925,19869,49056,2.898,10.051,57491,21439,36052,3.126,8.384,11434,1.667,16.768,1319,1328,8482
1995,5112,6240,7687,167951,158091,1610,21.993,877,11.98,49442,24130,25312,15.263,31.274,29388,9852,19536,6.232,18.589,20054,12.685,37.179,535,546,5912
1995,5121,10964,15326,242140,230199,2173,14.377,1750,11.578,61794,30786,31008,13.374,26.844,39202,12652,26550,5.496,17.03,22592,9.814,34.059,1132,1166,7995
1995,5122,1927,1972,14018,13547,399,20.939,266,13.96,3794,1951,1843,14.402,28.007,2946,1626,1320,12.003,21.747,848,6.26,43.495,208,209,1155
1995,5151,6332,8274,243726,244274,969,11.82,817,9.966,37173,14126,23047,5.783,15.218,37578,12437,25141,5.091,15.384,-405,-0.166,30.436,586,632,8228
1995,5152,227,420,18160,17083,57,13.971,33,8.088,3403,1112,2291,6.51,19.921,1259,640,619,3.747,7.37,2144,12.551,14.74,25,25,243
1995,5173,6576,29316,1041697,1027854,3546,12.223,2937,10.124,173285,57468,115817,5.591,16.859,146093,41910,104183,4.077,14.213,27192,2.646,28.427,729,772,8574
1995,5174,276,376,8468,7669,95,27.536,33,9.565,2767,1333,1434,17.382,36.08,1234,361,873,4.707,16.091,1533,19.99,32.182,19,19,161
1995,5179,1948,2662,37289,38627,794,32.146,410,16.599,12106,6151,5955,15.924,31.341,15224,4760,10464,12.323,39.413,-3118,-8.072,62.682,188,199,1413
1995,5182,5004,7811,324305,308209,1529,20.519,810,10.87,65874,26511,39363,8.602,21.373,34425,9678,24747,3.14,11.169,31449,10.204,22.339,451,454,4565
1995,5191,2602,3061,35110,35051,292,9.677,205,6.794,4981,2065,2916,5.891,14.211,4770,2043,2727,5.829,13.609,211,0.602,27.217,159,160,939
1995,5211,14,46,22633,22834,(D),(D),3,6.452,525,(D),461,(D),2.299,947,81,866,0.355,4.147,-422,-1.848,4.598,3,3,81
1995,5221,20694,98908,1952873,1957299,6461,6.556,5745,5.83,244496,85544,158952,4.371,12.491,251557,79548,172009,4.064,12.852,-7061,-0.361,24.983,715,1476,22591
1995,5222,15256,39272,470574,480744,6734,17.625,4606,12.055,95127,48426,46701,10.073,19.787,115913,39606,76307,8.238,24.111,-20786,-4.324,39.575,1835,1966,14456
1995,5223,8434,11475,100626,104867,2104,18.202,2272,19.656,26370,15058,11312,14.359,25.146,34367,14377,19990,13.71,32.772,-7997,-7.626,50.293,1533,1602,10934
1995,5231,8241,24365,383054,381925,4134,17.607,2363,10.064,64437,26325,38112,6.893,16.872,61740,15747,45993,4.123,16.165,2697,0.706,32.331,783,824,5686
1995,5232,32,51,6636,6548,8,16.162,5,10.101,451,21,430,0.321,6.888,245,233,12,3.558,3.742,206,3.146,7.483,5,5,233
1995,5239,18436,20281,177870,175537,3439,17.218,2823,14.134,41114,18575,22539,10.582,23.422,36412,16549,19863,9.428,20.743,4702,2.679,41.486,1951,1969,9273
1995,5241,4253,37871,1473687,1488294,3976,10.631,3033,8.11,162465,52375,110090,3.519,10.916,190581,44513,146068,2.991,12.805,-28116,-1.889,21.832,294,318,5541
1995,5242,107229,118299,696019,691712,11647,9.913,10025,8.533,111198,41595,69603,6.013,16.076,102927,38670,64257,5.59,14.88,8271,1.196,29.76,7225,7363,25527
1995,5259,582,631,20357,19236,62,9.59,93,14.385,3389,1006,2383,5.23,17.618,1132,621,511,3.228,5.885,2257,11.734,11.77,59,59,215
1995,5311,88893,96763,504367,500532,10915,11.328,10102,10.484,96478,45181,51297,9.027,19.275,89176,40770,48406,8.145,17.816,7302,1.459,35.632,7922,8053,29843
1995,5312,45294,50983,235627,233054,7654,15.155,6699,13.264,53645,23033,30612,9.883,23.018,48243,21332,26911,9.153,20.7,5402,2.318,41.401,4781,4858,14673
1995,5313,33506,39121,394393,391742,6778,17.847,4494,11.833,86285,46475,39810,11.864,22.026,79889,23935,55954,6.11,20.393,6396,1.633,40.787,3220,3303,16846
1995,5321,4859,9904,137032,133306,1126,11.473,947,9.649,22083,5438,16645,4.079,16.566,14655,4844,9811,3.634,10.994,7428,5.572,21.987,548,580,2474
1995,5322,20476,30732,249842,240260,4414,14.494,3856,12.662,63947,22573,41374,9.395,26.616,45581,20172,25409,8.396,18.972,18366,7.644,37.943,2795,3047,14722
1995,5323,3929,6273,43108,42282,496,7.958,416,6.674,7271,2059,5212,4.87,17.197,5568,2142,3426,5.066,13.169,1703,4.028,26.338,279,296,1594
1995,5324,7418,10071,114940,112583,1180,11.807,1026,10.266,22294,7010,15284,6.227,19.802,17605,6313,11292,5.607,15.637,4689,4.165,31.275,635,666,3496
1995,5331,1658,1814,20568,19513,327,18.686,199,11.371,5776,2568,3208,13.16,29.601,3584,1548,2036,7.933,18.367,2192,11.234,36.734,139,139,790
1995,5411,150250,156983,1005222,1009989,15451,9.937,12450,8.007,123873,43154,80719,4.273,12.265,133379,38176,95203,3.78,13.206,-9506,-0.941,24.53,9251,9350,28172
1995,5412,80865,85525,786094,766458,9998,11.835,7908,9.361,135997,53934,82063,7.037,17.744,98076,31036,67040,4.049,12.796,37921,4.948,25.592,5773,5821,22797
1995,5413,71288,80327,1010433,991837,11064,14.102,7319,9.329,179930,54905,125025,5.536,18.141,142412,40731,101681,4.107,14.358,37518,3.783,28.717,5038,5119,21754
1995,5414,19689,19897,106325,101935,3752,19.393,2653,13.712,28013,12165,15848,11.934,27.481,19091,8275,10816,8.118,18.729,8922,8.753,37.457,2067,2074,6498
1995,5415,38168,43162,566197,530492,11117,27.557,5477,13.576,157899,63870,94029,12.04,29.765,85995,33226,52769,6.263,16.21,71904,13.554,32.421,3656,3713,16231
1995,5416,46627,49592,457026,438760,10211,21.223,7252,15.073,115780,42366,73414,9.656,26.388,79045,30853,48192,7.032,18.016,36735,8.372,36.031,5523,5586,21818
1995,5417,7897,9927,453587,456224,1477,15.301,929,9.624,54342,18182,36160,3.985,11.911,59824,16577,43247,3.634,13.113,-5482,-1.202,23.823,556,559,3875
1995,5418,30388,33232,395786,386982,4951,15.182,3709,11.373,75095,22521,52574,5.82,19.405,57455,20588,36867,5.32,14.847,17640,4.558,29.694,2913,2955,14197
1995,5419,37892,43433,380111,370358,4344,10.149,3080,7.196,74059,20144,53915,5.439,19.997,54676,16934,37742,4.572,14.763,19383,5.234,29.526,2152,2180,10031
1995,5511,28605,51880,3226956,3189239,4917,9.518,4477,8.666,533226,171349,361877,5.373,16.72,458504,127946,330558,4.012,14.377,74722,2.343,28.753,1001,1037,12416
1995,5611,17078,18550,340756,331932,3707,20.729,2373,13.27,90643,36998,53645,11.146,27.308,72402,38173,34229,11.5,21.812,18241,5.495,43.625,1818,1835,22209
1995,5612,694,1261,75181,74100,275,23.514,92,7.867,15189,7045,8144,9.507,20.498,13052,4940,8112,6.667,17.614,2137,2.884,35.228,32,33,498
1995,5613,21371,32183,2531388,2373088,6071,19.691,3367,10.921,808223,298052,510171,12.56,34.058,489370,142560,346810,6.007,20.622,318853,13.436,41.243,2276,2350,96226
1995,5614,25668,29534,459177,437695,4602,15.825,3695,12.706,110437,39184,71253,8.952,25.231,67620,23499,44121,5.369,15.449,42817,9.782,30.898,2922,2958,17400
1995,5615,25947,32562,272903,267568,3890,12.076,3189,9.9,49068,18165,30903,6.789,18.339,38968,14643,24325,5.473,14.564,10100,3.775,29.128,2156,2439,11023
1995,5616,14501,17892,602771,585222,2601,14.757,2067,11.728,120840,36719,84121,6.274,20.649,84981,27221,57760,4.651,14.521,35859,6.127,29.042,1513,1528,15022
1995,5617,105896,110634,1253887,1225503,20421,18.949,14692,13.633,277986,95688,182298,7.808,22.683,221409,80516,140893,6.57,18.067,56577,4.617,36.134,11688,11709,57453
1995,5619,19320,21103,311047,300190,4013,19.681,2587,12.688,82184,27624,54560,9.202,27.377,60340,21817,38523,7.268,20.101,21844,7.277,40.201,2028,2055,13386
1995,5621,5444,6001,95142,89675,823,14.36,283,4.938,17763,5214,12549,5.814,19.808,6899,1724,5175,1.922,7.693,10864,12.115,15.387,209,209,1265
1995,5622,1768,2741,93453,91934,332,12.296,250,9.259,14847,3793,11054,4.126,16.15,11734,3793,7941,4.126,12.764,3113,3.386,25.527,156,163,1371
1995,5629,5151,5592,81705,80252,768,13.952,593,10.773,18026,5338,12688,6.652,22.462,14955,3919,11036,4.883,18.635,3071,3.827,37.27,456,460,2856
1995,6111,14671,16836,590112,576623,801,4.807,455,2.731,59432,10003,49429,1.735,10.307,32496,5909,26587,1.025,5.636,26936,4.671,11.271,326,326,4457
1995,6112,557,825,73495,73895,31,3.713,51,6.108,5057,651,4406,0.881,6.844,5924,776,5148,1.05,8.017,-867,-1.173,13.687,32,43,637
1995,6113,2137,2572,1178965,1171593,128,5.012,92,3.602,69876,2097,67779,0.179,5.964,55129,2556,52573,0.218,4.705,14747,1.259,9.411,60,62,1500
1995,6114,4229,4653,51101,50730,948,21.203,584,13.062,11774,4570,7204,9.009,23.209,11069,4865,6204,9.59,21.82,705,1.39,43.639,408,452,3510
1995,6115,5115,5952,64725,63425,710,12.115,527,8.992,12044,4618,7426,7.281,18.989,9493,2964,6529,4.673,14.967,2551,4.022,29.935,355,374,2156
1995,6116,17795,18932,145213,140590,3349,18.295,2097,11.455,34627,15062,19565,10.713,24.63,25144,8982,16162,6.389,17.885,9483,6.745,35.769,1648,1667,7255
1995,6117,2843,2974,25700,24732,577,19.914,424,14.633,6105,2683,3422,10.849,24.685,4284,1722,2562,6.963,17.322,1821,7.363,34.644,327,327,1336
1995,6211,173709,189021,1608686,1591589,13677,7.18,16599,8.714,265361,96599,168762,6.069,16.673,231144,95849,135295,6.022,14.523,34217,2.15,29.046,13308,13648,72052
1995,6212,104006,107217,613593,602050,5081,4.765,3917,3.673,83044,20688,62356,3.436,13.794,59785,14967,44818,2.486,9.93,23259,3.863,19.86,3204,3255,12646
1995,6213,71332,75603,346637,332974,8504,11.421,6223,8.357,80878,35199,45679,10.571,24.29,53791,20426,33365,6.134,16.155,27087,8.135,32.309,4729,4848,16486
1995,6214,8898,15843,347853,332029,1949,12.626,1136,7.359,69560,28290,41270,8.52,20.95,37569,11655,25914,3.51,11.315,31991,9.635,22.63,713,785,7068
1995,6215,5328,8342,144767,142475,1260,15.322,1023,12.44,28955,12957,15998,9.094,20.323,23932,13674,10258,9.597,16.797,5023,3.526,33.595,671,713,7662
1995,6216,7727,13658,746846,710442,2798,21.677,1297,10.048,179903,66430,113473,9.351,25.323,107720,34303,73417,4.828,15.162,72183,10.16,30.325,616,644,11429
1995,6219,5456,7408,170670,167376,770,10.399,763,10.305,32212,9923,22289,5.929,19.245,25509,11291,14218,6.746,15.241,6703,4.005,30.481,550,566,7920
1995,6221,2913,4621,4120131,4133851,136,2.946,128,2.772,183974,44128,139846,1.067,4.45,210563,50255,160308,1.216,5.094,-26589,-0.643,8.901,71,74,34702
1995,6222,592,922,303174,302723,55,5.898,76,8.15,18768,2674,16094,0.883,6.2,17534,8269,9265,2.732,5.792,1234,0.408,11.584,27,29,3955
1995,6223,258,390,131874,130203,32,8.41,13,3.417,9162,1801,7361,1.383,7.037,5720,1461,4259,1.122,4.393,3442,2.644,8.786,7,7,740
1995,6231,8217,14655,1457846,1435600,966,6.634,777,5.336,161796,60847,100949,4.238,11.27,118282,54446,63836,3.793,8.239,43514,3.031,16.478,476,512,31398
1995,6232,7479,17067,337545,327158,1812,11.053,465,2.836,54250,19368,34882,5.92,16.582,33487,6697,26790,2.047,10.236,20763,6.346,20.471,284,296,4401
1995,6233,11211,13410,338681,331519,1904,14.534,1285,9.809,46724,17457,29267,5.266,14.094,32393,14451,17942,4.359,9.771,14331,4.323,19.542,852,910,10854
1995,6239,4086,6026,156900,152028,542,9.137,354,5.968,21747,6461,15286,4.25,14.305,12068,3700,8368,2.434,7.938,9679,6.367,15.876,230,238,2310
1995,6241,24649,33978,528682,508531,3816,11.557,1900,5.754,89939,27599,62340,5.427,17.686,49894,10468,39426,2.058,9.811,40045,7.875,19.623,1283,1316,6439
1995,6242,6557,8023,82989,81655,785,10.001,438,5.58,13299,4457,8842,5.458,16.287,10522,2036,8486,2.493,12.886,2777,3.401,25.772,318,318,1465
1995,6243,5461,8572,319885,315980,585,6.857,503,5.896,45105,7357,37748,2.328,14.275,37446,4455,32991,1.41,11.851,7659,2.424,23.702,280,299,2472
1995,6244,43604,53560,567922,552264,6758,12.877,4603,8.771,101484,40332,61152,7.303,18.376,70109,24195,45914,4.381,12.695,31375,5.681,25.39,3632,3691,18913
1995,7111,6891,6966,101266,101598,1249,18.318,954,13.991,22361,8884,13477,8.744,22.009,22924,5364,17560,5.28,22.564,-563,-0.554,44.019,685,687,4002
1995,7112,2836,2957,79057,79330,470,15.962,445,15.113,13553,3595,9958,4.532,17.084,14121,2721,11400,3.43,17.8,-568,-0.716,34.169,349,352,1926
1995,7113,2836,2964,56435,56050,477,16.35,384,13.162,13878,5735,8143,10.232,24.76,13122,4104,9018,7.322,23.411,756,1.349,46.822,300,301,3480
1995,7114,1806,1845,13353,13215,326,18.289,201,11.276,3229,1542,1687,11.669,24.434,2928,1318,1610,9.974,22.157,301,2.278,44.313,145,145,891
1995,7115,7265,7293,35858,34419,1429,20.098,1063,14.951,11537,4898,6639,14.231,33.52,8657,3608,5049,10.483,25.152,2880,8.368,50.304,674,675,2327
1995,7121,3587,3919,77678,76194,364,9.524,170,4.448,8866,1766,7100,2.318,11.636,5912,932,4980,1.223,7.759,2954,3.877,15.518,110,110,647
1995,7131,1649,2814,112696,107280,480,17.725,268,9.897,23729,11778,11951,10.979,22.119,12285,4286,7999,3.995,11.451,11444,10.667,22.903,191,195,1311
1995,7132,1369,1633,94544,83010,305,19.825,116,7.54,31063,10946,20117,13.186,37.421,8592,1514,7078,1.824,10.351,22471,27.07,20.701,88,90,761
1995,7139,42746,46106,768980,751654,5524,12.13,4389,9.638,140117,55170,84947,7.34,18.641,105287,35533,69754,4.727,14.007,34830,4.634,28.015,3429,3488,26839
1995,7211,31453,38314,1488979,1475454,4314,11.382,3487,9.2,218982,100311,118671,6.799,14.842,191758,84301,107457,5.714,12.997,27224,1.845,25.993,2387,2451,48111
1995,7212,4707,5093,33163,32714,553,10.996,425,8.451,6421,1819,4602,5.56,19.628,5531,1472,4059,4.5,16.907,890,2.721,33.815,276,280,860
1995,7213,3067,3162,15596,15507,248,7.768,309,9.679,2962,1115,1847,7.19,19.101,2763,1269,1494,8.183,17.818,199,1.283,35.636,227,228,919
1995,7223,14137,27466,519722,523832,4279,15.352,5091,18.266,112580,56140,56440,10.717,21.492,121277,65016,56261,12.412,23.152,-8697,-1.66,42.983,2801,2881,26473
1995,7224,49629,50154,329738,325333,7022,13.993,7079,14.107,85575,43656,41919,13.419,26.304,76764,36769,39995,11.302,23.596,8811,2.708,47.191,5865,5878,31077
1995,7225,248802,339487,6457873,6314032,48817,14.618,37729,11.298,1346195,713155,633040,11.295,21.321,1061938,419542,642396,6.645,16.819,284257,4.502,33.637,28122,29229,282703
1995,8111,131400,142156,766754,744905,17922,12.775,14200,10.122,156654,65636,91018,8.811,21.03,113057,47385,65672,6.361,15.177,43597,5.853,30.355,10841,11051,36756
1995,8112,13535,16128,141560,136999,2046,12.765,1846,11.517,31403,13060,18343,9.533,22.922,21709,8168,13541,5.962,15.846,9694,7.076,31.692,1237,1285,5201
1995,8113,21585,22887,185096,178976,2692,11.901,2156,9.532,36121,11161,24960,6.236,20.182,24036,8761,15275,4.895,13.43,12085,6.752,26.859,1653,1659,6165
1995,8114,26298,27955,165516,167522,3708,13.238,3817,13.628,29007,10560,18447,6.304,17.315,32385,12145,20240,7.25,19.332,-3378,-2.016,34.631,3018,3038,9231
1995,8121,76230,87130,458274,454474,11006,12.665,10541,12.13,89736,40732,49004,8.962,19.745,82356,35565,46791,7.826,18.121,7380,1.624,36.242,8319,8617,28796
1995,8122,16505,21261,148226,143312,1626,7.742,1110,5.285,27182,11391,15791,7.948,18.967,16803,5327,11476,3.717,11.725,10379,7.242,23.45,731,778,3923
1995,8123,34752,41583,385990,381957,4267,10.25,4360,10.473,57362,20243,37119,5.3,15.018,49505,20594,28911,5.392,12.961,7857,2.057,25.922,3264,3428,15458
1995,8129,15401,24394,176015,173126,3563,14.85,2763,11.515,41625,18198,23427,10.511,24.043,34926,12629,22297,7.295,20.174,6699,3.869,40.348,1587,1686,6929
1995,8131,146934,147050,1322928,1297110,8606,5.927,4913,3.384,157807,23885,133922,1.841,12.166,105813,14503,91310,1.118,8.158,51994,4.008,16.315,3097,3097,9689
1995,8132,11074,12841,167922,160652,957,7.524,714,5.613,28740,9537,19203,5.936,17.89,14713,3567,11146,2.22,9.158,14027,8.731,18.317,482,494,2283
1995,8133,10151,11912,132055,129338,1015,8.632,707,6.013,19948,4167,15781,3.222,15.423,14567,3111,11456,2.405,11.263,5381,4.16,22.526,451,453,1975
1995,8134,31312,33212,326385,329453,1674,5.038,1708,5.14,40508,7652,32856,2.323,12.296,45995,6005,39990,1.823,13.961,-5487,-1.665,24.591,1234,1237,4264
1995,8139,63793,65932,503304,505764,3958,5.984,4377,6.618,65870,15477,50393,3.06,13.024,70881,20807,50074,4.114,14.015,-5011,-0.991,26.048,3232,3243,15068
1996,1131,225,277,2804,2835,31,11.232,29,10.507,599,244,355,8.607,21.129,682,133,549,4.691,24.056,-83,-2.928,42.257,23,23,115
1996,1132,128,162,1928,1671,37,24.503,15,9.934,759,353,406,21.131,45.435,260,58,202,3.472,15.564,499,29.871,31.128,8,8,31
1996,1133,12042,12123,84445,84741,1670,13.734,1744,14.342,16996,6415,10581,7.57,20.056,17660,6191,11469,7.306,20.84,-664,-0.784,40.113,1321,1322,4787
1996,1141,1240,1251,9594,9284,226,18.389,182,14.809,2734,690,2044,7.432,29.449,2182,877,1305,9.446,23.503,552,5.946,47.006,115,115,373
1996,1142,223,228,1718,1740,34,15.145,27,12.027,237,66,171,3.793,13.621,270,55,215,3.161,15.517,-33,-1.897,27.241,19,19,37
1996,1151,4501,4817,58190,58592,572,11.923,533,11.11,11017,3719,7298,6.347,18.803,11807,3190,8617,5.444,20.151,-790,-1.348,37.606,406,410,2175
1996,1152,2575,2609,16218,15984,421,16.468,316,12.361,3293,1429,1864,8.94,20.602,2810,1139,1671,7.126,17.58,483,3.022,35.16,256,256,975
1996,1153,1145,1179,14132,14089,187,15.99,168,14.365,2866,690,2176,4.898,20.343,2709,769,1940,5.458,19.228,157,1.114,38.457,124,124,497
1996,2111,6304,7484,92283,95208,641,8.439,864,11.375,12774,4498,8276,4.724,13.417,18977,7567,11410,7.948,19.932,-6203,-6.515,26.834,576,582,2291
1996,2121,1108,1536,85350,89689,180,11.046,367,22.522,10829,3618,7211,4.034,12.074,19347,8150,11197,9.087,21.571,-8518,-9.497,24.148,247,249,4534
1996,2122,344,491,42461,42572,64,13.061,62,12.653,4356,428,3928,1.005,10.232,4375,1840,2535,4.322,10.277,-19,-0.045,20.464,35,35,1263
1996,2123,3315,5050,97465,98262,335,6.638,329,6.519,11375,2452,8923,2.495,11.576,12863,4396,8467,4.474,13.091,-1488,-1.514,23.153,214,215,1405
1996,2131,7020,8093,148256,147061,943,11.578,1047,12.855,32297,7383,24914,5.02,21.962,30146,12199,17947,8.295,20.499,2151,1.463,40.998,744,766,7608
1996,2211,1573,7672,553226,565833,670,8.951,297,3.968,36874,20146,16728,3.56,6.517,61819,4041,57778,0.714,10.925,-24945,-4.409,13.034,49,49,510
1996,2212,604,2740,104325,105683,208,7.588,210,7.661,9405,3439,5966,3.254,8.899,12231,3494,8737,3.306,11.573,-2826,-2.674,17.799,40,45,452
1996,2213,4094,4540,34310,33700,318,7.059,248,5.505,4119,1590,2529,4.718,12.223,2893,1121,1772,3.326,8.585,1226,3.638,17.169,168,170,665
1996,2361,124260,124896,643711,640217,22460,18.122,20550,16.58,176182,71316,104866,11.139,27.519,168900,67931,100969,10.611,26.382,7282,1.137,52.763,14932,14933,52746
1996,2362,37823,38516,640650,630294,5203,13.669,4299,11.294,140383,31151,109232,4.942,22.273,119555,28140,91415,4.465,18.968,20828,3.304,37.936,3180,3181,21075
1996,2371,14710,15020,333795,333101,1445,9.714,1157,7.778,64447,16576,47871,4.976,19.348,64648,10698,53950,3.212,19.408,-201,-0.06,38.695,868,870,7554
1996,2372,8529,8715,63605,63346,1828,21.531,1378,16.231,16254,7147,9107,11.282,25.659,15642,6181,9461,9.758,24.693,612,0.966,49.386,1050,1058,4261
1996,2373,9826,10244,233563,230389,921,9.024,846,8.289,44354,7916,36438,3.436,19.252,37948,7502,30446,3.256,16.471,6406,2.781,32.943,614,615,5505
1996,2379,4690,4754,71996,71004,609,12.745,658,13.77,15025,3898,11127,5.49,21.161,13105,3503,9602,4.934,18.457,1920,2.704,36.914,508,509,2677
1996,2381,85016,85434,767236,750773,11939,14.086,10585,12.489,193665,53382,140283,7.11,25.795,160754,49609,111145,6.608,21.412,32911,4.384,42.824,8068,8069,40438
1996,2382,133647,135576,1399473,1367973,16037,11.981,12593,9.408,276199,65243,210956,4.769,20.19,213255,58111,155144,4.248,15.589,62944,4.601,31.178,9587,9592,45355
1996,2383,89771,90273,680969,672526,15014,16.775,13473,15.053,173650,55011,118639,8.18,25.821,156554,53443,103111,7.947,23.279,17096,2.542,46.557,10308,10321,43418
1996,2389,45326,45567,365998,359506,6397,14.202,5347,11.871,84636,24723,59913,6.877,23.542,71631,22111,49520,6.15,19.925,13005,3.617,39.85,4018,4019,17384
1996,3111,1098,1727,46222,46403,72,4.139,97,5.576,4932,1941,2991,4.183,10.629,5284,1300,3984,2.802,11.387,-352,-0.759,21.257,63,63,351
1996,3112,474,835,62685,64626,54,6.534,37,4.477,3920,1227,2693,1.899,6.066,7760,1351,6409,2.091,12.008,-3840,-5.942,12.131,26,26,421
1996,3113,1478,1651,82565,83821,143,8.573,177,10.612,7453,1492,5961,1.78,8.892,9897,1812,8085,2.162,11.807,-2444,-2.916,17.783,128,129,1009
1996,3114,1253,1667,171098,173485,104,6.203,123,7.337,13651,2846,10805,1.64,7.869,18584,3868,14716,2.23,10.712,-4933,-2.843,15.737,88,89,1780
1996,3115,1222,1727,129604,130238,82,4.702,116,6.651,10453,969,9484,0.744,8.026,11865,4630,7235,3.555,9.11,-1412,-1.084,16.052,70,72,1607
1996,3116,3361,3979,457367,448389,250,6.274,261,6.55,46524,7325,39199,1.634,10.376,28136,6831,21305,1.523,6.275,18388,4.101,12.55,193,193,2486
1996,3117,623,733,41690,42192,67,9.005,89,11.962,5546,1402,4144,3.323,13.145,6601,1957,4644,4.638,15.645,-1055,-2.5,26.289,65,65,1382
1996,3118,9357,10216,312841,310841,1205,11.737,1306,12.721,44378,10704,33674,3.444,14.277,40883,15534,25349,4.997,13.152,3495,1.124,26.305,923,943,7957
1996,3119,2191,2573,133716,135039,204,7.912,215,8.338,13364,2991,10373,2.215,9.896,15909,5723,10186,4.238,11.781,-2545,-1.885,19.793,166,167,2884
1996,3121,1844,2266,133042,132160,232,10.436,146,6.568,13986,2830,11156,2.141,10.583,12160,3986,8174,3.016,9.201,1826,1.382,18.402,103,104,1702
1996,3122,67,98,28723,28492,6,6.186,4,4.124,2270,126,2144,0.442,7.967,1723,859,864,3.015,6.047,547,1.92,12.095,(D),(D),(D)
1996,3131,355,588,80588,85133,32,5.365,49,8.215,3402,476,2926,0.559,3.996,12454,3596,8858,4.224,14.629,-9052,-10.633,7.992,31,31,685
1996,3132,1682,2041,222681,231683,167,8.134,191,9.303,12322,4229,8093,1.825,5.318,30265,7530,22735,3.25,13.063,-17943,-7.745,10.637,141,141,2522
1996,3133,2660,2874,109347,113086,371,12.945,355,12.387,9059,3129,5930,2.767,8.011,16701,4539,12162,4.014,14.768,-7642,-6.758,16.021,295,295,2385
1996,3141,2796,3062,118600,122205,283,9.076,395,12.668,9825,2587,7238,2.117,8.04,17057,4884,12173,3.997,13.958,-7232,-5.918,16.08,306,333,3078
1996,3149,4251,4387,111164,114276,569,13.073,500,11.488,16269,5662,10607,4.955,14.237,22715,9007,13708,7.882,19.877,-6446,-5.641,28.473,414,418,5907
1996,3151,1074,1190,108247,112208,112,9.226,160,13.18,10069,3593,6476,3.202,8.974,18018,6343,11675,5.653,16.058,-7949,-7.084,17.947,123,123,2648
1996,3152,10713,11621,548933,576215,2033,17.219,2405,20.369,79994,36109,43885,6.267,13.883,133844,57257,76587,9.937,23.228,-53850,-9.345,27.765,2051,2073,37260
1996,3159,1800,1919,56342,58617,224,11.487,286,14.667,6423,2176,4247,3.712,10.958,10900,2876,8024,4.906,18.595,-4477,-7.638,21.915,234,235,2418
1996,3161,305,333,15200,15516,32,9.624,31,9.323,1330,504,826,3.248,8.572,1938,354,1584,2.282,12.491,-608,-3.919,17.144,25,25,281
1996,3162,310,381,45994,50329,30,7.653,52,13.265,2087,295,1792,0.586,4.147,10813,3354,7459,6.664,21.485,-8726,-17.338,8.293,36,36,684
1996,3169,985,1019,29657,30772,89,8.62,116,11.235,2777,537,2240,1.745,9.024,5077,1800,3277,5.849,16.499,-2300,-7.474,18.049,89,89,908
1996,3211,4167,4659,125203,128958,312,6.595,456,9.639,10845,2748,8097,2.131,8.41,18332,5222,13110,4.049,14.215,-7487,-5.806,16.819,369,370,3284
1996,3212,1383,1734,111774,110213,114,6.607,97,5.622,11584,3365,8219,3.053,10.511,8464,1631,6833,1.48,7.68,3120,2.831,15.359,70,70,1083
1996,3219,9363,10110,305745,305885,994,9.815,1028,10.151,39561,10437,29124,3.412,12.933,39733,11601,28132,3.793,12.99,-172,-0.056,25.867,820,823,7400
1996,3221,220,536,178257,179795,8,1.473,22,4.052,5053,467,4586,0.26,2.81,7918,1644,6274,0.914,4.404,-2865,-1.593,5.621,9,9,145
1996,3222,3554,5231,396168,401004,284,5.457,231,4.438,26629,7717,18912,1.924,6.641,36334,9429,26905,2.351,9.061,-9705,-2.42,13.281,152,154,3425
1996,3231,39737,41671,824184,829771,2908,6.915,3673,8.734,81592,20151,61441,2.429,9.833,92731,29857,62874,3.598,11.175,-11139,-1.342,19.666,3035,3040,18821
1996,3241,1093,2046,116246,119218,114,5.599,94,4.617,6759,1454,5305,1.22,5.669,12630,3516,9114,2.949,10.594,-5871,-4.925,11.339,54,55,2157
1996,3251,1141,2314,210862,211670,129,5.562,140,6.036,14745,3916,10829,1.85,6.966,16398,5652,10746,2.67,7.747,-1653,-0.781,13.932,69,69,790
1996,3252,413,716,118692,120682,49,6.931,31,4.385,5330,1351,3979,1.119,4.417,9383,1243,8140,1.03,7.775,-4053,-3.358,8.833,18,18,771
1996,3253,629,891,38944,39419,56,6.26,63,7.043,2452,551,1901,1.398,6.22,3350,652,2698,1.654,8.499,-898,-2.278,12.441,41,42,388
1996,3254,1189,1477,199213,197929,141,9.717,89,6.134,17068,3533,13535,1.785,8.623,14624,2676,11948,1.352,7.389,2444,1.235,14.777,49,49,666
1996,3255,1566,2036,72280,72183,137,6.735,133,6.539,7008,1876,5132,2.599,9.709,6669,2325,4344,3.221,9.239,339,0.47,18.478,86,86,885
1996,3256,2024,2242,119135,119144,152,6.744,176,7.808,11893,1747,10146,1.466,9.982,12023,3712,8311,3.116,10.091,-130,-0.109,19.964,125,126,1965
1996,3259,2238,2939,125616,127067,198,6.757,181,6.176,9259,1901,7358,1.496,7.287,12094,2044,10050,1.609,9.518,-2835,-2.231,14.573,119,119,1001
1996,3261,10623,12983,765584,768550,955,7.396,815,6.311,81236,20125,61111,2.619,10.57,87293,19739,67554,2.568,11.358,-6057,-0.788,21.14,598,608,10466
1996,3262,2145,2663,198704,198847,228,8.669,162,6.16,16020,5487,10533,2.759,8.056,16378,4293,12085,2.159,8.237,-358,-0.18,16.113,117,121,2408
1996,3271,1540,1814,77649,79276,174,9.643,155,8.59,6669,1713,4956,2.161,8.412,9984,1875,8109,2.365,12.594,-3315,-4.182,16.825,118,118,756
1996,3272,1765,2034,135925,136592,209,10.38,168,8.344,10660,3362,7298,2.461,7.804,11914,3909,8005,2.862,8.722,-1254,-0.918,15.609,124,124,1470
1996,3273,5673,8797,180519,178541,593,6.762,539,6.146,25117,7224,17893,4.046,14.068,21164,5775,15389,3.235,11.854,3953,2.214,23.708,307,334,3160
1996,3274,268,381,18959,18615,33,8.719,28,7.398,1776,504,1272,2.707,9.541,1090,429,661,2.305,5.855,686,3.685,11.711,19,19,114
1996,3279,1996,2322,70516,70475,200,8.699,154,6.699,7688,2937,4751,4.167,10.909,7611,1830,5781,2.597,10.8,77,0.109,21.599,114,115,777
1996,3311,220,289,142894,142416,22,7.586,24,8.276,5991,3515,2476,2.468,4.207,4853,375,4478,0.263,3.408,1138,0.799,6.815,21,21,280
1996,3312,513,707,66995,67145,41,5.824,35,4.972,4253,978,3275,1.457,6.334,4559,1089,3470,1.622,6.79,-306,-0.456,12.668,26,26,586
1996,3313,356,524,84575,85519,25,4.794,20,3.835,5986,2649,3337,3.098,7,7723,3762,3961,4.399,9.031,-1737,-2.031,13.999,10,10,395
1996,3314,755,933,80303,79320,56,6.002,56,6.002,6306,1439,4867,1.814,7.95,4370,837,3533,1.055,5.509,1936,2.441,11.019,38,38,304
1996,3315,2368,2644,214926,214516,134,5.066,136,5.142,19471,5206,14265,2.427,9.077,18645,4335,14310,2.021,8.692,826,0.385,17.383,99,100,2498
1996,3321,3084,3290,140859,140147,176,5.361,162,4.935,13940,2437,11503,1.739,9.947,12664,3215,9449,2.294,9.036,1276,0.91,18.073,127,127,2110
1996,3322,1373,1514,76316,77155,83,5.495,76,5.031,4552,817,3735,1.059,5.9,6325,1236,5089,1.602,8.198,-1773,-2.298,11.8,55,55,538
1996,3323,10504,11287,346365,342857,836,7.438,742,6.601,43114,9243,33871,2.696,12.575,35904,10659,25245,3.109,10.472,7210,2.103,20.944,580,586,6160
1996,3324,1535,1862,106459,106294,105,5.66,91,4.906,10382,2039,8343,1.918,9.767,10000,2802,7198,2.636,9.408,382,0.359,18.816,58,58,1133
1996,3325,893,985,65721,67453,54,5.444,68,6.855,3588,719,2869,1.066,5.319,7162,1007,6155,1.493,10.618,-3574,-5.299,10.639,54,54,401
1996,3326,1545,1727,69579,70151,122,7.068,120,6.952,6415,2037,4378,2.904,9.145,7705,1925,5780,2.744,10.983,-1290,-1.839,18.289,88,89,1168
1996,3327,23742,24115,389919,382636,2071,8.706,1419,5.965,51649,11808,39841,3.086,13.498,37006,10176,26830,2.659,9.671,14643,3.827,19.343,1138,1141,7037
1996,3328,5485,5915,143217,142868,395,6.718,325,5.527,17461,4709,12752,3.296,12.222,16925,5319,11606,3.723,11.847,536,0.375,23.693,252,252,3128
1996,3329,5750,6260,314094,314246,421,6.742,389,6.23,27490,5396,22094,1.717,8.748,28155,5849,22306,1.861,8.96,-665,-0.212,17.496,303,304,3180
1996,3331,2729,2995,196358,197446,202,6.723,221,7.356,15059,2492,12567,1.262,7.627,17223,3701,13522,1.874,8.723,-2164,-1.096,15.254,170,170,1804
1996,3332,4081,4347,178841,174224,322,7.46,261,6.047,22887,3433,19454,1.97,13.137,13695,3814,9881,2.189,7.861,9192,5.276,15.721,201,204,2059
1996,3333,2377,2503,130663,126259,192,7.665,196,7.824,20705,10122,10583,8.017,16.399,12262,3157,9105,2.5,9.712,8443,6.687,19.424,147,149,1702
1996,3334,1541,1811,168755,167381,95,5.224,110,6.049,13874,1275,12599,0.762,8.289,11097,2604,8493,1.556,6.63,2777,1.659,13.26,85,85,2137
1996,3335,9667,10015,236579,232636,664,6.673,536,5.386,26185,5190,20995,2.231,11.256,18196,4870,13326,2.093,7.822,7989,3.434,15.643,427,428,3446
1996,3336,749,899,113168,115117,43,4.799,37,4.129,7281,1885,5396,1.637,6.325,11059,1078,9981,0.936,9.607,-3778,-3.282,12.65,25,25,184
1996,3339,5700,6335,335143,331743,450,7.155,358,5.692,33019,7088,25931,2.137,9.953,26282,8051,18231,2.427,7.922,6737,2.031,15.845,252,252,3329
1996,3341,1567,1668,196838,197775,199,12.006,178,10.739,23238,3560,19678,1.8,11.75,25100,6459,18641,3.266,12.691,-1862,-0.941,23.499,135,136,1774
1996,3342,1766,1970,232504,229092,159,8.026,181,9.137,28835,5461,23374,2.384,12.587,22167,7072,15095,3.087,9.676,6668,2.911,19.352,124,124,2675
1996,3343,496,529,34634,35601,83,16.275,45,8.824,4288,1195,3093,3.357,12.045,6266,2221,4045,6.239,17.601,-1978,-5.556,24.09,33,33,269
1996,3344,5176,5750,543618,527418,484,8.439,455,7.933,73192,10331,62861,1.959,13.877,40500,12198,28302,2.313,7.679,32692,6.199,15.358,347,348,3786
1996,3345,4532,5125,489620,494975,341,6.629,379,7.368,40344,10986,29358,2.22,8.151,50676,17580,33096,3.552,10.238,-10332,-2.087,16.301,271,272,3902
1996,3346,690,747,48163,48106,116,15.815,89,12.134,6695,1706,4989,3.546,13.917,6672,2386,4286,4.96,13.87,23,0.048,27.739,66,66,630
1996,3351,1110,1223,71419,72549,81,6.559,105,8.502,5642,1358,4284,1.872,7.777,7837,1396,6441,1.924,10.802,-2195,-3.026,15.554,83,85,635
1996,3352,326,398,106083,108184,26,6.452,36,8.933,5434,2112,3322,1.952,5.023,9509,2283,7226,2.11,8.79,-4075,-3.767,10.046,27,27,803
1996,3353,2218,2648,203440,204659,168,6.371,146,5.537,16535,2396,14139,1.171,8.079,18522,3625,14897,1.771,9.05,-1987,-0.971,16.159,101,102,1704
1996,3359,1807,2183,188439,189878,154,7.105,123,5.675,16120,2989,13131,1.574,8.49,18960,4579,14381,2.412,9.985,-2840,-1.496,16.979,76,78,1430
1996,3361,281,341,212034,218445,39,11.607,29,8.631,10257,1172,9085,0.537,4.695,23615,201,23414,0.092,10.811,-13358,-6.115,9.391,23,23,186
1996,3362,1699,1896,125864,129849,201,10.641,187,9.899,13896,4344,9552,3.345,10.702,21713,5327,16386,4.102,16.722,-7817,-6.02,21.403,152,152,3605
1996,3363,4370,5421,728515,737343,413,7.658,357,6.62,63159,22501,40658,3.052,8.566,81696,23690,58006,3.213,11.08,-18537,-2.514,17.132,244,244,5118
1996,3364,1342,1629,443009,449056,131,8.096,109,6.737,29574,11376,18198,2.533,6.586,41741,13250,28491,2.951,9.295,-12167,-2.709,13.172,70,70,771
1996,3365,178,239,30182,30243,20,8.547,10,4.274,2618,921,1697,3.045,8.657,2748,724,2024,2.394,9.087,-130,-0.43,17.313,5,5,78
1996,3366,1392,1512,136909,138904,175,11.725,136,9.112,13396,2814,10582,2.026,9.644,17175,3092,14083,2.226,12.365,-3779,-2.721,19.288,92,92,2355
1996,3369,591,622,36599,35818,100,16.625,59,9.809,6424,2815,3609,7.859,17.935,4858,2458,2400,6.863,13.563,1566,4.372,27.126,47,47,585
1996,3371,13363,13873,376036,380633,1541,11.044,1701,12.191,39317,11780,27537,3.095,10.329,48819,16525,32294,4.341,12.826,-9502,-2.496,20.659,1302,1314,10437
1996,3372,3405,3607,154715,156768,358,10,304,8.492,14991,4535,10456,2.893,9.563,19331,5056,14275,3.225,12.331,-4340,-2.768,19.125,232,234,3621
1996,3379,1034,1160,40425,40345,79,6.723,109,9.277,4688,960,3728,2.379,11.62,4539,1418,3121,3.515,11.25,149,0.369,22.501,89,90,927
1996,3391,10851,11425,270088,268120,974,8.569,858,7.548,30862,10118,20744,3.774,11.511,27142,8351,18791,3.115,10.123,3720,1.387,20.246,660,661,4591
1996,3399,16241,16795,413458,413413,1805,10.797,1651,9.876,53287,12880,40407,3.116,12.89,53247,14218,39029,3.439,12.88,40,0.01,25.76,1342,1346,10505
1996,4231,19559,24817,308247,308491,2697,10.888,2606,10.52,42483,13915,28568,4.511,13.771,43075,17033,26042,5.521,13.963,-592,-0.192,27.542,1796,1850,8985
1996,4232,9280,10494,132089,131989,1249,11.992,1091,10.475,20750,6773,13977,5.131,15.721,20470,7150,13320,5.417,15.509,280,0.212,31.018,802,817,4737
1996,4233,9896,13135,172711,173481,1259,9.649,1085,8.315,23685,7188,16497,4.143,13.653,25223,8494,16729,4.896,14.539,-1538,-0.887,27.306,759,779,4680
1996,4234,28948,37347,614123,608345,5087,13.72,4549,12.269,111528,38620,72908,6.348,18.333,100003,39064,60939,6.421,16.439,11525,1.894,32.877,2948,3084,22166
1996,4235,7412,9827,146898,145108,853,8.781,627,6.455,18055,5160,12895,3.556,12.442,14527,4026,10501,2.774,10.011,3528,2.431,20.022,410,420,2255
1996,4236,19076,29057,400026,391701,3381,11.813,2510,8.77,71253,23453,47800,5.987,18.191,54477,18353,36124,4.685,13.908,16776,4.283,27.816,1496,1546,9233
1996,4237,11665,16980,196329,195461,1280,7.594,1032,6.122,24096,6713,17383,3.434,12.328,22182,5358,16824,2.741,11.349,1914,0.979,22.697,688,719,3386
1996,4238,49320,64112,707306,696070,5374,8.437,4546,7.137,99239,31168,68071,4.478,14.257,76575,25958,50617,3.729,11.001,22664,3.256,22.002,3029,3166,16263
1996,4239,28085,30311,315585,312732,4032,13.475,3254,10.875,54518,18429,36089,5.893,17.433,48964,18567,30397,5.937,15.657,5554,1.776,31.314,2620,2663,14141
1996,4241,9562,12474,199589,198452,1122,8.986,1145,9.171,29518,7548,21970,3.803,14.874,27206,13173,14033,6.638,13.709,2312,1.165,27.418,673,689,5352
1996,4242,4380,5636,151468,150508,800,14.351,677,12.145,25596,7767,17829,5.161,17.006,23699,10584,13115,7.032,15.746,1897,1.26,31.492,409,449,3982
1996,4243,13366,14447,168906,170965,2086,14.411,2143,14.804,31524,12275,19249,7.18,18.439,35658,13623,22035,7.968,20.857,-4134,-2.418,36.878,1737,1763,10304
1996,4244,27848,33596,722551,727801,3496,10.342,3913,11.575,96569,23895,72674,3.283,13.269,106838,38914,67924,5.347,14.68,-10269,-1.411,26.537,2900,2960,22054
1996,4245,5538,8487,74733,76494,465,5.422,644,7.509,8436,2207,6229,2.885,11.028,11940,3520,8420,4.602,15.609,-3504,-4.581,22.057,421,437,2290
1996,4246,9474,13458,156797,153951,1315,9.905,951,7.163,26069,7328,18741,4.76,16.933,20266,5818,14448,3.779,13.164,5803,3.769,26.328,572,591,2562
1996,4247,7430,10621,126077,127169,678,6.321,888,8.279,18034,4683,13351,3.683,14.181,20225,4827,15398,3.796,15.904,-2191,-1.723,28.362,429,441,2241
1996,4248,3280,4262,138908,139274,225,5.25,272,6.347,13103,3064,10039,2.2,9.408,13931,4881,9050,3.505,10.003,-828,-0.595,18.816,196,198,2932
1996,4249,23352,28203,348875,347480,3742,13.363,3342,11.934,59556,19977,39579,5.749,17.139,56913,22186,34727,6.385,16.379,2643,0.761,32.758,2439,2471,13911
1996,4251,34921,37401,315246,314220,4184,11.34,3176,8.608,51953,17256,34697,5.492,16.534,49732,17570,32162,5.592,15.827,2221,0.707,31.654,2169,2181,11070
1996,4411,40745,43487,1075594,1059010,4708,10.973,3541,8.253,129992,43168,86824,4.076,12.275,97513,33423,64090,3.156,9.208,32479,3.067,18.416,2765,2803,26508
1996,4412,11051,11871,94750,92369,1155,9.844,880,7.5,16430,5620,10810,6.084,17.787,11703,3733,7970,4.041,12.67,4727,5.118,25.34,694,706,2963
1996,4413,38987,65255,550065,532553,5921,9.164,4638,7.178,107018,60204,46814,11.305,20.095,74813,23453,51360,4.404,14.048,32205,6.047,28.096,2801,2898,13283
1996,4421,21231,28116,252853,253379,2836,10.099,2766,9.85,38978,17151,21827,6.769,15.383,40620,14111,26509,5.569,16.031,-1642,-0.648,30.767,1920,2112,10289
1996,4422,24257,32849,226831,222226,3666,11.257,3103,9.528,44066,19432,24634,8.744,19.829,34553,12001,22552,5.4,15.549,9513,4.281,31.097,2061,2199,7272
1996,4431,28982,41366,376303,365107,6043,14.74,5307,12.945,90411,45258,45153,12.396,24.763,67646,28558,39088,7.822,18.528,22765,6.235,37.055,3305,3484,16317
1996,4441,45926,64264,846932,831173,5347,8.324,5285,8.228,139775,54831,84944,6.597,16.817,110129,41492,68637,4.992,13.25,29646,3.567,26.5,3393,3518,18389
1996,4442,16421,20178,160869,160013,1565,7.782,1430,7.111,23560,7131,16429,4.457,14.724,21795,5558,16237,3.473,13.621,1765,1.103,27.242,1019,1031,3703
1996,4451,61816,91103,2628590,2604439,9151,10.041,9211,10.107,318522,136026,182496,5.223,12.23,267392,103724,163668,3.983,10.267,51130,1.963,20.534,6384,6517,43593
1996,4452,17033,21666,139026,136640,2917,13.48,2863,13.231,32443,12608,19835,9.227,23.744,27860,13332,14528,9.757,20.389,4583,3.354,40.779,2166,2185,9016
1996,4453,23407,27185,133655,133802,2404,8.782,2785,10.173,21515,7920,13595,5.919,16.08,21910,8618,13292,6.441,16.375,-395,-0.295,32.16,1984,2019,6081
1996,4461,43161,77664,784265,787151,6888,8.888,6555,8.458,122321,53094,69227,6.745,15.54,128929,46044,82885,5.849,16.379,-6608,-0.839,31.079,4075,4274,22540
1996,4471,69860,120455,905315,903515,9636,7.968,10605,8.769,159999,60876,99123,6.738,17.709,156372,60437,95935,6.689,17.307,3627,0.401,34.614,6683,7078,36382
1996,4481,41414,91932,902323,930916,10026,10.807,11708,12.62,155480,75740,79740,8.136,16.702,212412,64988,147424,6.981,22.818,-56932,-6.116,33.404,6228,7099,27512
1996,4482,7326,30418,184376,185638,1788,5.792,2691,8.717,34959,12248,22711,6.598,18.832,37521,11311,26210,6.093,20.212,-2562,-1.38,37.664,916,1029,3448
1996,4483,18780,28287,150748,153403,2755,9.753,2678,9.48,24755,10156,14599,6.62,16.137,30633,11413,19220,7.44,19.969,-5878,-3.832,32.275,1667,1828,7722
1996,4511,31967,43696,380567,372697,5607,12.953,4791,11.068,74999,35991,39008,9.657,20.123,59467,22501,36966,6.037,15.956,15532,4.167,31.912,3484,3665,13995
1996,4512,8934,14662,126539,123651,1524,10.376,1575,10.723,27244,11536,15708,9.33,22.033,20730,7259,13471,5.871,16.765,6514,5.268,33.53,1022,1040,3757
1996,4522,91,6245,1079206,1086810,220,3.512,259,4.134,107562,33054,74508,3.041,9.897,124505,28015,96490,2.578,11.456,-16943,-1.559,19.794,(D),(D),(D)
1996,4523,10462,28993,1345497,1316194,2924,10.168,2452,8.527,176704,78501,98203,5.964,13.425,120747,34944,85803,2.655,9.174,55957,4.251,18.348,1293,1370,7049
1996,4531,22753,24097,122009,121780,2379,9.815,2663,10.986,20538,7075,13463,5.81,16.865,20084,7652,12432,6.283,16.492,454,0.373,32.984,2164,2195,6182
1996,4532,29597,39583,297013,291103,5131,13.051,4593,11.683,60892,29941,30951,10.285,20.918,49968,18099,31869,6.217,17.165,10924,3.753,34.33,3470,3597,12259
1996,4533,12630,15905,93366,92154,2356,15.021,1916,12.215,18858,8096,10762,8.785,20.464,16602,6121,10481,6.642,18.016,2256,2.448,36.031,1465,1480,3916
1996,4539,28704,34114,199709,192709,5702,17.125,4065,12.209,50528,25039,25489,12.993,26.22,36439,14941,21498,7.753,18.909,14089,7.311,37.818,3184,3264,11275
1996,4541,6973,7646,166804,163047,1226,16.59,714,9.662,28572,10449,18123,6.409,17.524,20981,5386,15595,3.303,12.868,7591,4.656,25.736,545,546,2809
1996,4542,4924,5717,70388,70465,791,14.029,634,11.244,9319,3759,5560,5.335,13.225,9586,3403,6183,4.829,13.604,-267,-0.379,26.45,486,486,2150
1996,4543,18460,24805,225239,224146,2714,11.071,2134,8.705,36638,12154,24484,5.422,16.346,34137,12332,21805,5.502,15.23,2501,1.116,30.46,1365,1394,6973
1996,4811,635,3087,464485,455336,302,9.707,350,11.25,51536,16887,34649,3.709,11.318,33790,17997,15793,3.952,7.421,17746,3.897,14.842,96,114,1773
1996,4812,1385,1554,26403,25333,232,15.441,129,8.586,6130,1688,4442,6.663,24.198,3708,1217,2491,4.804,14.637,2422,9.561,29.274,93,99,945
1996,4831,479,810,41435,40359,92,11.507,71,8.881,8150,2772,5378,6.868,20.194,6309,1186,5123,2.939,15.632,1841,4.562,31.265,35,40,867
1996,4832,331,365,12202,12156,50,14.006,34,9.524,2013,743,1270,6.112,16.56,1858,530,1328,4.36,15.285,155,1.275,30.571,21,21,130
1996,4841,29481,37222,775408,764674,6429,17.697,4643,12.78,117125,37904,79221,4.957,15.317,95913,28440,67473,3.719,12.543,21212,2.774,25.086,3384,3437,18803
1996,4842,48823,52606,522757,524650,7964,15.124,8069,15.323,99200,36081,63119,6.877,18.908,103203,44151,59052,8.415,19.671,-4003,-0.763,37.816,6245,6301,30878
1996,4851,455,554,29314,28928,90,16.933,45,8.467,3835,2515,1320,8.694,13.257,3170,873,2297,3.018,10.958,665,2.299,21.916,34,34,216
1996,4852,247,420,17889,18443,34,7.692,78,17.647,1581,322,1259,1.746,8.573,2685,645,2040,3.497,14.559,-1104,-5.986,17.145,28,33,172
1996,4853,5440,5529,56399,55607,917,16.465,998,17.919,11787,5105,6682,9.181,21.197,10284,5271,5013,9.479,18.494,1503,2.703,36.988,856,857,4521
1996,4854,3228,4259,144931,142917,347,8.169,325,7.651,17849,7073,10776,4.949,12.489,13783,6759,7024,4.729,9.644,4066,2.845,19.288,264,271,3453
1996,4855,1215,1329,28715,28264,183,14.028,134,10.272,5181,1098,4083,3.885,18.331,4323,1535,2788,5.431,15.295,858,3.036,30.591,102,102,1180
1996,4859,1828,1963,37297,35724,385,20.627,192,10.287,8402,3714,4688,10.397,23.52,5234,2345,2889,6.564,14.651,3168,8.868,29.303,147,147,1467
1996,4861,52,380,7954,8637,34,8.696,56,14.322,973,418,555,4.84,11.265,2371,369,2002,4.272,27.452,-1398,-16.186,22.531,3,3,17
1996,4862,147,1344,34977,36633,90,6.47,184,13.228,3169,1025,2144,2.798,8.651,6305,1698,4607,4.635,17.211,-3136,-8.561,17.302,24,24,133
1996,4869,57,534,6202,6299,36,6.557,66,12.022,752,229,523,3.636,11.939,921,436,485,6.922,14.623,-169,-2.683,23.879,4,4,16
1996,4871,337,371,7184,7187,52,13.904,58,15.508,993,250,743,3.479,13.818,980,337,643,4.689,13.637,13,0.181,27.273,48,48,304
1996,4872,1209,1244,11914,11769,189,15.372,160,13.013,2384,702,1682,5.965,20.257,2040,596,1444,5.064,17.334,344,2.923,34.669,119,119,394
1996,4879,133,136,1338,1270,25,18.727,20,14.981,300,74,226,5.829,23.631,163,45,118,3.545,12.84,137,10.792,25.679,14,14,36
1996,4881,2754,3630,101536,99230,578,16.358,385,10.896,20787,7753,13034,7.813,20.948,15990,4183,11807,4.215,16.114,4797,4.834,32.228,249,255,1441
1996,4882,485,776,18766,18763,80,10.39,68,8.831,3568,1758,1810,9.37,19.016,3496,1098,2398,5.852,18.632,72,0.384,37.265,39,40,704
1996,4883,2016,2595,81409,81910,244,9.403,244,9.403,11102,2104,8998,2.569,13.554,12412,2139,10273,2.611,15.153,-1310,-1.599,27.108,167,171,1205
1996,4884,4873,5084,36945,35264,873,17.695,572,11.594,8654,3619,5035,10.263,24.541,5329,2665,2664,7.557,15.112,3325,9.429,30.223,483,484,2332
1996,4885,10245,13573,129791,127150,1816,13.683,1213,9.14,23771,8339,15432,6.558,18.695,18327,7077,11250,5.566,14.414,5444,4.282,28.827,878,920,5152
1996,4889,837,884,10825,10601,136,15.596,112,12.844,2270,691,1579,6.519,21.414,1816,580,1236,5.471,17.131,454,4.283,34.263,88,92,479
1996,4921,1723,4818,462251,444752,620,13.113,440,9.306,76733,7199,69534,1.619,17.253,40880,29878,11002,6.718,9.192,35853,8.061,18.383,266,276,2396
1996,4922,4248,4656,69738,67695,814,17.798,649,14.19,16547,8053,8494,11.896,24.443,12415,4495,7920,6.64,18.34,4132,6.104,36.679,552,561,3690
1996,4931,6732,11378,475368,469235,1275,11.418,852,7.63,81624,29221,52403,6.227,17.395,68727,21616,47111,4.607,14.647,12897,2.749,29.293,326,332,3562
1996,5111,15912,18736,670879,674723,1979,10.618,1785,9.577,57666,16534,41132,2.45,8.547,66298,18384,47914,2.725,9.826,-8632,-1.279,17.093,1409,1423,10689
1996,5112,6748,8446,183281,172990,1670,20.813,826,10.294,45854,16249,29605,9.393,26.507,25314,8577,16737,4.958,14.633,20540,11.874,29.267,521,545,4967
1996,5121,11447,15798,244190,235230,2353,15.139,1842,11.851,56284,17245,39039,7.331,23.927,38099,12431,25668,5.285,16.197,18185,7.731,32.393,1173,1202,6790
1996,5122,2120,2186,18707,18061,465,22.217,279,13.33,4156,1944,2212,10.764,23.012,2917,1180,1737,6.534,16.151,1239,6.86,32.303,215,215,899
1996,5151,6286,8298,235227,238480,929,11.239,864,10.453,31265,12949,18316,5.43,13.11,37488,12270,25218,5.145,15.72,-6223,-2.609,26.22,662,709,8912
1996,5152,223,439,20530,19448,104,24.102,89,20.626,7117,4640,2477,23.859,36.596,4908,2570,2338,13.215,25.237,2209,11.359,50.474,29,32,178
1996,5173,6979,30017,1087529,1066731,4861,16.379,4184,14.098,240514,109000,131514,10.218,22.547,200009,76862,123147,7.205,18.75,40505,3.797,37.499,1038,1154,12322
1996,5174,342,447,10186,9421,103,24.553,48,11.442,4067,1385,2682,14.701,43.17,2507,1488,1019,15.795,26.611,1560,16.559,53.222,23,23,749
1996,5179,2912,3472,43818,40981,1362,44.121,592,19.177,17275,8482,8793,20.697,42.154,11605,5819,5786,14.199,28.318,5670,13.836,56.636,248,250,1558
1996,5182,4942,8317,338947,330901,1572,19.621,962,12.007,59770,24939,34831,7.537,18.063,43291,10377,32914,3.136,13.083,16479,4.98,26.166,461,470,3096
1996,5191,2804,3437,44409,42954,328,9.731,195,5.785,7069,1929,5140,4.491,16.457,4249,1055,3194,2.456,9.892,2820,6.565,19.784,162,162,666
1996,5211,16,46,22705,22709,0,0,(D),(D),551,0,551,0,2.426,595,(D),476,(D),2.62,-44,-0.194,4.853,0,0,0
1996,5221,19869,100396,1916447,1932444,6872,6.903,5183,5.206,239468,91200,148268,4.719,12.392,270685,77018,193667,3.986,14.007,-31217,-1.615,24.784,635,1203,17194
1996,5222,16058,41419,494519,481290,6534,16.229,4221,10.484,121635,50330,71305,10.457,25.273,95262,41871,53391,8.7,19.793,26373,5.48,39.586,1446,1579,11397
1996,5223,9082,12426,128620,114305,2676,22.45,1664,13.96,47389,25322,22067,22.153,41.459,19352,8720,10632,7.629,16.93,28037,24.528,33.86,975,1051,4411
1996,5231,8946,25352,409564,395653,3234,13.006,2260,9.089,72321,21343,50978,5.394,18.279,44285,17996,26289,4.548,11.193,28036,7.086,22.386,785,796,4694
1996,5232,29,46,6418,6516,7,14.433,12,24.742,118,27,91,0.414,1.811,313,91,222,1.397,4.804,-195,-2.993,3.622,6,6,70
1996,5239,19456,21486,191048,183021,3839,18.391,2616,12.532,47962,18958,29004,10.358,26.206,32252,13931,18321,7.612,17.622,15710,8.584,35.244,1859,1865,7953
1996,5241,4448,38153,1513366,1490973,4095,10.781,3757,9.891,206099,79487,126612,5.331,13.823,160744,37335,123409,2.504,10.781,45355,3.042,21.562,279,339,5174
1996,5242,108195,119451,710776,700577,11896,10.015,10549,8.881,121061,43486,77575,6.207,17.28,99391,38374,61017,5.477,14.187,21670,3.093,28.374,7540,7728,24284
1996,5259,537,570,20857,20254,35,5.882,85,14.286,4103,344,3759,1.698,20.258,2737,685,2052,3.382,13.514,1366,6.745,27.027,54,54,266
1996,5311,88995,97483,503502,502949,10827,11.148,10100,10.4,92020,40966,51054,8.145,18.296,90724,39839,50885,7.921,18.038,1296,0.258,36.077,7973,8071,29962
1996,5312,45684,51252,229589,231074,7381,14.455,6999,13.707,46685,20139,26546,8.715,20.204,49700,22135,27565,9.579,21.508,-3015,-1.305,40.407,4904,5114,16032
1996,5313,34920,40800,399180,394388,5708,14.248,4230,10.559,77747,33473,44274,8.487,19.713,68286,20499,47787,5.198,17.314,9461,2.399,34.629,2847,2907,13594
1996,5321,4791,9715,147334,142208,894,9.107,1097,11.175,28790,6375,22415,4.483,20.245,17992,6537,11455,4.597,12.652,10798,7.593,25.304,562,587,3731
1996,5322,19317,30333,214566,230967,4135,13.591,4320,14.199,46539,20904,25635,9.051,20.15,77060,23504,53556,10.176,33.364,-30521,-13.214,40.299,3062,3456,17439
1996,5323,3885,6257,43072,43159,472,7.553,457,7.313,7017,1917,5100,4.442,16.259,7335,2252,5083,5.218,16.995,-318,-0.737,32.517,299,328,1462
1996,5324,7531,10278,118493,116180,1335,13.142,1095,10.78,23398,8221,15177,7.076,20.139,18715,6881,11834,5.923,16.109,4683,4.031,32.217,650,672,3420
1996,5331,1420,1527,16543,16330,284,18.538,294,19.191,4937,1521,3416,9.314,30.233,4488,2880,1608,17.636,27.483,449,2.75,54.966,186,204,1232
1996,5411,152183,159088,992919,993164,15265,9.675,12645,8.014,123436,43904,79532,4.421,12.429,123503,35851,87652,3.61,12.435,-67,-0.007,24.857,9656,9730,27916
1996,5412,82662,87604,890372,878570,9767,11.247,8234,9.482,142500,49339,93161,5.616,16.22,118182,33960,84222,3.865,13.452,24318,2.768,26.903,5990,6082,23470
1996,5413,73985,83218,1036029,1019314,10803,13.232,7647,9.367,177180,50178,127002,4.923,17.382,144305,48115,96190,4.72,14.157,32875,3.225,28.314,5297,5372,23581
1996,5414,19469,19675,101749,99904,3617,18.734,2882,14.927,25110,11012,14098,11.023,25.134,21431,10972,10459,10.983,21.452,3679,3.683,42.903,2232,2235,7941
1996,5415,44013,49610,637764,598178,12836,27.665,6412,13.82,187691,80128,107563,13.395,31.377,108344,42972,65372,7.184,18.112,79347,13.265,36.225,4347,4418,22080
1996,5416,51296,54544,497626,482644,11307,21.45,7646,14.505,124553,49611,74942,10.279,25.806,94884,35327,59557,7.319,19.659,29669,6.147,39.318,5829,5863,26256
1996,5417,8389,10577,473162,461664,1566,15.208,1007,9.779,79620,24833,54787,5.379,17.246,57943,17440,40503,3.778,12.551,21677,4.695,25.102,621,639,4732
1996,5418,31148,34118,413347,403785,5109,15.211,4048,12.052,80708,27770,52938,6.877,19.988,61675,21010,40665,5.203,15.274,19033,4.714,30.548,3241,3264,14560
1996,5419,38393,44238,382799,377499,4302,9.864,3053,7,64129,18024,46105,4.775,16.988,53664,16151,37513,4.278,14.216,10465,2.772,28.431,2267,2293,12337
1996,5511,28290,52067,3227376,3218982,4837,9.332,4368,8.427,511863,152188,359675,4.728,15.901,495248,121302,373946,3.768,15.385,16615,0.516,30.77,999,1051,15937
1996,5611,15686,16674,274907,269185,3679,22.658,2805,17.275,78225,39238,38987,14.577,29.06,66849,33347,33502,12.388,24.834,11376,4.226,49.668,1952,1979,22978
1996,5612,861,1652,79452,78113,304,19.645,95,6.139,19707,10306,9401,13.194,25.229,16408,8966,7442,11.478,21.005,3299,4.223,42.011,32,34,522
1996,5613,22337,34709,2745713,2621864,6370,19.075,3742,11.205,874747,289088,585659,11.026,33.364,629748,173696,456052,6.625,24.019,244999,9.344,48.038,2355,2467,106769
1996,5614,24714,28748,491649,466776,4447,15.651,3778,13.296,122100,52176,69924,11.178,26.158,72971,23663,49308,5.069,15.633,49129,10.525,31.266,2964,3006,15329
1996,5615,25725,32888,276356,272207,4331,13.3,3681,11.304,52555,24442,28113,8.979,19.307,44759,16598,28161,6.098,16.443,7796,2.864,32.886,2522,2604,10955
1996,5616,15146,19105,619163,611810,2856,15.183,2268,12.057,123770,37909,85861,6.196,20.23,109957,44554,65403,7.282,17.972,13813,2.258,35.945,1582,1613,21526
1996,5617,109313,114141,1281362,1260964,19632,17.496,15766,14.051,264619,84498,180121,6.701,20.985,223388,78651,144737,6.237,17.716,41231,3.27,35.431,12665,12696,59617
1996,5619,17477,19311,291291,286295,3734,19.752,2920,15.446,70065,25770,44295,9.001,24.473,59878,23263,36615,8.126,20.915,10187,3.558,41.83,2205,2235,14998
1996,5621,5562,6212,99310,96155,741,12.252,413,6.829,15307,5289,10018,5.5,15.919,9001,2153,6848,2.239,9.361,6306,6.558,18.722,317,317,1511
1996,5622,1746,2709,88186,90303,287,10.567,301,11.082,12428,2860,9568,3.167,13.763,16297,4439,11858,4.916,18.047,-3869,-4.284,27.525,182,188,2082
1996,5629,5279,5737,83384,83361,734,12.886,652,11.447,21365,9695,11670,11.63,25.629,22039,11064,10975,13.272,26.438,-674,-0.809,51.259,490,490,2881
1996,6111,14887,17074,598791,592501,859,5.079,537,3.175,53099,11958,41141,2.018,8.962,40581,8438,32143,1.424,6.849,12518,2.113,13.698,360,376,6198
1996,6112,549,809,71279,72342,46,5.641,59,7.235,5938,863,5075,1.193,8.208,7960,3430,4530,4.741,11.003,-2022,-2.795,16.416,31,40,2609
1996,6113,2145,2595,1142041,1140717,135,5.246,92,3.575,62951,3413,59538,0.299,5.519,60692,5656,55036,0.496,5.321,2259,0.198,10.641,61,61,4831
1996,6114,4692,5148,54297,52885,1060,21.447,649,13.131,12706,5565,7141,10.523,24.026,9999,4795,5204,9.067,18.907,2707,5.119,37.814,487,500,3519
1996,6115,5299,6160,67001,65706,818,13.516,602,9.947,12977,4602,8375,7.004,19.75,10516,4512,6004,6.867,16.005,2461,3.746,32.009,416,430,2349
1996,6116,18529,19743,146401,143361,3307,17.15,2387,12.379,33123,14403,18720,10.047,23.105,27012,11934,15078,8.324,18.842,6111,4.263,37.684,1916,1931,9807
1996,6117,2995,3147,26696,26329,587,19.052,455,14.768,5495,2142,3353,8.136,20.871,4705,1708,2997,6.487,17.87,790,3,35.74,363,363,1263
1996,6211,167441,184784,1619915,1608561,13585,7.284,17030,9.131,264084,98315,165769,6.112,16.417,240864,103966,136898,6.463,14.974,23220,1.444,29.948,13699,14066,78446
1996,6212,104308,107694,625819,617302,5013,4.675,4065,3.791,81220,21081,60139,3.415,13.157,63989,16513,47476,2.675,10.366,17231,2.791,20.732,3308,3343,14052
1996,6213,72500,77081,357494,351945,8500,11.145,6876,9.015,73195,29551,43644,8.396,20.797,61913,23388,38525,6.645,17.592,11282,3.206,35.183,5266,5396,18182
1996,6214,8998,16894,373054,361477,2395,14.641,1324,8.094,73523,33089,40434,9.154,20.34,49940,17467,32473,4.832,13.816,23583,6.524,27.631,761,841,10175
1996,6215,5215,7668,141678,142456,978,12.229,1637,20.469,22500,9376,13124,6.582,15.794,24216,13888,10328,9.749,16.999,-1716,-1.205,31.589,637,667,5850
1996,6216,8732,14979,785805,762641,3064,21.38,1768,12.337,189589,78497,111092,10.293,24.86,144689,58563,86126,7.679,18.972,44900,5.887,37.944,644,734,20366
1996,6219,5280,7327,181913,178589,708,9.549,883,11.909,36678,8878,27800,4.971,20.538,29586,12480,17106,6.988,16.567,7092,3.971,33.133,578,609,7975
1996,6221,2725,4505,4058995,4053580,120,2.663,123,2.729,224481,68414,156067,1.688,5.538,211227,40290,170937,0.994,5.211,13254,0.327,10.422,64,64,14555
1996,6222,548,841,278547,290846,30,3.472,76,8.796,12017,5092,6925,1.751,4.132,36524,9474,27050,3.257,12.558,-24507,-8.426,8.263,26,30,6391
1996,6223,222,362,127592,128288,18,4.959,20,5.51,7353,3450,3903,2.689,5.732,8705,1444,7261,1.126,6.786,-1352,-1.054,11.463,9,9,706
1996,6231,8134,14759,1471271,1461523,890,6.054,775,5.272,146818,54928,91890,3.758,10.046,126369,44613,81756,3.053,8.646,20449,1.399,17.293,489,513,28151
1996,6232,7593,18371,352147,343856,1915,10.816,582,3.287,53886,19931,33955,5.796,15.671,37435,8077,29358,2.349,10.887,16451,4.784,21.774,380,397,5292
1996,6233,11644,13874,350358,343290,2042,14.99,1538,11.291,52604,21202,31402,6.176,15.323,38515,17261,21254,5.028,11.219,14089,4.104,22.439,1007,1056,10587
1996,6239,4096,6242,162334,159723,597,9.728,387,6.306,20948,7626,13322,4.775,13.115,15905,4495,11410,2.814,9.958,5043,3.157,19.916,246,258,2562
1996,6241,25773,35819,536820,528949,4029,11.547,2174,6.231,78788,27136,51652,5.13,14.895,63139,12518,50621,2.367,11.937,15649,2.959,23.873,1436,1474,8078
1996,6242,6703,8296,83640,83003,770,9.432,506,6.198,12505,4770,7735,5.747,15.066,11160,2657,8503,3.201,13.445,1345,1.62,26.891,348,352,1612
1996,6243,5498,8661,311496,313983,671,7.801,552,6.417,40424,8247,32177,2.627,12.875,45236,7830,37406,2.494,14.407,-4812,-1.533,25.749,252,308,3792
1996,6244,44803,55342,585502,575458,6841,12.57,5001,9.189,96504,41644,54860,7.237,16.77,76683,27120,49563,4.713,13.326,19821,3.444,26.651,4004,4074,21093
1996,7111,7093,7181,97774,98281,1195,16.949,934,13.247,21426,7127,14299,7.252,21.801,22471,5179,17292,5.27,22.864,-1045,-1.063,43.602,656,656,3743
1996,7112,2971,3089,82757,79403,571,18.889,439,14.522,20457,6764,13693,8.519,25.764,13697,4260,9437,5.365,17.25,6760,8.514,34.5,341,346,3309
1996,7113,2916,3051,58146,55741,490,16.344,384,12.809,13995,4046,9949,7.259,25.107,9010,3237,5773,5.807,16.164,4985,8.943,32.328,294,296,2544
1996,7114,1897,1942,11931,11894,379,20.371,216,11.61,3125,1906,1219,16.026,26.275,3021,1191,1830,10.014,25.4,104,0.874,50.801,167,167,875
1996,7115,7450,7470,39019,35685,1493,20.538,1092,15.022,16533,4948,11585,13.866,46.331,9994,3814,6180,10.688,28.007,6539,18.324,56.013,701,702,2270
1996,7121,3723,4060,77252,77004,338,8.475,194,4.865,7459,1171,6288,1.521,9.687,7139,700,6439,0.909,9.271,320,0.416,18.542,130,130,595
1996,7131,1747,2959,131815,126002,327,11.094,304,10.314,27561,11963,15598,9.494,21.873,15811,2623,13188,2.082,12.548,11750,9.325,25.096,222,226,1750
1996,7132,1429,1727,121218,112074,292,17.708,136,8.247,29929,13273,16656,11.843,26.705,12088,2702,9386,2.411,10.786,17841,15.919,21.572,99,99,2037
1996,7139,43202,46647,761810,757637,5469,11.826,4665,10.088,125737,49290,76447,6.506,16.596,117064,38524,78540,5.085,15.451,8673,1.145,30.902,3678,3717,30151
1996,7211,32062,39302,1514870,1502779,4507,11.617,3494,9.006,240526,137051,103475,9.12,16.005,215797,101326,114471,6.743,14.36,24729,1.646,28.72,2452,2516,62135
1996,7212,4860,5308,35183,34389,574,10.935,456,8.687,7372,2726,4646,7.927,21.437,5789,1656,4133,4.815,16.834,1583,4.603,33.668,312,313,1209
1996,7213,2979,3070,15417,15554,212,6.812,296,9.512,2209,518,1691,3.33,14.202,2462,1130,1332,7.265,15.829,-253,-1.627,28.404,230,230,963
1996,7223,12725,27212,497460,506819,4458,16.322,4661,17.065,92737,49282,43455,9.724,18.298,111592,55979,55613,11.045,22.018,-18855,-3.72,36.596,2841,2894,25774
1996,7224,48817,49340,327546,327991,6660,13.4,7382,14.853,78516,40190,38326,12.253,23.938,79751,38888,40863,11.856,24.315,-1235,-0.377,47.877,6229,6243,32475
1996,7225,254651,348516,6626168,6528567,48862,14.217,39197,11.405,1302446,712528,589918,10.914,19.95,1107203,427121,680082,6.542,16.959,195243,2.991,33.919,29133,30129,283620
1996,8111,134178,145953,799911,781813,18313,12.722,14312,9.942,159316,67559,91757,8.641,20.378,122765,50662,72103,6.48,15.703,36551,4.675,31.405,11066,11268,40510
1996,8112,13891,16525,149542,145849,2260,13.804,1955,11.941,33013,12502,20511,8.572,22.635,25657,10204,15453,6.996,17.591,7356,5.044,35.183,1295,1375,5667
1996,8113,21813,23135,189431,186013,2563,11.181,2138,9.327,34573,11239,23334,6.042,18.586,27612,9052,18560,4.866,14.844,6961,3.742,29.688,1599,1603,6378
1996,8114,26324,27991,160167,162676,3617,12.923,3612,12.905,25807,10064,15743,6.187,15.864,30628,11464,19164,7.047,18.828,-4821,-2.964,31.728,2942,2952,8720
1996,8121,75933,86753,456439,455089,11208,12.924,11149,12.856,90882,44915,45967,9.869,19.97,87402,36720,50682,8.069,19.205,3480,0.765,38.411,8852,9055,29139
1996,8122,16143,21122,147985,147032,1329,6.299,1280,6.067,24214,9567,14647,6.507,16.469,22031,7222,14809,4.912,14.984,2183,1.485,29.968,817,867,4237
1996,8123,34589,41248,385173,383623,4286,10.369,4459,10.788,56758,22215,34543,5.791,14.795,53630,20847,32783,5.434,13.98,3128,0.815,27.96,3332,3476,16411
1996,8129,15535,24590,185799,180071,3465,14.215,3038,12.463,45908,18579,27329,10.318,25.494,34731,15313,19418,8.504,19.287,11177,6.207,38.575,1732,1819,9011
1996,8131,150675,150794,1372023,1347230,8614,5.784,4874,3.273,164084,24603,139481,1.826,12.179,113976,13588,100388,1.009,8.46,50108,3.719,16.92,3027,3027,8178
1996,8132,11691,13488,166689,166129,983,7.359,724,5.42,20750,4321,16429,2.601,12.49,19612,3727,15885,2.243,11.805,1138,0.685,23.611,494,505,2697
1996,8133,10553,12404,141032,140785,1011,8.259,685,5.596,18519,5665,12854,4.024,13.154,17920,3062,14858,2.175,12.729,599,0.425,25.457,451,468,1989
1996,8134,30820,32711,322102,320374,1479,4.5,1794,5.458,37528,5987,31541,1.869,11.714,34134,5968,28166,1.863,10.654,3394,1.059,21.309,1341,1341,4292
1996,8139,63958,66089,501652,500864,3996,6.056,3780,5.729,65227,15359,49868,3.067,13.023,63343,16067,47276,3.208,12.647,1884,0.376,25.294,2774,2779,11119
1997,1131,218,268,2837,2788,35,13.084,34,12.71,614,113,501,4.053,22.023,516,139,377,4.986,18.508,98,3.515,37.016,30,31,68
1997,1132,128,167,1912,1925,28,17.337,17,10.526,612,246,366,12.783,31.8,578,89,489,4.625,30.034,34,1.767,60.068,14,14,75
1997,1133,11785,11850,80798,81820,1465,12.236,1711,14.29,15454,5134,10320,6.275,18.888,17541,6373,11168,7.789,21.439,-2087,-2.551,37.776,1313,1314,4615
1997,1141,1252,1261,9655,9531,231,18.569,197,15.836,2211,776,1435,8.142,23.198,2014,988,1026,10.366,21.131,197,2.067,42.262,121,121,659
1997,1142,229,233,2095,1900,31,13.449,26,11.28,550,327,223,17.215,28.955,175,98,77,5.159,9.213,375,19.742,18.426,20,21,64
1997,1151,4535,4882,66716,63980,543,11.121,544,11.142,18146,6995,11151,10.933,28.362,12518,5028,7490,7.859,19.566,5628,8.797,39.131,379,387,3312
1997,1152,2792,2831,17289,16858,467,16.871,341,12.319,3363,1419,1944,8.418,19.95,2506,926,1580,5.493,14.866,857,5.084,29.732,263,263,730
1997,1153,1167,1200,14486,14327,168,14.135,145,12.2,2773,595,2178,4.153,19.355,2474,658,1816,4.593,17.268,299,2.087,34.536,108,108,393
1997,2111,6183,7328,99524,95632,714,9.666,831,11.25,28388,8906,19482,9.313,29.685,20381,6733,13648,7.041,21.312,8007,8.373,42.624,521,525,2216
1997,2121,969,1368,83860,84826,175,12.337,276,19.457,12565,5233,7332,6.169,14.813,14382,6122,8260,7.217,16.955,-1817,-2.142,29.626,166,171,3005
1997,2122,332,465,42608,42253,70,14.973,75,16.043,4718,892,3826,2.111,11.166,3952,1185,2767,2.805,9.353,766,1.813,18.706,46,48,552
1997,2123,3275,5015,98657,98303,365,7.293,344,6.874,14159,4008,10151,4.077,14.403,13479,3365,10114,3.423,13.712,680,0.692,27.423,185,190,1414
1997,2131,7037,8158,158375,154224,1120,13.766,1076,13.225,42883,17248,25635,11.184,27.806,34158,18727,15431,12.143,22.148,8725,5.657,44.297,691,695,6565
1997,2211,1545,7697,552612,560677,476,6.2,437,5.692,38453,13935,24518,2.485,6.858,54264,7061,47203,1.259,9.678,-15811,-2.82,13.717,64,64,611
1997,2212,580,2639,100386,100205,162,6.102,194,7.307,11825,2928,8897,2.922,11.801,11271,3228,8043,3.221,11.248,554,0.553,22.496,57,60,902
1997,2213,4089,4549,33790,33601,277,6.097,266,5.855,4155,1204,2951,3.583,12.366,3810,1601,2209,4.765,11.339,345,1.027,22.678,186,187,787
1997,2361,125915,126531,641083,626437,23332,18.693,19902,15.945,184252,74060,110192,11.822,29.413,154812,67615,87197,10.794,24.713,29440,4.7,49.426,14489,14493,51687
1997,2362,40105,40833,693050,679496,5275,13.075,4298,10.653,148903,30836,118067,4.538,21.914,121346,32713,88633,4.814,17.858,27557,4.056,35.716,3144,3147,22590
1997,2371,15620,15907,366830,353724,1401,8.87,1177,7.452,82162,13992,68170,3.956,23.228,55646,10210,45436,2.886,15.731,26516,7.496,31.463,850,851,6694
1997,2372,8489,8630,51907,51287,1833,21.667,1493,17.648,15584,7230,8354,14.097,30.386,14613,7527,7086,14.676,28.493,971,1.893,56.985,1147,1148,4444
1997,2373,10674,11031,256233,250211,999,9.098,899,8.187,51594,7998,43596,3.197,20.62,39817,8708,31109,3.48,15.913,11777,4.707,31.827,606,607,5420
1997,2379,4706,4781,66080,68300,568,11.776,653,13.538,15104,3150,11954,4.612,22.114,19190,8233,10957,12.054,28.097,-4086,-5.982,44.229,505,505,4296
1997,2381,88698,89099,839308,808621,12866,14.661,10177,11.597,222899,58950,163949,7.29,27.565,161325,49909,111416,6.172,19.951,61574,7.615,39.901,7794,7819,40166
1997,2382,138110,140032,1504903,1461296,15957,11.526,12778,9.23,301682,66522,235160,4.552,20.645,215424,63695,151729,4.359,14.742,86258,5.903,29.484,9786,9798,49445
1997,2383,91699,92198,712742,690314,15314,16.799,13235,14.519,191395,55997,135398,8.112,27.726,146476,55019,91457,7.97,21.219,44919,6.507,42.438,10252,10259,43866
1997,2389,46633,46880,378521,370293,6636,14.349,5369,11.61,96481,30291,66190,8.18,26.055,80691,32958,47733,8.901,21.791,15790,4.264,43.582,4030,4030,18550
1997,3111,1018,1627,45972,46274,88,5.359,118,7.186,4187,1170,3017,2.528,9.048,4808,1531,3277,3.309,10.39,-621,-1.342,18.097,65,67,667
1997,3112,503,859,62926,63025,47,5.471,47,5.471,3567,538,3029,0.854,5.66,3669,830,2839,1.317,5.822,-102,-0.162,11.319,29,29,218
1997,3113,1423,1607,84110,83202,165,10.258,168,10.445,9178,1629,7549,1.958,11.031,7225,1963,5262,2.359,8.684,1953,2.347,17.367,118,122,1381
1997,3114,1285,1672,168193,169422,111,6.599,131,7.788,15234,2496,12738,1.473,8.992,17479,5189,12290,3.063,10.317,-2245,-1.325,17.983,78,82,1483
1997,3115,1189,1694,129365,129766,86,5.031,117,6.844,11730,2039,9691,1.571,9.039,12476,3798,8678,2.927,9.614,-746,-0.575,18.079,71,74,1295
1997,3116,3495,4100,452749,455750,267,6.486,300,7.288,35491,6914,28577,1.517,7.787,41903,14578,27325,3.199,9.194,-6412,-1.407,15.575,221,222,6934
1997,3117,641,747,41518,42422,81,10.8,87,11.6,6397,858,5539,2.023,15.08,8202,2854,5348,6.728,19.335,-1805,-4.255,30.159,59,63,1068
1997,3118,9232,10044,304303,308025,1269,12.592,1336,13.257,36354,10352,26002,3.361,11.802,43524,14662,28862,4.76,14.13,-7170,-2.328,23.605,1025,1043,7448
1997,3119,2195,2557,142538,140863,227,8.86,237,9.251,19022,2937,16085,2.085,13.504,15785,5656,10129,4.015,11.206,3237,2.298,22.412,168,168,2239
1997,3121,1921,2351,137615,136886,267,11.568,181,7.842,12739,2960,9779,2.162,9.306,11474,2947,8527,2.153,8.382,1265,0.924,16.764,131,134,1913
1997,3122,71,103,30516,29669,15,15.306,5,5.102,3015,559,2456,1.884,10.162,1401,21,1380,0.071,4.722,1614,5.44,9.444,5,5,21
1997,3131,338,573,81875,83032,46,7.979,53,9.193,7951,2662,5289,3.206,9.576,10291,3651,6640,4.397,12.394,-2340,-2.818,19.152,27,28,683
1997,3132,1670,1998,214990,216231,152,7.538,189,9.373,18392,3607,14785,1.668,8.506,20803,8137,12666,3.763,9.621,-2411,-1.115,17.011,133,133,1979
1997,3133,2361,2540,106167,106531,273,10.518,384,14.795,12317,3480,8837,3.267,11.562,13127,4199,8928,3.942,12.322,-810,-0.76,23.124,321,322,2708
1997,3141,2827,3072,127382,126632,255,8.148,370,11.823,14267,3222,11045,2.544,11.267,12546,4174,8372,3.296,9.907,1721,1.359,19.815,286,287,1714
1997,3149,4410,4539,110128,110634,534,11.797,509,11.245,16847,5545,11302,5.012,15.228,17862,8036,9826,7.264,16.145,-1015,-0.917,30.455,387,388,4705
1997,3151,1087,1190,101186,103791,100,8.244,146,12.036,9756,1812,7944,1.746,9.4,14893,4593,10300,4.425,14.349,-5137,-4.949,18.799,114,115,1905
1997,3152,10362,11168,520101,537618,1941,17.058,2363,20.766,85420,33041,52379,6.146,15.889,120689,61924,58765,11.518,22.449,-35269,-6.56,31.777,2038,2055,41784
1997,3159,2019,2130,57858,58001,279,13.16,259,12.217,9062,4284,4778,7.386,15.624,9304,3119,6185,5.378,16.041,-242,-0.417,31.248,210,211,1860
1997,3161,305,334,16251,15962,27,7.941,39,11.471,2303,718,1585,4.498,14.428,1760,414,1346,2.594,11.026,543,3.402,22.052,35,35,229
1997,3162,319,383,44343,45092,30,7.782,35,9.079,4345,1359,2986,3.014,9.636,5597,2680,2917,5.943,12.412,-1252,-2.777,19.272,24,24,709
1997,3169,966,996,29195,29356,89,8.873,103,10.269,3524,832,2692,2.834,12.005,3850,1193,2657,4.064,13.115,-326,-1.111,24.009,85,85,564
1997,3211,4101,4570,129874,129126,319,6.918,401,8.697,14903,2945,11958,2.281,11.541,13373,4498,8875,3.483,10.357,1530,1.185,20.713,318,319,2060
1997,3212,1404,1752,111205,110770,112,6.409,103,5.894,11263,2153,9110,1.944,10.168,10402,2993,7409,2.702,9.391,861,0.777,18.781,71,73,1334
1997,3219,8994,9721,316366,309662,976,10.045,967,9.952,45567,9198,36369,2.97,14.715,31961,10197,21764,3.293,10.321,13606,4.394,20.643,754,754,6626
1997,3221,206,509,173427,175084,11,2.132,25,4.845,6176,2468,3708,1.41,3.527,9359,3182,6177,1.817,5.345,-3183,-1.818,7.055,8,8,73
1997,3222,3483,5158,398666,398510,263,5.067,327,6.301,38364,13625,24739,3.419,9.627,38421,18933,19488,4.751,9.641,-57,-0.014,19.254,183,185,3682
1997,3231,38426,40288,821940,827667,2656,6.504,3748,9.179,90607,21554,69053,2.604,10.947,102172,40668,61504,4.914,12.345,-11565,-1.397,21.895,3065,3073,20964
1997,3241,1104,2067,114246,115766,109,5.24,135,6.49,9092,3961,5131,3.422,7.854,12101,3638,8463,3.143,10.453,-3009,-2.599,15.708,62,65,743
1997,3251,1085,2260,206336,209583,158,6.988,160,7.077,10794,3214,7580,1.534,5.15,17254,3539,13715,1.689,8.233,-6460,-3.082,10.3,61,72,1145
1997,3252,437,751,121085,120203,47,6.233,53,7.029,8046,2650,5396,2.205,6.694,6351,1759,4592,1.463,5.284,1695,1.41,10.567,32,32,570
1997,3253,644,858,36110,35988,44,5.066,65,7.484,3134,300,2834,0.834,8.708,2855,927,1928,2.576,7.933,279,0.775,15.866,29,30,316
1997,3254,1286,1607,206903,203646,131,8.188,117,7.313,28266,5103,23163,2.506,13.88,20712,4481,16231,2.2,10.171,7554,3.709,20.341,67,69,1178
1997,3255,1620,2076,73805,73497,129,6.193,143,6.865,8675,2083,6592,2.834,11.803,8078,2688,5390,3.657,10.991,597,0.812,21.982,85,86,1112
1997,3256,2076,2278,122912,122556,188,8.228,202,8.84,13013,2291,10722,1.869,10.618,12294,4400,7894,3.59,10.031,719,0.587,20.063,134,134,1369
1997,3259,2121,2777,125169,124539,200,7.194,206,7.41,11852,2144,9708,1.722,9.517,10624,3088,7536,2.48,8.531,1228,0.986,17.061,125,125,988
1997,3261,10651,13022,789556,780935,897,6.897,863,6.636,95698,20375,75323,2.609,12.254,78645,24731,53914,3.167,10.071,17053,2.184,20.141,592,598,12280
1997,3262,2082,2595,195724,196341,165,6.294,218,8.316,16308,3656,12652,1.862,8.306,17374,5898,11476,3.004,8.849,-1066,-0.543,16.612,146,159,3073
1997,3271,1542,1792,80290,79142,129,7.119,169,9.327,8764,735,8029,0.929,11.074,6526,1631,4895,2.061,8.246,2238,2.828,16.492,118,118,708
1997,3272,1812,2078,131656,132138,203,9.859,165,8.014,12186,3637,8549,2.752,9.222,12777,3164,9613,2.394,9.669,-591,-0.447,18.444,125,125,655
1997,3273,5540,8741,186504,183605,551,6.305,546,6.248,27692,6458,21234,3.517,15.082,22194,6605,15589,3.597,12.088,5498,2.994,24.176,315,320,3520
1997,3274,234,357,19329,19229,20,5.517,31,8.552,1709,271,1438,1.409,8.888,1510,335,1175,1.742,7.853,199,1.035,15.705,23,23,243
1997,3279,1969,2337,71932,71694,195,8.405,161,6.94,8341,1831,6510,2.554,11.634,7740,2724,5016,3.8,10.796,601,0.838,21.592,119,120,1458
1997,3311,181,252,137987,141067,25,9.862,28,11.045,3209,644,2565,0.457,2.275,9217,1295,7922,0.918,6.534,-6008,-4.259,4.55,20,20,1196
1997,3312,483,671,64953,65173,28,4.148,36,5.333,4102,343,3759,0.526,6.294,4526,998,3528,1.531,6.945,-424,-0.651,12.588,31,31,888
1997,3313,350,526,86200,85851,35,6.711,26,4.986,6406,2047,4359,2.384,7.462,5735,1829,3906,2.13,6.68,671,0.782,13.36,9,9,147
1997,3314,681,857,80052,78938,56,6.534,56,6.534,7197,1759,5438,2.228,9.117,4979,1517,3462,1.922,6.307,2218,2.81,12.615,32,33,193
1997,3315,2358,2649,218844,217605,122,4.582,149,5.596,18871,3517,15354,1.616,8.672,16436,3089,13347,1.42,7.553,2435,1.119,15.106,110,110,1679
1997,3321,2753,2968,140671,139014,132,4.401,194,6.469,15351,3432,11919,2.469,11.043,11837,5068,6769,3.646,8.515,3514,2.528,17.03,149,150,3446
1997,3322,1473,1614,78130,77879,104,6.492,80,4.994,5861,641,5220,0.823,7.526,5263,1122,4141,1.441,6.758,598,0.768,13.516,58,58,385
1997,3323,10881,11677,364926,358408,802,6.882,754,6.47,49660,9874,39786,2.755,13.856,36711,11830,24881,3.301,10.243,12949,3.613,20.486,546,547,5611
1997,3324,1439,1763,104779,105221,80,4.506,105,5.914,9519,1186,8333,1.127,9.047,10484,2772,7712,2.634,9.964,-965,-0.917,18.093,55,55,1072
1997,3325,798,883,66841,65809,54,6.071,67,7.532,6914,608,6306,0.924,10.506,4817,981,3836,1.491,7.32,2097,3.186,14.639,44,48,617
1997,3326,1590,1765,68503,68188,117,6.646,108,6.135,6205,922,5283,1.352,9.1,5608,1501,4107,2.201,8.224,597,0.876,16.449,73,73,498
1997,3327,24871,25261,410802,403020,2116,8.458,1627,6.504,53355,11294,42061,2.802,13.239,37989,10862,27127,2.695,9.426,15366,3.813,18.852,1291,1291,8375
1997,3328,5576,6050,150823,147341,423,7.03,357,5.933,20975,4523,16452,3.07,14.236,14049,3219,10830,2.185,9.535,6926,4.701,19.07,266,268,2078
1997,3329,5448,5951,303944,302379,510,8.624,436,7.372,28681,5620,23061,1.859,9.485,25615,7979,17636,2.639,8.471,3066,1.014,16.942,320,320,3514
1997,3331,2637,2913,206701,203205,212,7.264,223,7.641,22130,4470,17660,2.2,10.89,14968,3034,11934,1.493,7.366,7162,3.525,14.732,174,174,1718
1997,3332,4072,4331,178949,180160,383,8.903,325,7.555,20621,3681,16940,2.043,11.446,22933,4995,17938,2.773,12.729,-2312,-1.283,22.892,222,223,2067
1997,3333,2350,2486,130692,129525,215,8.692,190,7.681,14101,2904,11197,2.242,10.887,11956,2641,9315,2.039,9.231,2145,1.656,18.461,140,140,1325
1997,3334,1473,1757,172079,171018,123,6.987,130,7.384,16058,4127,11931,2.413,9.39,14108,4716,9392,2.758,8.249,1950,1.14,16.499,96,96,1442
1997,3335,9504,9860,239937,238049,551,5.588,551,5.588,25279,5463,19816,2.295,10.619,21426,6110,15316,2.567,9.001,3853,1.619,18.001,442,442,3493
1997,3336,736,894,110699,110459,42,4.711,37,4.15,7984,1755,6229,1.589,7.228,7289,966,6323,0.875,6.599,695,0.629,13.198,27,28,346
1997,3339,5978,6614,350530,349195,437,6.636,380,5.77,37769,9598,28171,2.749,10.816,34448,12638,21810,3.619,9.865,3321,0.951,19.73,275,278,5225
1997,3341,1611,1706,221149,216631,211,12.419,197,11.595,27529,3478,24051,1.605,12.708,18502,7477,11025,3.451,8.541,9027,4.167,17.082,143,144,2363
1997,3342,1812,2011,243369,239617,148,7.318,171,8.455,30301,3067,27234,1.28,12.646,22806,5742,17064,2.396,9.518,7495,3.128,19.035,101,101,1592
1997,3343,491,525,32021,31572,66,12.583,65,12.393,4480,1380,3100,4.371,14.19,3582,893,2689,2.829,11.346,898,2.844,22.691,47,47,317
1997,3344,5094,5706,550657,544983,517,9.107,459,8.085,63021,16526,46495,3.032,11.564,52193,12413,39780,2.278,9.577,10828,1.987,19.154,338,339,5260
1997,3345,4534,5136,481830,483839,357,6.952,355,6.913,53621,15980,37641,3.303,11.082,58393,23538,34855,4.865,12.069,-4772,-0.986,22.165,245,245,2494
1997,3346,758,825,48290,47137,105,12.971,74,9.141,7405,1459,5946,3.095,15.71,5111,1152,3959,2.444,10.843,2294,4.867,21.686,60,60,496
1997,3351,1122,1230,72991,72975,79,6.34,111,8.909,6424,1001,5423,1.372,8.803,6345,1537,4808,2.106,8.695,79,0.108,17.39,77,77,887
1997,3352,239,307,99760,101354,20,6.39,32,10.224,6338,1323,5015,1.305,6.253,9686,2592,7094,2.557,9.557,-3348,-3.303,12.507,27,27,573
1997,3353,2384,2797,207188,206786,163,5.843,148,5.306,17052,3996,13056,1.932,8.246,16168,6029,10139,2.916,7.819,884,0.427,15.637,90,91,980
1997,3359,1750,2121,191137,188855,154,7.247,162,7.624,17982,2288,15694,1.212,9.522,13528,4788,8740,2.535,7.163,4454,2.358,14.326,96,96,1825
1997,3361,266,331,225540,217136,54,16.641,41,12.635,22888,4586,18302,2.112,10.541,6359,314,6045,0.145,2.929,16529,7.612,5.857,25,25,228
1997,3362,1783,1963,120527,123901,165,8.371,181,9.183,11802,2062,9740,1.664,9.525,18575,7097,11478,5.728,14.992,-6773,-5.466,19.051,121,121,3518
1997,3363,4587,5639,781708,763524,430,7.646,400,7.112,84973,21051,63922,2.757,11.129,48497,11761,36736,1.54,6.352,36476,4.777,12.703,241,245,3015
1997,3364,1375,1653,446363,433744,116,6.994,127,7.658,53919,5573,48346,1.285,12.431,27075,17507,9568,4.036,6.242,26844,6.189,12.484,70,70,970
1997,3365,164,221,28598,29471,12,5.322,21,9.313,2384,475,1909,1.612,8.089,3895,691,3204,2.345,13.217,-1511,-5.127,16.179,11,11,145
1997,3366,1474,1585,141063,139381,175,11.171,138,8.809,17038,4745,12293,3.404,12.224,13551,2047,11504,1.469,9.722,3487,2.502,19.445,81,82,1330
1997,3369,629,654,37208,36704,80,12.167,87,13.232,4220,613,3607,1.67,11.497,3338,1032,2306,2.812,9.094,882,2.403,18.189,57,57,361
1997,3371,13063,13562,376689,375597,1527,11.221,1621,11.911,45579,12348,33231,3.288,12.135,43281,16523,26758,4.399,11.523,2298,0.612,23.047,1231,1237,9449
1997,3372,4044,4259,176541,172938,374,8.864,295,6.991,22253,3481,18772,2.013,12.868,14977,4955,10022,2.865,8.66,7276,4.207,17.321,218,221,2540
1997,3379,998,1118,40736,40560,71,6.253,106,9.335,4616,736,3880,1.815,11.381,4240,1677,2563,4.135,10.454,376,0.927,20.907,88,88,1049
1997,3391,11088,11624,269919,269881,928,7.975,953,8.19,31470,7473,23997,2.769,11.661,31556,12812,18744,4.747,11.693,-86,-0.032,23.321,714,727,7162
1997,3399,16492,17066,425478,424623,1795,10.53,1757,10.307,56846,16550,40296,3.898,13.387,55002,16520,38482,3.891,12.953,1844,0.434,25.906,1429,1437,10827
1997,4231,17375,21332,278620,276184,2174,9.92,3341,15.245,48011,13152,34859,4.762,17.384,42834,19372,23462,7.014,15.509,5177,1.874,31.019,1926,2037,10176
1997,4232,9529,10689,136131,133863,1232,11.59,1113,10.471,22771,5683,17088,4.245,17.011,18402,6752,11650,5.044,13.747,4369,3.264,27.494,782,801,4137
1997,4233,8271,11090,139003,136558,1271,11.459,1274,11.486,25820,8635,17185,6.323,18.908,20813,9854,10959,7.216,15.241,5007,3.667,30.482,872,902,5779
1997,4234,28649,36468,636722,622585,4455,12.146,4877,13.296,139390,41934,97456,6.735,22.389,111095,49577,61518,7.963,17.844,28295,4.545,35.688,2934,3131,21615
1997,4235,7843,10379,159538,155555,813,7.864,731,7.071,24024,6431,17593,4.134,15.444,16124,4698,11426,3.02,10.365,7900,5.079,20.731,444,455,2916
1997,4236,19581,28612,397305,388498,3075,10.784,2879,10.097,75588,21487,54101,5.531,19.456,57509,22822,34687,5.874,14.803,18079,4.654,29.606,1623,1708,11838
1997,4237,11307,15967,184158,181854,1201,7.515,1230,7.696,27206,7710,19496,4.24,14.96,22520,7378,15142,4.057,12.384,4686,2.577,24.767,732,755,4182
1997,4238,49669,64648,714644,708699,5170,8.007,5005,7.752,102376,26123,76253,3.686,14.446,90630,30958,59672,4.368,12.788,11746,1.657,25.576,3080,3172,16580
1997,4239,27946,30213,311024,309971,4007,13.324,3727,12.393,57863,20766,37097,6.699,18.667,56130,21212,34918,6.843,18.108,1733,0.559,36.216,2861,2890,12853
1997,4241,9829,12728,199154,199292,1052,8.229,1164,9.105,26178,6304,19874,3.163,13.135,26475,11502,14973,5.771,13.285,-297,-0.149,26.271,699,710,5130
1997,4242,4826,6228,163853,160280,1051,17.292,751,12.356,32797,9418,23379,5.876,20.462,26030,11886,14144,7.416,16.24,6767,4.222,32.481,478,485,4331
1997,4243,13681,14728,176539,175587,2172,14.764,2139,14.54,34598,9612,24986,5.474,19.704,32608,13337,19271,7.596,18.571,1990,1.133,37.142,1708,1716,9174
1997,4244,27891,33567,740948,733163,3590,10.638,3953,11.713,121051,33506,87545,4.57,16.511,105486,43580,61906,5.944,14.388,15565,2.123,28.776,2823,2857,23280
1997,4245,5306,8220,71507,72272,488,5.847,739,8.855,10405,2626,7779,3.633,14.397,11825,4129,7696,5.713,16.362,-1420,-1.965,28.794,421,454,2597
1997,4246,9692,13627,156044,156096,1277,9.395,1208,8.887,27155,9084,18071,5.819,17.396,27661,9671,17990,6.196,17.721,-506,-0.324,34.793,588,624,4074
1997,4247,7398,10415,125874,127194,571,5.382,958,9.03,19065,3791,15274,2.98,14.989,21562,8817,12745,6.932,16.952,-2497,-1.963,29.978,408,430,2749
1997,4248,3193,4125,138841,138383,253,6.047,371,8.867,15712,4164,11548,3.009,11.354,14856,5803,9053,4.193,10.735,856,0.619,21.471,229,246,3164
1997,4249,22059,26347,335610,333941,3747,14.165,3957,14.959,64757,21021,43736,6.295,19.392,61695,25672,36023,7.688,18.475,3062,0.917,36.95,2803,2834,13355
1997,4251,33701,36015,300963,298940,4004,11.182,3591,10.028,54682,16953,37729,5.671,18.292,50793,22281,28512,7.453,16.991,3889,1.301,33.982,2314,2337,11899
1997,4411,41980,44788,1118419,1102335,4650,10.443,4125,9.264,144413,45949,98464,4.168,13.101,112000,42973,69027,3.898,10.16,32413,2.94,20.321,3123,3154,29225
1997,4412,11520,12364,101810,99908,1214,9.876,1072,8.72,18031,5459,12572,5.464,18.048,14087,5315,8772,5.32,14.1,3944,3.948,28.2,803,825,3762
1997,4413,37654,61253,531597,528620,4957,8.117,4597,7.527,77256,30105,47151,5.695,14.615,71768,22593,49175,4.274,13.576,5488,1.038,27.153,2834,3035,13020
1997,4421,19813,27514,253111,252968,3305,12.076,3014,11.013,45312,18482,26830,7.306,17.912,45225,16094,29131,6.362,17.878,87,0.034,35.756,1969,2148,9414
1997,4422,23974,32395,231419,228149,3570,11.045,3427,10.602,46106,18017,28089,7.897,20.209,39931,14395,25536,6.309,17.502,6175,2.707,35.004,2048,2202,7590
1997,4431,31827,48725,424453,423910,6311,13.05,5579,11.537,88780,39041,49739,9.21,20.943,88322,35118,53204,8.284,20.835,458,0.108,41.67,3315,3474,16113
1997,4441,49765,71157,984954,959134,5201,7.332,4750,6.697,155134,68181,86953,7.109,16.174,105017,42074,62943,4.387,10.949,50117,5.225,21.898,2942,3123,18506
1997,4442,16490,20574,172954,170699,1561,7.596,1511,7.353,28124,7551,20573,4.424,16.476,23739,6270,17469,3.673,13.907,4385,2.569,27.814,1046,1064,3713
1997,4451,60012,88195,2607382,2609906,9852,11.154,10119,11.456,356907,177187,179720,6.789,13.675,362468,114270,248198,4.378,13.888,-5561,-0.213,27.35,6801,6968,42107
1997,4452,15928,19745,124903,127492,2519,12.445,3510,17.341,26743,11451,15292,8.982,20.976,31342,16181,15161,12.692,24.584,-4599,-3.607,41.952,2121,2172,8976
1997,4453,23072,26599,127682,128797,2276,8.44,3011,11.166,21406,7214,14192,5.601,16.62,23754,9957,13797,7.731,18.443,-2348,-1.823,33.24,2116,2179,6731
1997,4461,41280,78499,897700,838767,8330,10.711,6874,8.839,224574,68061,156513,8.114,26.774,108081,43296,64785,5.162,12.886,116493,13.889,25.771,4101,4515,25732
1997,4471,65681,118123,905959,909264,9991,8.414,11243,9.468,163658,63628,100030,6.998,17.999,168781,64512,104269,7.095,18.562,-5123,-0.563,35.998,7117,7566,39523
1997,4481,39802,87329,885738,897434,9959,11.097,14797,16.487,167336,74696,92640,8.323,18.646,187872,84574,103298,9.424,20.934,-20536,-2.288,37.292,5729,6973,27040
1997,4482,7021,28635,181496,183086,2371,8.019,4232,14.314,38844,16361,22483,8.936,21.216,41367,19484,21883,10.642,22.594,-2523,-1.378,42.433,877,1055,5135
1997,4483,18677,28402,163097,157042,2959,10.437,2859,10.084,38748,11460,27288,7.297,24.674,26233,9427,16806,6.003,16.704,12515,7.969,33.409,1664,1779,4716
1997,4511,30864,41944,359991,369535,4713,11.071,5966,14.014,64497,25994,38503,7.034,17.454,83004,32466,50538,8.786,22.462,-18507,-5.008,34.907,3634,4037,16930
1997,4512,8025,13684,129076,126156,1339,9.68,1637,11.834,26720,10122,16598,8.023,21.18,20521,8406,12115,6.663,16.266,6199,4.914,32.533,1033,1074,4866
1997,4522,79,6245,1053517,1065895,174,2.783,190,3.039,97677,26683,70994,2.503,9.164,122436,19360,103076,1.816,11.487,-24759,-2.323,18.328,5,5,390
1997,4523,9058,27840,1466194,1400371,3111,11.178,3095,11.12,265956,71757,194199,5.124,18.992,137154,46518,90636,3.322,9.794,128802,9.198,19.588,1452,1827,11877
1997,4531,22422,23637,121869,122257,2353,9.835,2928,12.239,22514,7127,15387,5.83,18.415,23161,9136,14025,7.473,18.945,-647,-0.529,36.831,2283,2314,6875
1997,4532,29740,40853,313406,304772,5576,13.75,4975,12.268,70932,31526,39406,10.344,23.274,54355,20795,33560,6.823,17.835,16577,5.439,35.669,3432,3614,13227
1997,4533,12713,16066,95560,93325,2323,14.646,1912,12.055,18993,8245,10748,8.835,20.352,14493,5456,9037,5.846,15.53,4500,4.822,31.059,1514,1527,3651
1997,4539,29444,35846,220012,213960,5877,16.652,4773,13.524,56881,26962,29919,12.601,26.585,44535,18298,26237,8.552,20.815,12346,5.77,41.629,3552,3663,13953
1997,4541,7935,8697,198394,190286,1359,15.981,973,11.442,39592,13889,25703,7.299,20.807,23229,9330,13899,4.903,12.207,16363,8.599,24.415,665,678,4320
1997,4542,5164,5877,69794,69953,733,12.484,722,12.297,11108,5217,5891,7.458,15.879,11357,5268,6089,7.531,16.235,-249,-0.356,31.758,506,532,2477
1997,4543,19073,25135,218410,221733,2812,11.224,2650,10.577,38860,13953,24907,6.293,17.526,45669,20378,25291,9.19,20.596,-6809,-3.071,35.051,1686,1741,8998
1997,4811,609,2993,489934,481216,272,9.083,275,9.184,46101,6533,39568,1.358,9.58,28895,3054,25841,0.635,6.005,17206,3.576,12.009,75,82,1827
1997,4812,1472,1613,25472,25623,227,14.25,187,11.739,4802,1645,3157,6.42,18.741,5168,880,4288,3.434,20.17,-366,-1.428,37.483,110,114,574
1997,4831,762,1149,53251,51901,133,11.801,89,7.897,9231,3652,5579,7.037,17.786,6331,1821,4510,3.509,12.198,2900,5.588,24.397,36,36,971
1997,4832,485,530,17961,17041,49,9.432,28,5.39,3352,281,3071,1.649,19.671,1563,88,1475,0.516,9.172,1789,10.499,18.345,20,20,59
1997,4841,31615,39816,850135,832343,7095,18.207,5398,13.853,149797,49452,100345,5.941,17.997,114076,39584,74492,4.756,13.705,35721,4.292,27.411,3992,4045,21496
1997,4842,47560,50805,476100,479872,7639,14.923,8409,16.427,98240,35628,62612,7.424,20.472,106165,50322,55843,10.487,22.124,-7925,-1.651,40.944,6440,6512,31335
1997,4851,456,556,28900,28630,90,16.379,77,14.013,4499,1662,2837,5.805,15.715,3977,1681,2296,5.872,13.891,522,1.823,27.783,53,53,979
1997,4852,189,340,16524,15953,25,7.123,47,13.39,2756,226,2530,1.417,17.276,1603,613,990,3.843,10.048,1153,7.227,20.097,17,17,244
1997,4853,5518,5593,58750,57968,960,17.221,923,16.558,14592,6111,8481,10.542,25.173,13307,7522,5785,12.976,22.956,1285,2.217,45.912,766,772,5284
1997,4854,3221,4246,148776,147149,404,9.479,436,10.23,28096,11692,16404,7.946,19.094,25131,10872,14259,7.388,17.079,2965,2.015,34.157,238,244,3145
1997,4855,1265,1382,29574,29063,150,10.965,122,8.918,5561,1450,4111,4.989,19.134,4534,1404,3130,4.831,15.601,1027,3.534,31.201,91,92,970
1997,4859,2099,2274,44746,43654,376,17.056,237,10.751,9658,3056,6602,7.001,22.124,7462,2882,4580,6.602,17.094,2196,5.03,34.187,173,173,1401
1997,4861,44,363,7669,7824,14,3.694,46,12.137,942,299,643,3.822,12.04,1257,436,821,5.573,16.066,-315,-4.026,24.08,4,4,108
1997,4862,126,1425,33586,34949,156,11.183,96,6.882,4267,2013,2254,5.76,12.209,6966,1877,5089,5.371,19.932,-2699,-7.723,24.418,22,22,578
1997,4869,50,470,5760,5946,42,8.554,84,17.108,686,258,428,4.339,11.538,1029,744,285,12.514,17.307,-343,-5.769,23.076,4,4,7
1997,4871,325,362,8153,7837,54,14.835,58,15.934,1788,469,1319,5.984,22.815,1163,420,743,5.359,14.84,625,7.975,29.68,38,38,220
1997,4872,1134,1168,12885,12329,172,14.632,187,15.908,3554,1845,1709,14.965,28.826,2493,904,1589,7.332,20.221,1061,8.606,40.441,136,136,578
1997,4879,131,135,1574,1508,22,16.117,25,18.315,462,81,381,5.373,30.647,323,220,103,14.594,21.426,139,9.221,42.852,15,15,42
1997,4881,2972,3865,108232,106903,511,13.28,477,12.396,19870,6346,13524,5.936,18.587,17377,8027,9350,7.509,16.255,2493,2.332,32.51,286,288,3230
1997,4882,433,789,19280,19026,110,14.058,97,12.396,3661,1870,1791,9.829,19.242,3264,1310,1954,6.885,17.155,397,2.087,34.311,55,55,746
1997,4883,1715,2204,72446,71564,213,9.569,257,11.545,13858,1736,12122,2.426,19.365,12055,4135,7920,5.778,16.845,1803,2.519,33.69,142,152,1588
1997,4884,5494,5723,44718,42300,936,16.749,667,11.935,11264,5334,5930,12.61,26.629,6501,2830,3671,6.69,15.369,4763,11.26,30.738,520,527,2145
1997,4885,10727,14265,138359,133384,2101,15.034,1521,10.884,31772,11539,20233,8.651,23.82,21883,9753,12130,7.312,16.406,9889,7.414,32.812,982,1002,5239
1997,4889,733,791,19366,14728,150,19.108,138,17.58,11522,10754,768,73.02,78.235,2719,1404,1315,9.533,18.462,8803,59.773,36.924,106,111,1298
1997,4921,1739,5101,463193,461275,558,11.076,432,8.575,41448,7589,33859,1.645,8.986,36722,5193,31529,1.126,7.961,4726,1.025,15.922,325,328,4002
1997,4922,4390,4779,68248,69249,891,18.883,770,16.319,17037,7442,9595,10.747,24.603,18907,7952,10955,11.483,27.303,-1870,-2.7,49.205,583,604,5488
1997,4931,6410,11609,502697,490816,1484,13.035,1035,9.091,105349,39982,65367,8.146,21.464,81410,25528,55882,5.201,16.587,23939,4.877,33.173,398,418,5510
1997,5111,16010,19021,690503,689730,1937,10.19,1912,10.059,78828,18048,60780,2.617,11.429,77093,23411,53682,3.394,11.177,1735,0.252,22.355,1493,1498,9072
1997,5112,8439,10551,251714,234666,1842,18.189,994,9.815,71821,23911,47910,10.189,30.606,37596,14936,22660,6.365,16.021,34225,14.585,32.042,602,628,9642
1997,5121,11520,15820,251106,244230,2288,14.537,2126,13.508,65208,37325,27883,15.283,26.699,52414,18973,33441,7.769,21.461,12794,5.239,42.922,1273,1338,7493
1997,5122,2311,2422,19357,18836,433,18.402,295,12.537,4018,1707,2311,9.063,21.332,2981,1321,1660,7.013,15.826,1037,5.506,31.653,228,228,970
1997,5151,5898,8012,243791,240755,974,11.947,1256,15.405,47767,18860,28907,7.834,19.841,41296,18981,22315,7.884,17.153,6471,2.688,34.305,868,910,12027
1997,5152,242,436,24477,23010,66,14.553,101,22.271,7500,1944,5556,8.449,32.595,4599,3569,1030,15.511,19.987,2901,12.608,39.975,32,32,385
1997,5173,6829,30159,1105961,1091383,4154,13.883,3680,12.299,219242,73640,145602,6.747,20.088,189094,66350,122744,6.079,17.326,30148,2.762,34.652,1126,1192,13353
1997,5174,336,468,11500,10594,83,18.322,53,11.7,3778,1819,1959,17.17,35.662,1910,1111,799,10.487,18.029,1868,17.633,36.058,33,33,386
1997,5179,4037,4508,62714,54109,1714,42.952,679,17.015,26477,12916,13561,23.871,48.933,9225,4719,4506,8.721,17.049,17252,31.884,34.098,387,388,2246
1997,5182,4162,7388,308340,307548,1415,19.068,1481,19.957,65310,29685,35625,9.652,21.236,63489,23891,39598,7.768,20.644,1821,0.592,41.287,550,558,6378
1997,5191,2706,3323,46482,46283,254,7.664,236,7.121,8138,2928,5210,6.326,17.583,7407,1610,5797,3.479,16.004,731,1.579,32.007,175,179,904
1997,5211,12,42,22130,22387,0,0,(D),(D),171,0,171,0,0.764,699,(D),694,(D),3.122,-528,-2.359,1.528,0,0,0
1997,5221,19336,103067,1922877,1921300,11859,11.648,9353,9.186,383391,177127,206264,9.219,19.955,379751,184447,195304,9.6,19.765,3640,0.189,39.531,658,1109,16232
1997,5222,16918,43096,522972,509905,6968,16.519,5137,12.179,142171,69179,72992,13.567,27.882,114379,56925,57454,11.164,22.431,27792,5.45,44.863,1597,1783,10732
1997,5223,9901,14083,156018,146912,3440,25.89,1848,13.908,47208,18435,28773,12.548,32.134,28435,12960,15475,8.822,19.355,18773,12.778,38.71,1042,1089,6738
1997,5231,10589,27432,477953,446237,4580,17.097,3294,12.296,134894,36340,98554,8.144,30.229,68139,25278,42861,5.665,15.27,66755,14.96,30.539,852,878,6366
1997,5232,19,31,5937,5975,0,0,12,32.432,97,0,97,0,1.624,171,41,130,0.686,2.862,-74,-1.239,3.247,5,5,14
1997,5239,20981,23463,243640,235000,4620,20.464,2847,12.61,63778,22922,40856,9.754,27.14,46312,19566,26746,8.326,19.707,17466,7.432,39.414,1920,1927,9575
1997,5241,4412,36257,1547333,1546528,4345,11.668,6311,16.947,217557,78785,138772,5.094,14.067,214886,80132,134754,5.181,13.895,2671,0.173,27.789,383,408,5626
1997,5242,111133,122190,731623,723371,13262,10.939,11361,9.371,135521,53642,81879,7.416,18.735,119549,53678,65871,7.421,16.527,15972,2.208,33.053,7401,7541,25832
1997,5259,152,160,1484,2027,29,15.065,94,48.831,234,104,130,5.131,11.544,1348,1230,118,60.681,66.502,-1114,-54.958,23.088,62,62,730
1997,5311,88829,98701,496802,496048,11334,11.486,11291,11.442,102250,44322,57928,8.935,20.613,100526,50224,50302,10.125,20.265,1724,0.348,40.531,8765,8859,36291
1997,5312,45690,51274,221215,218934,7969,15.694,6973,13.733,54866,24238,30628,11.071,25.061,50770,25169,25601,11.496,23.19,4096,1.871,46.379,4696,4844,16928
1997,5313,38444,44943,451996,443158,6097,13.828,4394,9.966,100525,37711,62814,8.51,22.684,82830,34639,48191,7.816,18.691,17695,3.993,37.382,2811,2872,18925
1997,5321,4531,9611,154139,149667,1041,10.846,1015,10.575,30119,5517,24602,3.686,20.124,21061,8343,12718,5.574,14.072,9058,6.052,28.144,546,592,3744
1997,5322,18106,31452,228072,218701,5423,17.598,4152,13.473,65537,35174,30363,16.083,29.966,47666,20233,27433,9.251,21.795,17871,8.171,43.59,2915,3151,13291
1997,5323,3537,6024,39008,39143,538,8.897,584,9.658,6522,2294,4228,5.861,16.662,6834,3185,3649,8.137,17.459,-312,-0.797,33.324,364,411,2000
1997,5324,7236,10359,130708,125219,1525,14.896,1282,12.523,32465,11550,20915,9.224,25.927,21261,9700,11561,7.746,16.979,11204,8.948,33.958,814,860,6425
1997,5331,1631,1754,18815,18890,286,16.647,214,12.456,5124,2117,3007,11.207,27.126,5318,2743,2575,14.521,28.153,-194,-1.027,54.252,158,158,2234
1997,5411,153924,161248,1019278,1009538,15879,9.894,14362,8.949,144179,46987,97192,4.654,14.282,124661,41265,83396,4.088,12.348,19518,1.933,24.697,10821,10936,30826
1997,5412,83582,88682,946465,923361,9725,11.024,8797,9.972,193816,69012,124804,7.474,20.99,147809,47320,100489,5.125,16.008,46007,4.983,32.015,6202,6276,32416
1997,5413,77534,86683,1066892,1049642,11236,13.177,8411,9.864,201106,56528,144578,5.385,19.159,166255,62253,104002,5.931,15.839,34851,3.32,31.678,5631,5736,26950
1997,5414,21738,21943,112411,110229,3812,17.748,2883,13.423,27075,11647,15428,10.566,24.563,22961,10416,12545,9.449,20.83,4114,3.732,41.661,2251,2254,7669
1997,5415,51055,57095,740723,682768,15342,28.784,7754,14.548,247927,83709,164218,12.26,36.312,131501,61838,69663,9.057,19.26,116426,17.052,38.52,5310,5373,32911
1997,5416,52667,55949,459071,442387,13315,24.826,8682,16.188,131087,60724,70363,13.726,29.632,98551,47726,50825,10.788,22.277,32536,7.355,44.554,6363,6432,31260
1997,5417,8643,10905,476987,480001,1648,15.431,1198,11.217,81628,25357,56271,5.283,17.006,86658,24839,61819,5.175,18.054,-5030,-1.048,34.012,664,677,5548
1997,5418,31198,34254,424805,416451,5034,14.823,4449,13.1,82020,28207,53813,6.773,19.695,65667,26096,39571,6.266,15.768,16353,3.927,31.536,3421,3491,19936
1997,5419,39099,44903,389778,383920,4076,9.132,3535,7.92,72440,21151,51289,5.509,18.869,60678,22463,38215,5.851,15.805,11762,3.064,31.61,2392,2479,13096
1997,5511,27930,50791,3238532,3239488,5045,9.814,6276,12.209,608447,172250,436197,5.317,18.782,607090,219161,387929,6.765,18.74,1357,0.042,37.481,1286,1388,23044
1997,5611,18663,20996,331456,316630,5025,25.291,2770,13.942,103422,51609,51813,16.299,32.663,74383,39537,34846,12.487,23.492,29039,9.171,46.984,2056,2086,29448
1997,5612,1145,2312,106860,100720,591,28.19,160,7.632,28034,12826,15208,12.734,27.834,15978,5161,10817,5.124,15.864,12056,11.97,31.728,48,51,755
1997,5613,23406,37081,3116197,2971691,6988,19.474,4593,12.8,1031032,353316,677716,11.889,34.695,739123,232542,506581,7.825,24.872,291909,9.823,49.744,2510,2660,119748
1997,5614,24793,29324,578656,541017,4807,16.529,4325,14.871,174161,80723,93438,14.921,32.191,98837,42936,55901,7.936,18.269,75324,13.923,36.537,3169,3262,26862
1997,5615,25509,32552,282552,279112,3781,11.525,4292,13.082,59721,22017,37704,7.888,21.397,52374,24406,27968,8.744,18.765,7347,2.632,37.529,2619,2692,12313
1997,5616,15274,19001,643379,628945,2838,15.126,2360,12.579,132198,42913,89285,6.823,21.019,104409,35080,69329,5.578,16.601,27789,4.418,33.201,1696,1704,18674
1997,5617,111172,116298,1333314,1299159,20029,17.445,17052,14.852,317616,109466,208150,8.426,24.448,248525,96851,151674,7.455,19.13,69091,5.318,38.259,13554,13569,65924
1997,5619,20536,22489,333240,318780,4273,19.58,2942,13.481,85114,31157,53957,9.774,26.7,55999,21681,34318,6.801,17.567,29115,9.133,35.133,2244,2250,15369
1997,5621,6425,7453,139319,133557,857,11.782,499,6.86,27252,9681,17571,7.249,20.405,15866,3644,12222,2.728,11.88,11386,8.525,23.759,359,361,2660
1997,5622,1410,2143,56865,61475,289,13.166,393,17.904,12207,5822,6385,9.471,19.857,21663,8112,13551,13.196,35.239,-9456,-15.382,39.714,195,218,2910
1997,5629,5045,5565,84807,82943,777,14.032,722,13.038,21415,7567,13848,9.123,25.819,17448,5369,12079,6.473,21.036,3967,4.783,42.073,529,532,4034
1997,6111,15401,17607,636181,621634,884,5.061,607,3.475,66126,11139,54987,1.792,10.637,36944,8350,28594,1.343,5.943,29182,4.694,11.886,388,396,6239
1997,6112,551,817,73091,72516,31,3.769,42,5.106,6755,671,6084,0.925,9.315,5763,869,4894,1.198,7.947,992,1.368,15.894,22,28,518
1997,6113,2264,2782,1180256,1165932,175,6.385,93,3.393,75452,2055,73397,0.176,6.471,46396,2485,43911,0.213,3.979,29056,2.492,7.959,59,62,2098
1997,6114,5038,5592,59264,56338,1085,20.096,699,12.947,17205,7292,9913,12.943,30.539,11377,5048,6329,8.96,20.194,5828,10.345,40.388,524,533,3862
1997,6115,5230,6144,66448,63785,810,13.402,610,10.093,14962,4765,10197,7.47,23.457,9675,3449,6226,5.407,15.168,5287,8.289,30.336,399,407,2144
1997,6116,19051,20347,154702,149900,3225,16.135,2507,12.543,38719,15323,23396,10.222,25.83,28868,10887,17981,7.263,19.258,9851,6.572,38.516,1967,1981,7925
1997,6117,2872,3090,28618,27386,578,19.051,466,15.359,7068,2264,4804,8.267,25.809,4619,1898,2721,6.931,16.866,2449,8.943,33.733,373,375,1666
1997,6211,160497,180237,1557793,1531074,16960,9.388,17782,9.843,319672,130472,189200,8.522,20.879,265494,116612,148882,7.616,17.34,54178,3.539,34.681,13336,13776,78567
1997,6212,104755,108284,645420,634719,5619,5.202,5077,4.7,93388,25069,68319,3.95,14.713,72334,22605,49729,3.561,11.396,21054,3.317,22.792,3842,3912,17361
1997,6213,75252,80784,402425,389544,9281,11.598,7754,9.69,99007,42615,56392,10.94,25.416,72419,32693,39726,8.393,18.591,26588,6.825,37.181,5647,5727,23598
1997,6214,9639,19973,492427,481326,3316,17.343,1611,8.426,101752,42275,59477,8.783,21.14,78285,25657,52628,5.33,16.264,23467,4.875,32.529,784,843,13018
1997,6215,5397,8991,145793,147470,2249,26.496,1243,14.644,34686,17117,17569,11.607,23.521,38062,18882,19180,12.804,25.81,-3376,-2.289,47.041,590,616,6552
1997,6216,10684,17782,903537,876442,3499,20.675,1783,10.535,222955,84434,138521,9.634,25.439,168421,58366,110055,6.659,19.216,54534,6.222,38.433,777,908,26128
1997,6219,3949,5871,165101,160142,737,12.179,1098,18.144,48196,23557,24639,14.71,30.096,37652,22352,15300,13.958,23.512,10544,6.584,47.023,548,602,8609
1997,6221,2591,4402,4077384,4077160,169,3.823,207,4.682,330731,96429,234302,2.365,8.112,328982,90361,238621,2.216,8.069,1749,0.043,16.138,91,99,44565
1997,6222,492,788,245288,258388,85,10.753,90,11.385,26794,12706,14088,4.917,10.37,53616,20136,33480,7.793,20.75,-26822,-10.381,20.739,36,41,7665
1997,6223,236,374,136394,138770,31,8.3,30,8.032,12219,3594,8625,2.59,8.805,16903,5449,11454,3.927,12.181,-4684,-3.375,17.61,6,7,2311
1997,6231,7748,14688,1503187,1489968,1192,8.192,918,6.309,176218,70545,105673,4.735,11.827,150926,58180,92746,3.905,10.129,25292,1.697,20.259,518,552,33282
1997,6232,7298,19361,349334,346709,1869,9.938,761,4.046,57247,19645,37602,5.666,16.512,52011,11957,40054,3.449,15.001,5236,1.51,30.003,461,468,7414
1997,6233,11741,14233,400008,391194,2255,16.17,1680,12.047,65984,25515,40469,6.522,16.867,48581,21074,27507,5.387,12.419,17403,4.449,24.837,1095,1127,12392
1997,6239,3395,5639,130732,128996,514,9.127,499,8.861,21445,6571,14874,5.094,16.625,17922,5868,12054,4.549,13.894,3523,2.731,27.787,291,292,3423
1997,6241,28624,40368,652385,631919,4296,10.857,2700,6.823,115980,28496,87484,4.509,18.354,75548,17217,58331,2.725,11.955,40432,6.398,23.911,1588,1623,9121
1997,6242,7700,9556,101876,99985,665,6.98,608,6.382,16219,3327,12892,3.328,16.222,12516,4112,8404,4.113,12.518,3703,3.704,25.036,351,357,2129
1997,6243,5230,7835,284911,283346,633,8.035,720,9.139,47304,6913,40391,2.44,16.695,44349,8015,36334,2.829,15.652,2955,1.043,31.304,290,329,3430
1997,6244,45781,56717,612866,603226,6601,11.736,5663,10.068,107130,39824,67306,6.602,17.76,87748,31953,55795,5.297,14.546,19382,3.213,29.093,4324,4416,23674
1997,7111,7330,7424,108245,105050,1171,15.919,1035,14.07,26677,8583,18094,8.17,25.395,20196,6846,13350,6.517,19.225,6481,6.169,38.45,736,740,4304
1997,7112,3002,3116,85675,84887,562,18.103,539,17.362,17014,5943,11071,7.001,20.043,15571,6334,9237,7.462,18.343,1443,1.7,36.687,383,386,4731
1997,7113,2985,3098,64449,61473,405,12.985,447,14.332,15196,4361,10835,7.094,24.72,9597,3042,6555,4.949,15.612,5599,9.108,31.223,344,344,2120
1997,7114,2140,2195,13721,13127,358,16.721,250,11.677,3815,1328,2487,10.117,29.062,2507,1470,1037,11.198,19.098,1308,9.964,38.196,190,190,1329
1997,7115,7843,7861,32566,33375,1698,22.423,1121,14.804,12446,4887,7559,14.643,37.292,14237,5013,9224,15.02,42.658,-1791,-5.366,74.584,741,744,3263
1997,7121,4685,5052,89923,86621,358,7.183,222,4.454,12147,1510,10637,1.743,14.023,5426,858,4568,0.991,6.264,6721,7.759,12.528,142,142,566
1997,7131,1618,2756,129065,128515,281,10.05,361,12.911,19044,9654,9390,7.512,14.819,18792,5812,12980,4.522,14.622,252,0.196,29.245,243,244,4652
1997,7132,1592,1919,159456,152352,291,15.624,178,9.557,31478,10684,20794,7.013,20.661,16842,5962,10880,3.913,11.055,14636,9.607,22.109,110,116,4743
1997,7139,43797,47522,827920,816457,5327,11.249,4990,10.538,147945,54536,93409,6.68,18.12,125256,48857,76399,5.984,15.341,22689,2.779,30.683,3783,3818,33542
1997,7211,32617,40864,1556606,1544246,5448,13.548,4143,10.303,253039,110980,142059,7.187,16.386,227831,93744,134087,6.071,14.754,25208,1.632,29.507,2809,2873,57667
1997,7212,5021,5439,33957,34790,622,11.475,585,10.792,7115,2152,4963,6.186,20.451,8687,3039,5648,8.735,24.97,-1572,-4.519,40.903,324,324,1715
1997,7213,3153,3229,15827,15950,284,8.776,298,9.209,2543,955,1588,5.988,15.944,2809,1104,1705,6.922,17.612,-266,-1.668,31.888,203,205,820
1997,7223,9293,23634,475593,475336,3325,13.53,5206,21.185,114775,53542,61233,11.264,24.146,114311,57954,56357,12.192,24.048,464,0.098,48.097,2865,2933,24429
1997,7224,47363,47834,316987,319453,5698,11.685,7560,15.503,74102,35572,38530,11.135,23.197,78684,38848,39836,12.161,24.631,-4582,-1.434,46.393,6342,6377,32655
1997,7225,260922,360700,6843630,6761066,53694,15.098,43569,12.251,1424699,791732,632967,11.71,21.072,1255839,490725,765114,7.258,18.575,168860,2.498,37.149,31684,32935,320476
1997,8111,137475,149780,824034,811974,18158,12.223,15705,10.572,165099,70035,95064,8.625,20.333,140817,58096,82721,7.155,17.343,24282,2.99,34.685,11778,12015,43815
1997,8112,13657,16025,137604,140184,2066,12.836,2207,13.712,30462,8976,21486,6.403,21.73,36238,20465,15773,14.599,25.85,-5776,-4.12,43.46,1285,1301,5053
1997,8113,20954,22487,188798,187062,2446,10.911,2307,10.291,32027,9690,22337,5.18,17.121,28569,10552,18017,5.641,15.272,3458,1.849,30.545,1712,1713,7065
1997,8114,24509,26021,146631,147182,3355,12.796,3753,14.314,25177,9589,15588,6.515,17.106,26093,11587,14506,7.873,17.728,-916,-0.622,34.212,2949,2974,8733
1997,8121,74656,85486,456063,454883,11502,13.403,12169,14.18,95216,44099,51117,9.695,20.932,94066,42839,51227,9.418,20.679,1150,0.253,41.358,9222,9467,29931
1997,8122,15915,21479,156653,152328,1683,7.897,1350,6.334,30677,13531,17146,8.883,20.139,21666,6635,15031,4.356,14.223,9011,5.916,28.447,817,853,4056
1997,8123,34307,40855,387321,385979,4344,10.586,4708,11.473,65365,21223,44142,5.498,16.935,62615,26833,35782,6.952,16.222,2750,0.712,32.445,3397,3562,16936
1997,8129,15560,24569,198644,194800,3398,13.806,3484,14.156,44500,17157,27343,8.807,22.844,37053,15355,21698,7.882,19.021,7447,3.823,38.042,1863,1980,7816
1997,8131,154526,154651,1433905,1406369,8248,5.386,5229,3.414,173113,23313,149800,1.658,12.309,117660,16439,101221,1.169,8.366,55453,3.943,16.732,3242,3242,9902
1997,8132,9417,10982,112045,112069,1044,9.596,839,7.712,17493,4085,13408,3.645,15.609,17404,5988,11416,5.343,15.53,89,0.079,31.059,552,558,3181
1997,8133,7838,9393,83387,82984,901,9.67,749,8.039,14098,3397,10701,4.094,16.989,13331,3896,9435,4.695,16.065,767,0.924,32.129,477,482,2542
1997,8134,27999,29716,300898,297891,1412,4.719,1828,6.109,40288,7608,32680,2.554,13.524,34463,6590,27873,2.212,11.569,5825,1.955,23.138,1273,1277,4316
1997,8139,63043,64945,493144,491632,3404,5.201,4414,6.744,65884,13097,52787,2.664,13.401,62867,17900,44967,3.641,12.787,3017,0.614,25.575,3150,3159,12657
1998,1131,256,304,2979,3025,45,15.177,30,10.118,490,116,374,3.835,16.198,579,134,445,4.43,19.14,-89,-2.942,32.397,20,20,64
1998,1132,146,212,1802,1651,67,35.356,22,11.609,692,475,217,28.779,41.927,396,113,283,6.846,23.993,296,17.934,47.985,16,16,76
1998,1133,11686,11758,79879,81049,1478,12.489,1630,13.774,15711,5968,9743,7.363,19.385,18086,6419,11667,7.92,22.315,-2375,-2.93,38.769,1229,1229,4651
1998,1141,1288,1300,7447,8507,238,18.371,229,17.677,2220,933,1287,10.967,26.096,4409,2064,2345,24.262,51.828,-2189,-25.732,52.192,173,173,593
1998,1142,244,244,1997,1950,40,16.563,35,14.493,396,146,250,7.489,20.313,285,121,164,6.207,14.619,111,5.694,29.238,24,24,103
1998,1151,4536,4868,66638,66843,547,11.224,558,11.45,14453,4933,9520,7.38,21.622,14994,4583,10411,6.856,22.432,-541,-0.809,43.245,389,389,2698
1998,1152,2791,2839,17523,17389,485,17.387,386,13.838,3583,1804,1779,10.374,20.605,3300,1164,2136,6.694,18.978,283,1.627,37.955,313,313,924
1998,1153,1235,1267,14159,13900,211,17.154,137,11.138,3198,968,2230,6.964,23.008,2672,687,1985,4.943,19.224,526,3.784,38.447,99,99,591
1998,2111,6066,7234,94717,98137,615,8.43,737,10.103,15713,4854,10859,4.946,16.011,22610,5063,17547,5.159,23.039,-6897,-7.028,32.023,456,462,1592
1998,2121,898,1298,80472,82850,151,11.248,240,17.877,11180,4424,6756,5.34,13.494,15901,5843,10058,7.053,19.193,-4721,-5.698,26.989,141,152,3409
1998,2122,316,434,39864,40565,44,9.8,74,16.481,2770,323,2447,0.796,6.829,4136,891,3245,2.197,10.196,-1366,-3.367,13.657,47,47,173
1998,2123,3262,5054,102219,100491,318,6.303,300,5.946,15375,2492,12883,2.48,15.3,11768,2996,8772,2.981,11.711,3607,3.589,23.421,184,186,1364
1998,2131,7068,8142,171989,165492,1041,12.759,1075,13.176,47458,14462,32996,8.739,28.677,34645,16720,17925,10.103,20.935,12813,7.742,41.869,677,713,8667
1998,2211,1562,8142,553464,552227,885,11.207,394,4.99,53509,26976,26533,4.885,9.69,50921,6509,44412,1.179,9.221,2588,0.469,18.442,67,72,903
1998,2212,569,2682,97507,100175,224,8.366,215,8.03,9427,2691,6736,2.686,9.411,15233,3091,12142,3.086,15.206,-5806,-5.796,18.821,43,45,475
1998,2213,4130,4598,34681,34282,279,6.094,239,5.221,4263,2058,2205,6.003,12.435,3424,1004,2420,2.929,9.988,839,2.447,19.976,169,169,663
1998,2361,128496,129166,668036,657566,22041,17.205,19932,15.558,181378,72137,109241,10.97,27.583,160715,66480,94235,10.11,24.441,20663,3.142,48.882,14154,14159,47859
1998,2362,40147,40932,731072,714899,4663,11.439,4325,10.61,156636,34267,122369,4.793,21.91,124097,27476,96621,3.843,17.359,32539,4.552,34.717,3086,3088,18032
1998,2371,15900,16214,381534,375499,1498,9.323,1206,7.506,74386,14012,60374,3.732,19.81,62280,13890,48390,3.699,16.586,12106,3.224,33.172,869,872,7303
1998,2372,8695,8858,55578,55051,1694,19.341,1495,17.069,16507,7812,8695,14.19,29.985,15353,5673,9680,10.305,27.889,1154,2.096,55.777,1086,1086,3478
1998,2373,10755,11159,265403,263636,933,8.383,874,7.853,48697,9642,39055,3.657,18.471,45083,8106,36977,3.075,17.1,3614,1.371,34.201,603,605,5016
1998,2379,4706,4781,68452,67615,555,11.585,574,11.982,17018,3864,13154,5.715,25.169,15577,4727,10850,6.991,23.038,1441,2.131,46.076,446,446,2492
1998,2381,89976,90334,869198,855429,11828,13.192,10485,11.694,207284,54614,152670,6.384,24.232,179391,51818,127573,6.058,20.971,27893,3.261,41.942,7758,7759,38804
1998,2382,139910,142165,1591688,1554040,15469,10.965,13301,9.428,310898,76355,234543,4.913,20.006,235323,64961,170362,4.18,15.143,75575,4.863,30.285,9989,9997,49795
1998,2383,93372,93944,743745,728251,14963,16.086,13111,14.095,184765,55634,129131,7.639,25.371,153677,51918,101759,7.129,21.102,31088,4.269,42.204,9889,9900,40112
1998,2389,47857,48120,392658,386499,6672,14.043,5457,11.485,90913,26862,64051,6.95,23.522,78447,25871,52576,6.694,20.297,12466,3.225,40.594,3999,4002,18089
1998,3111,1014,1622,47649,46819,103,6.331,113,6.945,6216,2597,3619,5.547,13.277,4643,1202,3441,2.567,9.917,1573,3.36,19.834,75,75,449
1998,3112,502,862,63229,63262,47,5.459,45,5.226,4510,1283,3227,2.028,7.129,4516,562,3954,0.888,7.139,-6,-0.009,14.258,30,30,208
1998,3113,1452,1638,84324,84523,115,7.025,113,6.903,6617,1056,5561,1.249,7.829,6969,1127,5842,1.333,8.245,-352,-0.416,15.657,79,82,473
1998,3114,1321,1719,167591,168292,133,7.824,95,5.588,16818,5317,11501,3.159,9.993,17922,2059,15863,1.223,10.649,-1104,-0.656,19.987,69,69,786
1998,3115,1193,1713,130456,130954,85,4.962,85,4.962,11303,3140,8163,2.398,8.631,12113,4238,7875,3.236,9.25,-810,-0.619,17.263,44,44,457
1998,3116,3454,4071,462886,459504,263,6.419,315,7.689,35409,6715,28694,1.461,7.706,28585,4876,23709,1.061,6.221,6824,1.485,12.442,236,237,2304
1998,3117,647,761,43899,43011,72,9.48,69,9.085,7760,2044,5716,4.752,18.042,6009,1210,4799,2.813,13.971,1751,4.071,27.942,45,45,733
1998,3118,9507,10334,299500,303511,1269,12.369,1120,10.917,33240,10763,22477,3.546,10.952,40813,12400,28413,4.086,13.447,-7573,-2.495,21.904,848,864,6654
1998,3119,2252,2608,142264,142499,225,8.664,203,7.817,15345,3983,11362,2.795,10.768,15789,3827,11962,2.686,11.08,-444,-0.312,21.537,150,153,2203
1998,3121,1919,2371,139283,139253,228,9.612,230,9.696,12025,2217,9808,1.592,8.635,11871,2511,9360,1.803,8.525,154,0.111,17.05,177,185,1583
1998,3122,83,112,30177,30436,18,16.822,8,7.477,1459,168,1291,0.552,4.794,2023,275,1748,0.904,6.647,-564,-1.853,9.587,5,5,143
1998,3131,335,576,82469,82250,40,6.963,37,6.44,6803,2070,4733,2.517,8.271,6280,2135,4145,2.596,7.635,523,0.636,15.271,23,26,974
1998,3132,1660,1989,207983,210982,148,7.443,147,7.393,13765,3107,10658,1.473,6.524,19805,6077,13728,2.88,9.387,-6040,-2.863,13.049,101,103,1921
1998,3133,2195,2367,102238,104505,155,6.351,302,12.375,9672,2722,6950,2.605,9.255,14171,4633,9538,4.433,13.56,-4499,-4.305,18.51,236,240,2603
1998,3141,2777,3020,122498,124896,229,7.506,291,9.538,11099,2473,8626,1.98,8.887,15997,6009,9988,4.811,12.808,-4898,-3.922,17.773,219,224,2242
1998,3149,4380,4511,108140,109757,488,10.828,480,10.65,14616,4464,10152,4.067,13.317,17976,6609,11367,6.022,16.378,-3360,-3.061,26.634,379,380,4549
1998,3151,1070,1166,92457,96599,89,7.546,116,9.835,9229,2768,6461,2.865,9.554,17403,5041,12362,5.218,18.016,-8174,-8.462,19.108,88,91,3038
1998,3152,10148,10878,484067,503977,1587,14.387,1892,17.152,67984,22846,45138,4.533,13.49,107728,43249,64479,8.582,21.376,-39744,-7.886,26.979,1508,1516,28338
1998,3159,1969,2065,56069,57615,189,8.945,285,13.488,6610,2142,4468,3.718,11.473,9684,2796,6888,4.853,16.808,-3074,-5.335,22.946,211,216,1978
1998,3161,301,330,15706,15849,25,7.519,30,9.023,1183,113,1070,0.713,7.464,1473,386,1087,2.435,9.294,-290,-1.83,14.928,22,22,195
1998,3162,335,389,38046,41169,39,10.052,37,9.536,2181,699,1482,1.698,5.298,8632,4453,4179,10.817,20.967,-6451,-15.67,10.595,21,21,394
1998,3169,953,980,27215,28277,90,9.109,106,10.729,2628,656,1972,2.32,9.294,4716,1468,3248,5.191,16.678,-2088,-7.384,18.588,78,78,476
1998,3211,4073,4539,133197,132750,295,6.469,338,7.411,13724,3049,10675,2.297,10.338,12794,3388,9406,2.552,9.638,930,0.701,19.275,252,252,1970
1998,3212,1435,1790,113259,112700,122,6.889,84,4.743,11861,2946,8915,2.614,10.524,10531,3447,7084,3.059,9.344,1330,1.18,18.689,62,62,1153
1998,3219,9177,9931,330814,324859,1048,10.63,903,9.16,46640,12598,34042,3.878,14.357,34910,10524,24386,3.24,10.746,11730,3.611,21.492,690,691,6283
1998,3221,222,525,175597,175100,25,4.789,19,3.64,10751,7508,3243,4.288,6.14,9719,3228,6491,1.844,5.551,1032,0.589,11.101,(D),(D),(D)
1998,3222,3517,5237,399102,400742,280,5.361,252,4.825,34364,9569,24795,2.388,8.575,37143,14494,22649,3.617,9.269,-2779,-0.693,17.15,146,148,2751
1998,3231,37696,39529,834715,833075,2442,6.115,3255,8.151,92251,19108,73143,2.294,11.074,88734,28873,59861,3.466,10.651,3517,0.422,21.303,2585,2594,18460
1998,3241,1119,2138,114444,115293,179,8.475,127,6.013,11890,2828,9062,2.453,10.313,13181,5255,7926,4.558,11.433,-1291,-1.12,20.626,52,54,521
1998,3251,1103,2343,209272,207028,195,8.458,120,5.205,16930,4376,12554,2.114,8.178,12456,1789,10667,0.864,6.017,4474,2.161,12.033,61,62,807
1998,3252,436,760,120111,120499,41,5.402,39,5.138,8381,4208,4173,3.492,6.955,9335,1459,7876,1.211,7.747,-954,-0.792,13.911,21,21,848
1998,3253,660,884,37189,37124,70,7.923,69,7.81,3346,874,2472,2.354,9.013,3252,976,2276,2.629,8.76,94,0.253,17.52,41,41,313
1998,3254,1352,1683,206494,206925,174,10.542,109,6.604,17965,2967,14998,1.434,8.682,18884,6942,11942,3.355,9.126,-919,-0.444,17.364,66,66,870
1998,3255,1626,2076,74920,74640,127,6.116,128,6.164,7846,1806,6040,2.42,10.512,7279,2657,4622,3.56,9.752,567,0.76,19.504,73,73,599
1998,3256,2103,2315,125250,124209,185,8.031,162,7.033,14334,3934,10400,3.167,11.54,12134,3866,8268,3.112,9.769,2200,1.771,19.538,119,121,1854
1998,3259,2133,2796,125917,126394,198,7.084,196,7.013,10973,3220,7753,2.548,8.682,11952,2784,9168,2.203,9.456,-979,-0.775,17.363,128,130,1173
1998,3261,10684,13125,811440,803379,883,6.738,841,6.418,98031,24353,73678,3.031,12.202,82230,27116,55114,3.375,10.236,15801,1.967,20.471,570,584,14224
1998,3262,2075,2596,199208,197397,166,6.399,162,6.245,16876,3652,13224,1.85,8.549,13119,4222,8897,2.139,6.646,3757,1.903,13.292,108,108,1273
1998,3271,1547,1801,78230,79646,143,7.922,151,8.366,7283,2679,4604,3.364,9.144,9944,2345,7599,2.944,12.485,-2661,-3.341,18.288,109,110,573
1998,3272,1834,2107,131455,131684,184,8.777,163,7.775,9434,1925,7509,1.462,7.164,9873,2148,7725,1.631,7.498,-439,-0.333,14.328,114,114,824
1998,3273,5528,8809,193635,190065,538,6.121,499,5.677,28161,6725,21436,3.538,14.817,21109,4924,16185,2.591,11.106,7052,3.71,22.212,257,264,2637
1998,3274,243,376,20113,19779,32,8.637,21,5.668,2018,776,1242,3.923,10.203,1388,258,1130,1.304,7.018,630,3.185,14.035,17,17,196
1998,3279,1998,2384,75579,74121,200,8.451,165,6.972,9338,2942,6396,3.969,12.598,6343,2161,4182,2.916,8.558,2995,4.041,17.115,129,129,1425
1998,3311,204,284,139810,139167,30,10.85,15,5.425,6318,1964,4354,1.411,4.54,5213,618,4595,0.444,3.746,1105,0.794,7.492,9,9,138
1998,3312,502,698,65376,64911,45,6.531,27,3.919,4852,723,4129,1.114,7.475,3907,509,3398,0.784,6.019,945,1.456,12.038,14,14,199
1998,3313,366,537,86573,86332,32,5.959,32,5.959,5423,369,5054,0.427,6.282,4857,1000,3857,1.158,5.626,566,0.656,11.252,21,21,273
1998,3314,708,884,82676,82275,64,7.314,46,5.257,6125,1278,4847,1.553,7.445,5228,691,4537,0.84,6.354,897,1.09,12.709,28,28,141
1998,3315,2383,2694,229099,225487,131,4.874,118,4.391,21410,4831,16579,2.142,9.495,13976,2768,11208,1.228,6.198,7434,3.297,12.396,86,86,1184
1998,3321,2762,2972,148067,144248,158,5.314,160,5.382,18742,4400,14342,3.05,12.993,11010,3821,7189,2.649,7.633,7732,5.36,15.265,107,107,1556
1998,3322,1489,1639,82545,80762,101,6.206,78,4.793,7870,3309,4561,4.097,9.745,4441,775,3666,0.96,5.499,3429,4.246,10.998,60,60,496
1998,3323,11167,12011,389509,380110,924,7.784,642,5.409,51636,13353,38283,3.513,13.585,33212,8607,24605,2.264,8.737,18424,4.847,17.475,472,476,4882
1998,3324,1449,1790,106795,106391,115,6.459,96,5.392,10638,2767,7871,2.601,9.999,9825,1901,7924,1.787,9.235,813,0.764,18.47,75,76,1210
1998,3325,795,873,66108,66169,44,5.011,54,6.15,5323,703,4620,1.062,8.045,5364,1827,3537,2.761,8.107,-41,-0.062,16.089,39,39,737
1998,3326,1617,1794,68963,68970,125,6.999,109,6.103,6705,1195,5510,1.733,9.722,6817,2203,4614,3.194,9.884,-112,-0.162,19.443,74,76,875
1998,3327,25662,26070,444973,429900,2216,8.615,1523,5.921,64338,13015,51323,3.027,14.966,34228,9148,25080,2.128,7.962,30110,7.004,15.924,1165,1167,6139
1998,3328,5603,6119,159060,155567,386,6.331,342,5.609,22735,4871,17864,3.131,14.614,15806,4929,10877,3.168,10.16,6929,4.454,20.321,262,262,3295
1998,3329,5670,6203,314335,311453,560,9.161,380,6.216,29285,6260,23025,2.01,9.403,23345,5403,17942,1.735,7.496,5940,1.907,14.991,278,279,2669
1998,3331,2693,2991,215599,212090,200,6.708,181,6.071,22994,5508,17486,2.597,10.842,16266,5182,11084,2.443,7.669,6728,3.172,15.339,130,130,2258
1998,3332,4135,4388,191978,187123,308,7.035,288,6.578,24334,5299,19035,2.832,13.004,14830,3283,11547,1.754,7.925,9504,5.079,15.851,208,208,1567
1998,3333,2336,2480,133070,133099,176,7.037,218,8.717,13194,3017,10177,2.267,9.913,13165,4386,8779,3.295,9.891,29,0.022,19.782,157,158,1988
1998,3334,1469,1772,169864,171172,109,6.153,108,6.097,13943,3077,10866,1.798,8.146,16452,3534,12918,2.065,9.611,-2509,-1.466,16.291,71,72,1391
1998,3335,9524,9898,248147,245299,532,5.372,542,5.473,26868,5623,21245,2.292,10.953,21120,5269,15851,2.148,8.61,5748,2.343,17.22,418,422,3621
1998,3336,753,908,110571,110408,44,4.862,38,4.199,7615,803,6812,0.727,6.897,7397,1921,5476,1.74,6.7,218,0.197,13.399,21,21,115
1998,3339,6029,6687,364023,358726,407,6.094,391,5.854,38421,8355,30066,2.329,10.71,27929,7849,20080,2.188,7.786,10492,2.925,15.571,282,284,3708
1998,3341,1639,1732,233852,225531,217,12.627,190,11.056,34698,4547,30151,2.016,15.385,18643,4459,14184,1.977,8.266,16055,7.119,16.533,144,145,1314
1998,3342,1855,2066,250427,247087,189,9.229,153,7.471,34032,6744,27288,2.729,13.773,27717,9070,18647,3.671,11.218,6315,2.556,22.435,100,100,1611
1998,3343,480,519,32243,32361,51,9.733,61,11.641,3977,1206,2771,3.727,12.29,4122,1887,2235,5.831,12.738,-145,-0.448,24.579,41,41,602
1998,3344,5164,5817,575956,564753,520,9.007,433,7.5,76687,12922,63765,2.288,13.579,54574,13339,41235,2.362,9.663,22113,3.916,19.327,296,301,4785
1998,3345,4604,5234,499285,493166,342,6.544,326,6.238,51919,17949,33970,3.64,10.528,38748,12943,25805,2.624,7.857,13171,2.671,15.714,203,205,2210
1998,3346,757,827,48802,48980,100,12.173,89,10.834,6686,2298,4388,4.692,13.651,6910,1891,5019,3.861,14.108,-224,-0.457,27.301,65,65,795
1998,3351,1158,1272,75113,74260,101,8.01,79,6.265,7388,1369,6019,1.844,9.949,5705,1139,4566,1.534,7.682,1683,2.266,15.365,57,57,481
1998,3352,239,310,101009,100485,26,8.347,29,9.31,9058,752,8306,0.748,9.014,7752,2563,5189,2.551,7.715,1306,1.3,15.429,13,13,113
1998,3353,2393,2824,208583,209006,167,5.936,146,5.189,21148,4226,16922,2.022,10.118,21506,7574,13932,3.624,10.29,-358,-0.171,20.237,88,88,755
1998,3359,1810,2190,197201,195183,181,8.345,139,6.408,19100,4354,14746,2.231,9.786,15039,3831,11208,1.963,7.705,4061,2.081,15.41,73,74,993
1998,3361,282,346,224057,225203,36,10.573,25,7.342,13037,811,12226,0.36,5.789,15494,961,14533,0.427,6.88,-2457,-1.091,11.578,20,20,107
1998,3362,1819,2012,129063,125099,168,8.436,127,6.377,17060,3955,13105,3.162,13.637,9272,2508,6764,2.005,7.412,7788,6.225,14.824,102,102,1342
1998,3363,4568,5710,804593,798888,390,6.859,342,6.015,78849,25196,53653,3.154,9.87,67372,12116,55256,1.517,8.433,11477,1.437,16.866,225,229,4872
1998,3364,1404,1698,472548,459194,139,8.254,111,6.591,37836,5533,32303,1.205,8.24,11026,2590,8436,0.564,2.401,26810,5.838,4.802,82,84,1117
1998,3365,160,222,30590,29677,12,5.393,13,5.843,4352,393,3959,1.324,14.665,2498,265,2233,0.893,8.417,1854,6.247,16.835,9,9,195
1998,3366,1479,1579,140576,141564,162,10.154,195,12.222,14235,2092,12143,1.478,10.056,16591,7388,9203,5.219,11.72,-2356,-1.664,20.111,124,125,3431
1998,3369,659,686,39450,38382,87,12.966,57,8.495,5117,2383,2734,6.209,13.332,3100,659,2441,1.717,8.077,2017,5.255,16.154,43,43,456
1998,3371,13180,13686,384768,380851,1573,11.546,1449,10.636,49803,11825,37978,3.105,13.077,42043,17323,24720,4.549,11.039,7760,2.038,22.078,1103,1114,9793
1998,3372,4069,4275,186155,182438,303,7.065,331,7.717,25266,4883,20383,2.677,13.849,17841,5012,12829,2.747,9.779,7425,4.07,19.558,248,249,2984
1998,3379,995,1111,44121,42840,74,6.619,88,7.871,5674,1157,4517,2.701,13.245,3131,775,2356,1.809,7.309,2543,5.936,14.617,68,69,567
1998,3391,10987,11592,283840,278862,874,7.524,921,7.929,37420,10153,27267,3.641,13.419,27639,9366,18273,3.359,9.911,9781,3.507,19.823,680,684,4143
1998,3399,16843,17399,438579,435482,1952,11.297,1711,9.902,59589,16709,42880,3.837,13.683,53246,18417,34829,4.229,12.227,6343,1.457,24.454,1350,1352,8748
1998,4231,17057,20976,285831,282257,2101,9.926,2481,11.722,45224,15244,29980,5.401,16.022,38115,16177,21938,5.731,13.504,7109,2.519,27.007,1728,1774,10000
1998,4232,9641,10796,138812,137938,1148,10.661,1093,10.15,22644,6147,16497,4.456,16.416,20737,8371,12366,6.069,15.034,1907,1.383,30.067,793,811,4302
1998,4233,8421,11280,142149,140677,1377,12.289,1228,10.959,25314,9497,15817,6.751,17.994,22174,9081,13093,6.455,15.762,3140,2.232,31.525,793,815,4585
1998,4234,28649,36475,663789,653170,4113,11.259,4224,11.563,129163,39243,89920,6.008,19.775,106119,41210,64909,6.309,16.247,23044,3.528,32.494,2747,2829,19165
1998,4235,7891,10427,164448,163111,696,6.659,746,7.137,21042,4677,16365,2.867,12.9,18187,6070,12117,3.721,11.15,2855,1.75,22.3,444,477,3493
1998,4236,19791,29045,435891,423420,3408,11.791,3123,10.805,90747,30416,60331,7.183,21.432,65097,25557,39540,6.036,15.374,25650,6.058,30.748,1570,1656,9871
1998,4237,11264,16258,192439,189811,1403,8.689,1181,7.314,29216,9037,20179,4.761,15.392,23882,7722,16160,4.068,12.582,5334,2.81,25.164,763,817,4793
1998,4238,49900,65067,755310,739530,4779,7.346,4762,7.32,113300,29697,83603,4.016,15.321,81873,28734,53139,3.885,11.071,31427,4.25,22.142,3036,3142,16262
1998,4239,28144,30445,318700,317745,3659,12.041,3547,11.672,55242,18435,36807,5.802,17.386,53581,19603,33978,6.169,16.863,1661,0.523,33.726,2731,2753,13247
1998,4241,9810,12957,212006,206878,1224,9.509,1054,8.188,31593,11896,19697,5.75,15.271,21455,7940,13515,3.838,10.371,10138,4.9,20.742,663,674,3747
1998,4242,4952,6421,169826,166644,965,15.263,768,12.147,28193,9578,18615,5.748,16.918,21813,8202,13611,4.922,13.09,6380,3.829,26.179,530,536,4957
1998,4243,13833,14886,179393,178673,2008,13.531,1916,12.911,34798,10108,24690,5.657,19.476,33278,11491,21787,6.431,18.625,1520,0.851,37.25,1464,1488,7846
1998,4244,27514,33093,752268,751752,3026,9.057,3664,10.966,101885,26464,75421,3.52,13.553,100286,33437,66849,4.448,13.34,1599,0.213,26.681,2629,2711,16560
1998,4245,5235,8075,72479,72489,425,5.194,641,7.833,10089,2484,7605,3.427,13.918,10152,3692,6460,5.093,14.005,-63,-0.087,27.836,343,384,2088
1998,4246,9707,13635,156137,157159,1089,7.968,1152,8.429,22493,5538,16955,3.524,14.312,24401,9434,14967,6.003,15.526,-1908,-1.214,28.625,637,665,3470
1998,4247,7259,10473,128136,127507,829,7.921,815,7.787,21945,7450,14495,5.843,17.211,20457,6612,13845,5.186,16.044,1488,1.167,32.088,394,405,2477
1998,4248,3230,4112,146016,143846,254,6.132,314,7.581,16694,4519,12175,3.142,11.606,12214,3891,8323,2.705,8.491,4480,3.114,16.982,185,249,2525
1998,4249,22390,26736,349295,345282,3773,14.182,3511,13.197,65931,22967,42964,6.652,19.095,57793,22542,35251,6.529,16.738,8138,2.357,33.476,2513,2578,12808
1998,4251,33952,36273,303732,303004,3420,9.455,3218,8.896,51350,15991,35359,5.277,16.947,49855,19308,30547,6.372,16.454,1495,0.493,32.907,2176,2199,9721
1998,4411,42509,45653,1145661,1141634,4596,10.118,4138,9.11,137521,60102,77419,5.265,12.046,129463,39852,89611,3.491,11.34,8058,0.706,22.68,3225,3258,30778
1998,4412,11712,12598,107037,105242,1162,9.279,1011,8.073,17780,6348,11432,6.032,16.894,14173,4664,9509,4.432,13.467,3607,3.427,26.934,770,785,3379
1998,4413,37416,60890,534312,534203,4172,6.815,4835,7.898,83186,23211,59975,4.345,15.572,81233,30126,51107,5.639,15.206,1953,0.366,30.413,2424,2746,12038
1998,4421,20000,27836,272424,264672,2560,9.206,2502,8.998,51903,18548,33355,7.008,19.61,36541,13187,23354,4.982,13.806,15362,5.804,27.612,1645,1741,7980
1998,4422,24450,32039,240738,236598,3235,10.009,3799,11.754,46930,18361,28569,7.76,19.835,38507,16204,22303,6.849,16.275,8423,3.56,32.551,1922,2048,7177
1998,4431,32674,49568,436795,432662,5683,11.509,5301,10.736,82057,32083,49974,7.415,18.966,73711,28994,44717,6.701,17.037,8346,1.929,34.073,3244,3393,14462
1998,4441,49610,71219,1000331,994137,4161,5.838,4280,6.005,131035,38351,92684,3.858,13.181,118485,38403,80082,3.863,11.918,12550,1.262,23.837,2731,2860,15042
1998,4442,16656,20666,176999,175698,1374,6.638,1441,6.962,26136,6206,19930,3.532,14.876,23389,6986,16403,3.976,13.312,2747,1.563,26.624,949,975,3969
1998,4451,59944,87932,2663967,2642132,8664,9.819,9270,10.506,352094,146517,205577,5.545,13.326,304381,109746,194635,4.154,11.52,47713,1.806,23.041,6223,6394,41699
1998,4452,16028,20455,128968,127511,3227,16.022,2598,12.899,28168,12468,15700,9.778,22.091,25426,11355,14071,8.905,19.94,2742,2.15,39.881,1839,1886,7879
1998,4453,23041,26055,130359,130051,2128,8.053,2870,10.861,23120,7194,15926,5.532,17.778,22261,8983,13278,6.907,17.117,859,0.661,34.234,1782,1812,5363
1998,4461,41233,79526,941820,921950,6733,8.503,6051,7.642,168883,60584,108299,6.571,18.318,129927,43908,86019,4.763,14.093,38956,4.225,28.185,3406,3758,21448
1998,4471,65407,117754,938990,925884,9248,7.83,9957,8.43,178748,60823,117925,6.569,19.306,152360,54844,97516,5.923,16.456,26388,2.85,32.911,5709,6334,32374
1998,4481,39248,86683,924315,907219,8504,9.753,9527,10.926,177324,59770,117554,6.588,19.546,143418,51268,92150,5.651,15.809,33906,3.737,31.617,4628,5091,19274
1998,4482,6939,28779,196295,189671,1941,6.75,1895,6.59,36248,14018,22230,7.391,19.111,22972,8202,14770,4.324,12.111,13276,6.999,24.223,667,739,2559
1998,4483,18951,28723,159903,162462,2753,9.607,2622,9.149,28666,10987,17679,6.763,17.645,34210,14362,19848,8.84,21.057,-5544,-3.412,35.289,1359,1499,4745
1998,4511,30854,41876,383236,373439,4497,10.698,4820,11.466,72452,29462,42990,7.889,19.401,53050,22399,30651,5.998,14.206,19402,5.195,28.412,3163,3404,12246
1998,4512,7858,13590,137502,133736,1363,9.982,1491,10.92,28739,15818,12921,11.828,21.489,21459,8323,13136,6.223,16.046,7280,5.444,32.092,823,895,3384
1998,4522,71,6125,1058795,1052928,119,1.941,131,2.137,87483,14667,72816,1.393,8.309,73676,12876,60800,1.223,6.997,13807,1.311,13.994,3,6,365
1998,4523,9085,28316,1462516,1467075,3200,11.359,2912,10.337,144680,74186,70494,5.057,9.862,155596,36208,119388,2.468,10.606,-10916,-0.744,19.724,1050,1190,5230
1998,4531,22333,23463,122817,123309,2242,9.492,2554,10.813,20889,6920,13969,5.612,16.94,21885,7671,14214,6.221,17.748,-996,-0.808,33.881,1999,2022,5873
1998,4532,29962,41336,337091,326580,4848,11.762,4611,11.187,71829,30355,41474,9.295,21.994,50961,18588,32373,5.692,15.604,20868,6.39,31.209,3168,3253,10941
1998,4533,12932,16352,105522,100614,2048,12.649,1725,10.654,23483,8492,14991,8.44,23.34,13489,4839,8650,4.809,13.407,9994,9.933,26.813,1354,1366,3509
1998,4539,30524,37172,235745,229378,5253,14.322,4264,11.626,54576,21721,32855,9.47,23.793,41454,17439,24015,7.603,18.072,13122,5.721,36.145,3058,3155,12396
1998,4541,8356,9118,214676,207427,1426,15.984,1033,11.579,39784,13177,26607,6.353,19.18,25304,6725,18579,3.242,12.199,14480,6.981,24.398,785,794,4446
1998,4542,5135,5727,66388,68635,648,11.137,831,14.282,9000,2887,6113,4.206,13.113,13747,8070,5677,11.758,20.029,-4747,-6.916,26.226,558,565,2508
1998,4543,19239,25325,221654,220632,2655,10.514,2511,9.943,37282,12195,25087,5.527,16.898,35439,13525,21914,6.13,16.063,1843,0.835,32.125,1754,1791,7721
1998,4811,613,3100,505042,497513,349,11.461,239,7.849,45506,8292,37214,1.667,9.147,30708,3526,27182,0.709,6.172,14798,2.974,12.345,69,82,2051
1998,4812,1519,1665,27006,26640,234,14.216,196,11.908,5710,871,4839,3.27,21.434,5242,1701,3541,6.385,19.677,468,1.757,39.354,153,153,892
1998,4831,773,1180,54458,54115,184,15.808,152,13.058,11331,4985,6346,9.212,20.939,10752,5732,5020,10.592,19.869,579,1.07,39.738,71,88,2296
1998,4832,494,537,18295,18071,55,10.338,45,8.459,2518,702,1816,3.885,13.934,2056,533,1523,2.95,11.378,462,2.557,22.755,32,32,280
1998,4841,33694,41860,890764,873453,7635,18.635,5857,14.295,144353,43312,101041,4.959,16.527,110252,41778,68474,4.783,12.623,34101,3.904,25.245,4273,4421,23744
1998,4842,47855,51273,495646,486847,7212,14.141,6667,13.072,99196,30899,68297,6.347,20.375,81480,29521,51959,6.064,16.736,17716,3.639,33.473,5149,5177,20502
1998,4851,448,561,29429,29056,79,14.107,77,13.75,3557,1007,2550,3.466,12.242,2794,833,1961,2.867,9.616,763,2.626,19.232,64,64,522
1998,4852,193,348,17429,17270,23,6.525,32,9.078,1980,355,1625,2.056,11.465,1666,436,1230,2.525,9.647,314,1.818,19.294,19,19,139
1998,4853,5641,5725,60560,59797,927,16.384,793,14.016,13725,6105,7620,10.21,22.953,12047,4323,7724,7.229,20.146,1678,2.806,40.293,650,656,3503
1998,4854,3207,4253,153199,152527,317,7.446,326,7.657,22636,6754,15882,4.428,14.841,21728,5644,16084,3.7,14.245,908,0.595,28.491,225,227,2568
1998,4855,1247,1378,30824,30454,133,9.599,148,10.682,4995,1152,3843,3.783,16.402,4158,1589,2569,5.218,13.654,837,2.748,27.307,117,118,1354
1998,4859,2163,2332,47503,46793,356,15.385,320,13.829,9985,3465,6520,7.405,21.339,8624,3870,4754,8.27,18.43,1361,2.909,36.86,247,265,2786
1998,4861,45,358,7077,7439,42,11.538,54,14.835,809,372,437,5.001,10.875,1532,549,983,7.38,20.594,-723,-9.719,21.75,(D),(D),(D)
1998,4862,131,1562,32709,32847,233,15.482,119,7.907,5716,1938,3778,5.9,17.402,5822,1670,4152,5.084,17.725,-106,-0.323,34.804,7,11,154
1998,4869,52,541,6109,5955,97,19.113,30,5.911,1105,783,322,13.149,18.556,815,170,645,2.855,13.686,290,4.87,27.372,(D),(D),(D)
1998,4871,329,367,8635,8414,45,12.312,42,11.491,1800,645,1155,7.666,21.393,1319,349,970,4.148,15.676,481,5.717,31.353,34,34,311
1998,4872,1176,1204,12506,12829,171,14.322,151,12.647,2656,1148,1508,8.948,20.703,3358,1598,1760,12.456,26.175,-702,-5.472,41.406,110,111,864
1998,4879,141,145,1764,1705,26,18.246,21,14.737,463,150,313,8.8,27.163,333,83,250,4.869,19.537,130,7.627,39.073,16,16,73
1998,4881,3077,3982,114919,111767,480,12.197,387,9.834,20270,7982,12288,7.142,18.136,14258,5046,9212,4.515,12.757,6012,5.379,25.514,250,252,1810
1998,4882,437,758,19838,19784,96,12.379,131,16.892,3840,1683,2157,8.507,19.41,3698,1820,1878,9.2,18.692,142,0.718,37.385,42,60,476
1998,4883,1748,2252,71441,72371,229,10.228,203,9.067,12898,5121,7777,7.076,17.822,15023,3049,11974,4.213,20.758,-2125,-2.936,35.644,137,139,1627
1998,4884,5678,5919,47085,46201,870,14.92,694,11.902,9732,3753,5979,8.123,21.064,8063,3752,4311,8.121,17.452,1669,3.612,34.904,529,532,2963
1998,4885,11002,14589,148265,143802,1652,11.431,1377,9.528,29367,9069,20298,6.307,20.422,20632,7594,13038,5.281,14.348,8735,6.074,28.695,926,966,4790
1998,4889,795,1576,55278,37277,884,74.788,96,8.122,38680,35185,3495,94.389,103.765,3340,607,2733,1.628,8.96,35340,94.805,17.92,76,77,308
1998,4921,2002,5609,466629,465548,960,17.894,472,8.798,48648,21460,27188,4.61,10.45,43114,7578,35536,1.628,9.261,5534,1.189,18.522,213,216,2671
1998,4922,4418,4809,69600,68816,714,14.887,688,14.345,14404,3627,10777,5.271,20.931,12948,4212,8736,6.121,18.815,1456,2.116,37.631,576,580,3237
1998,4931,6497,11927,512558,508646,1281,10.86,1019,8.639,89696,33673,56023,6.62,17.634,82907,29630,53277,5.825,16.3,6789,1.335,32.599,335,354,3859
1998,5111,15831,19051,710265,698399,1950,10.277,1795,9.461,91349,24587,66762,3.52,13.08,66889,17343,49546,2.483,9.577,24460,3.502,19.155,1344,1354,7915
1998,5112,8530,10720,279265,267791,1387,13.035,1228,11.541,69758,20812,48946,7.772,26.049,46264,17825,28439,6.656,17.276,23494,8.773,34.552,779,801,7734
1998,5121,11870,16078,258800,255658,2276,14.24,2086,13.051,61007,27926,33081,10.923,23.863,54594,23981,30613,9.38,21.354,6413,2.508,42.709,1203,1283,8528
1998,5122,2411,2536,19999,19662,436,17.602,318,12.838,4392,1912,2480,9.725,22.338,3610,1256,2354,6.388,18.361,782,3.977,36.722,244,244,965
1998,5151,5637,7753,239903,241958,800,10.12,1105,13.978,34922,12677,22245,5.239,14.433,38959,20857,18102,8.62,16.102,-4037,-1.668,28.866,746,814,11464
1998,5152,280,622,29999,28709,180,32.028,60,10.676,7745,4030,3715,14.037,26.978,5178,2156,3022,7.51,18.036,2567,8.941,36.072,12,12,572
1998,5173,6979,33714,1183846,1147285,7144,22.342,3666,11.465,283155,128121,155034,11.167,24.68,208019,92137,115882,8.031,18.131,75136,6.549,36.263,906,987,12001
1998,5174,347,551,11077,10525,154,30.647,57,11.343,3766,1385,2381,13.159,35.781,2628,1183,1445,11.24,24.969,1138,10.812,49.938,26,27,361
1998,5179,4572,5235,81296,73936,1621,33.048,961,19.592,32119,14922,17197,20.182,43.442,17366,6671,10695,9.023,23.488,14753,19.954,46.976,671,678,3836
1998,5182,4521,8082,327579,318668,1454,18.764,788,10.169,69210,22749,46461,7.139,21.719,50848,15083,35765,4.733,15.956,18362,5.762,31.913,380,387,3636
1998,5191,2830,3457,51379,48994,363,10.764,194,5.752,9009,3064,5945,6.254,18.388,4317,1105,3212,2.255,8.811,4692,9.577,17.623,130,136,544
1998,5211,15,44,21936,22033,3,6.977,(D),(D),488,42,446,0.191,2.215,683,(D),664,(D),3.1,-195,-0.885,4.43,0,0,0
1998,5221,19090,105989,1965163,1950914,9048,8.65,6278,6.002,302782,109289,193493,5.602,15.52,275084,88390,186694,4.531,14.1,27698,1.42,28.201,415,760,13305
1998,5222,17662,44375,604277,566442,6675,15.255,5437,12.426,175891,76890,99001,13.574,31.052,99531,43600,55931,7.697,17.571,76360,13.481,35.143,1598,1718,10895
1998,5223,11714,16259,185612,169598,3501,22.882,1583,10.346,60323,23207,37116,13.684,35.568,28609,12255,16354,7.226,16.869,31714,18.7,33.738,892,938,5640
1998,5231,11161,29984,471161,481729,5635,19.602,3160,10.993,91520,34814,56706,7.227,18.998,115226,35955,79271,7.464,23.919,-23706,-4.921,37.997,872,901,7468
1998,5232,34,46,6184,6077,13,31.707,3,7.317,588,374,214,6.155,9.677,419,3,416,0.049,6.895,169,2.781,13.791,(D),(D),(D)
1998,5239,22401,25103,263327,257361,4227,17.241,3055,12.461,63149,21803,41346,8.472,24.537,50953,17147,33806,6.663,19.798,12196,4.739,39.597,2041,2069,8658
1998,5241,4566,38295,1555112,1551845,6921,18.597,4761,12.793,256750,86361,170389,5.565,16.545,253667,69327,184340,4.467,16.346,3083,0.199,32.692,281,312,5224
1998,5242,112734,123898,787635,770872,11700,9.486,10571,8.571,144053,46427,97626,6.023,18.687,110284,43800,66484,5.682,14.306,33769,4.381,28.613,7178,7304,24178
1998,5259,224,249,2294,2141,111,52.235,38,17.882,1471,1283,188,59.939,68.722,1190,276,914,12.894,55.594,281,13.128,111.189,25,29,120
1998,5311,88892,99095,507616,506271,10433,10.535,10301,10.402,102659,43857,58802,8.663,20.277,99992,43947,56045,8.681,19.751,2667,0.527,39.501,7530,7703,29524
1998,5312,47057,52658,236420,231532,7688,14.77,6472,12.434,57132,24269,32863,10.482,24.676,47173,20193,26980,8.721,20.374,9959,4.301,40.749,4321,4422,12608
1998,5313,40324,46854,462085,461259,6495,14.095,4947,10.736,97646,37538,60108,8.138,21.169,94923,39301,55622,8.52,20.579,2723,0.59,41.158,2929,3079,21766
1998,5321,4499,10124,172325,164185,1458,14.763,962,9.741,33458,7689,25769,4.683,20.378,17210,7286,9924,4.438,10.482,16248,9.896,20.964,456,531,3444
1998,5322,17332,30744,242382,236186,3407,10.931,4254,13.649,57062,21304,35758,9.02,24.16,45405,19489,25916,8.252,19.224,11657,4.936,38.449,2517,3145,13402
1998,5323,3565,5927,39602,38917,476,8.054,442,7.479,6752,2485,4267,6.385,17.35,5377,2282,3095,5.864,13.817,1375,3.533,27.634,281,292,1494
1998,5324,7371,10722,138114,135108,1523,14.377,1266,11.951,30298,11717,18581,8.672,22.425,23890,9653,14237,7.145,17.682,6408,4.743,35.364,700,826,6092
1998,5331,1673,1791,19968,19815,229,12.829,217,12.157,4192,1460,2732,7.368,21.156,3886,995,2891,5.021,19.611,306,1.544,39.223,143,143,716
1998,5411,155473,162700,1053261,1041151,14697,9.069,13424,8.283,145453,45753,99700,4.394,13.97,121131,37833,83298,3.634,11.634,24322,2.336,23.269,9623,9743,26349
1998,5412,84648,90143,1078001,1018084,9479,10.588,8253,9.218,243806,76964,166842,7.56,23.948,122664,41915,80749,4.117,12.049,121142,11.899,24.097,5636,5667,21247
1998,5413,80374,90102,1173816,1125952,11358,12.816,8397,9.475,241720,95872,145848,8.515,21.468,144299,43343,100956,3.849,12.816,97421,8.652,25.631,5658,5738,23660
1998,5414,22750,22961,123547,119895,3826,16.998,2921,12.977,28255,10995,17260,9.171,23.567,20881,8598,12283,7.171,17.416,7374,6.15,34.832,2233,2242,6854
1998,5415,59932,66511,867504,813799,17733,28.589,8766,14.132,267845,111524,156321,13.704,32.913,160293,61196,99097,7.52,19.697,107552,13.216,39.394,5772,5833,28593
1998,5416,58282,61818,530161,497921,14305,24.203,8877,15.019,156199,64782,91417,13.011,31.37,91744,39965,51779,8.026,18.425,64455,12.945,36.851,6532,6569,27889
1998,5417,8961,11321,513593,499612,1599,14.317,1294,11.586,90000,29442,60558,5.893,18.014,61909,16971,44938,3.397,12.391,28091,5.623,24.783,725,755,4275
1998,5418,32355,35554,447805,438120,5020,14.362,3817,10.921,90217,32330,57887,7.379,20.592,70629,22756,47873,5.194,16.121,19588,4.471,32.242,2784,2803,15098
1998,5419,41265,47931,423288,407169,6544,14.059,3777,8.114,90665,31392,59273,7.71,22.267,57759,20883,36876,5.129,14.186,32906,8.082,28.371,2237,2249,13507
1998,5511,28100,51066,3295193,3273909,5398,10.557,5530,10.815,616063,171787,444276,5.247,18.817,572987,197262,375725,6.025,17.502,43076,1.316,35.003,1119,1190,17973
1998,5611,18776,21726,365799,349224,3540,16.508,2977,13.882,103768,43910,59858,12.574,29.714,70068,29307,40761,8.392,20.064,33700,9.65,40.128,2073,2104,20347
1998,5612,1239,2406,108548,108650,399,16.907,307,13.008,22258,9415,12843,8.665,20.486,22707,8762,13945,8.064,20.899,-449,-0.413,40.972,69,117,2679
1998,5613,24952,40327,3574795,3383791,7061,18.19,4045,10.42,1110286,367504,742782,10.861,32.812,725771,241467,484304,7.136,21.448,384515,11.363,42.897,2397,2519,80985
1998,5614,25699,30488,641016,610858,4806,16.045,3738,12.479,157962,58076,99886,9.507,25.859,97485,40176,57309,6.577,15.959,60477,9.9,31.917,2656,2720,21665
1998,5615,25144,33256,296042,290140,4093,12.415,3519,10.674,57958,23671,34287,8.158,19.976,46736,17507,29229,6.034,16.108,11222,3.868,32.216,2390,2504,12502
1998,5616,15587,19508,685731,665431,2821,14.634,2358,12.233,134258,37550,96708,5.643,20.176,92200,39980,52220,6.008,13.856,42058,6.32,27.711,1661,1704,24621
1998,5617,113329,118804,1392152,1367091,19430,16.554,16573,14.12,300684,98059,202625,7.173,21.994,249730,90402,159328,6.613,18.267,50954,3.727,36.535,12860,12888,61043
1998,5619,21006,22878,351838,342883,3341,14.707,3019,13.29,80008,21289,58719,6.209,23.334,62188,21202,40986,6.183,18.137,17820,5.197,36.274,2203,2222,13782
1998,5621,6424,7669,145453,143762,1011,13.336,835,11.014,23023,10659,12364,7.414,16.015,20016,8839,11177,6.148,13.923,3007,2.092,27.846,648,657,5442
1998,5622,1424,2210,56768,57325,299,13.634,265,12.084,10587,4635,5952,8.086,18.469,11721,5102,6619,8.9,20.447,-1134,-1.978,36.937,165,167,2530
1998,5629,5219,5816,90034,88548,721,12.595,538,9.398,20047,6913,13134,7.807,22.64,16954,4500,12454,5.082,19.147,3093,3.493,38.293,379,384,2323
1998,6111,15684,17835,663393,651436,840,4.737,635,3.581,67525,15937,51588,2.446,10.366,43196,8188,35008,1.257,6.631,24329,3.735,13.262,360,368,4856
1998,6112,533,795,74682,73889,24,2.985,42,5.224,7226,404,6822,0.547,9.78,5579,1305,4274,1.766,7.551,1647,2.229,15.101,29,31,1175
1998,6113,2297,2861,1266828,1245646,162,5.722,102,3.603,90795,6435,84360,0.517,7.289,48533,2411,46122,0.194,3.896,42262,3.393,7.792,68,69,1548
1998,6114,5222,5742,58285,58693,999,17.638,843,14.883,15279,5242,10037,8.931,26.032,15841,8809,7032,15.009,26.99,-562,-0.958,52.064,605,617,3500
1998,6115,5356,6235,69497,68404,724,11.643,691,11.112,13319,3577,9742,5.229,19.471,10996,3747,7249,5.478,16.075,2323,3.396,32.15,486,500,2669
1998,6116,19788,21206,170228,162655,3171,15.257,2328,11.201,42260,15564,26696,9.569,25.981,27372,9832,17540,6.045,16.828,14888,9.153,33.657,1726,1732,6855
1998,6117,3092,3325,31926,30311,634,19.696,422,13.11,7800,3102,4698,10.234,25.733,4559,1644,2915,5.424,15.041,3241,10.692,30.081,313,313,1144
1998,6211,158527,179720,1616703,1600450,14691,8.144,16032,8.887,291512,106088,185424,6.629,18.214,258369,92103,166266,5.755,16.144,33143,2.071,32.287,11681,12061,62586
1998,6212,106184,109799,663468,656567,5668,5.189,4542,4.158,89929,25793,64136,3.928,13.697,76314,20243,56071,3.083,11.623,13615,2.074,23.246,3443,3537,15251
1998,6213,76398,81866,419915,412484,8385,10.298,7504,9.216,81722,30459,51263,7.384,19.812,66540,26308,40232,6.378,16.132,15182,3.681,32.263,5445,5529,18662
1998,6214,10126,21059,523393,510665,2568,12.488,1577,7.669,96063,42150,53913,8.254,18.811,69395,25687,43708,5.03,13.589,26668,5.222,27.178,691,766,9425
1998,6215,5458,8918,151640,149341,993,11.059,1116,12.428,27991,9686,18305,6.486,18.743,23674,11807,11867,7.906,15.852,4317,2.891,31.705,565,580,4386
1998,6216,11071,17919,894598,902843,2117,11.854,1996,11.177,163523,42438,121085,4.7,18.112,180498,55512,124986,6.149,19.992,-16975,-1.88,36.224,1089,1125,26541
1998,6219,4178,6215,173334,171392,792,13.039,510,8.396,25887,9303,16584,5.428,15.104,22096,8954,13142,5.224,12.892,3791,2.212,25.784,330,347,4952
1998,6221,3535,5452,4530448,4497387,158,2.914,100,1.844,276212,66991,209221,1.49,6.142,211394,52170,159224,1.16,4.7,64818,1.441,9.401,40,40,19834
1998,6222,506,788,246868,251436,52,6.508,74,9.262,14839,3939,10900,1.567,5.902,24696,15739,8957,6.26,9.822,-9857,-3.92,11.803,12,12,3856
1998,6223,285,430,152033,149994,44,10.654,10,2.421,10173,3753,6420,2.502,6.782,6076,1462,4614,0.975,4.051,4097,2.731,8.102,(D),(D),(D)
1998,6231,7974,15504,1547025,1529641,1407,9.278,728,4.801,169273,65879,103394,4.307,11.066,132934,44491,88443,2.909,8.691,36339,2.376,17.381,436,460,25077
1998,6232,7470,20283,376007,364574,1948,9.814,1081,5.446,72199,24150,48049,6.624,19.804,49117,15464,33653,4.242,13.472,23082,6.331,26.945,424,466,6996
1998,6233,12139,14879,430258,414282,2080,14.298,1417,9.741,74545,30102,44443,7.266,17.994,42438,17599,24839,4.248,10.244,32107,7.75,20.487,959,1008,10860
1998,6239,3376,5740,137316,134467,588,10.344,477,8.391,22571,6648,15923,4.944,16.786,16795,4982,11813,3.705,12.49,5776,4.295,24.98,266,298,2911
1998,6241,29450,41334,693880,677909,3754,9.174,2930,7.16,121350,30575,90775,4.51,17.901,89112,20922,68190,3.086,13.145,32238,4.756,26.29,1689,1760,10194
1998,6242,7954,9861,109836,106440,636,6.53,394,4.045,17842,4188,13654,3.935,16.763,10985,2255,8730,2.119,10.32,6857,6.442,20.641,201,203,997
1998,6243,5227,7824,295929,291476,587,7.488,617,7.871,52389,9597,42792,3.293,17.974,43721,6928,36793,2.377,15,8668,2.974,30,289,297,2469
1998,6244,46853,57845,640847,629198,6588,11.489,5584,9.738,110040,39836,70204,6.331,17.489,86927,31930,54997,5.075,13.816,23113,3.673,27.631,4098,4180,21834
1998,7111,7550,7666,112962,110921,1173,15.506,971,12.835,26221,8617,17604,7.769,23.639,21860,7210,14650,6.5,19.708,4361,3.932,39.415,671,672,4339
1998,7112,3126,3247,88941,88379,527,16.435,446,13.909,15917,5450,10467,6.167,18.01,14632,5141,9491,5.817,16.556,1285,1.454,33.112,336,341,2200
1998,7113,3139,3258,63262,63886,487,15.29,341,10.706,15272,6163,9109,9.647,23.905,16203,5579,10624,8.733,25.362,-931,-1.457,47.81,239,241,2785
1998,7114,2217,2273,14039,14075,344,15.35,280,12.494,3317,1701,1616,12.085,23.567,3408,1039,2369,7.382,24.213,-91,-0.647,47.133,199,200,612
1998,7115,8263,8282,32110,32759,1689,20.857,1321,16.313,11253,4847,6406,14.796,34.351,12432,4360,8072,13.31,37.95,-1179,-3.599,68.703,789,789,2170
1998,7121,4818,5192,94976,93009,336,6.536,233,4.533,11477,1438,10039,1.546,12.34,7500,915,6585,0.984,8.064,3977,4.276,16.127,142,142,635
1998,7131,1716,2797,138462,133328,388,13.927,366,13.137,26499,10904,15595,8.178,19.875,15923,4067,11856,3.05,11.943,10576,7.932,23.886,200,206,2951
1998,7132,1659,1981,163861,159633,228,11.615,192,9.781,22143,5310,16833,3.326,13.871,13630,3940,9690,2.468,8.538,8513,5.333,17.077,131,132,2945
1998,7139,44222,48121,861289,846276,5232,10.935,4683,9.788,153560,53466,100094,6.318,18.145,123675,45070,78605,5.326,14.614,29885,3.531,29.228,3398,3484,30878
1998,7211,33714,42480,1625796,1602575,5186,12.416,3761,9.005,275787,137003,138784,8.549,17.209,227543,94651,132892,5.906,14.199,48244,3.01,28.397,2418,2477,46592
1998,7212,5121,5512,35649,35152,569,10.371,518,9.441,7038,2151,4887,6.119,20.022,6001,1851,4150,5.266,17.072,1037,2.95,34.143,314,341,1241
1998,7213,3089,3164,15557,15451,245,7.671,305,9.549,2723,846,1877,5.475,17.623,2504,974,1530,6.304,16.206,219,1.417,32.412,217,217,635
1998,7223,9546,23000,476735,479931,3758,16.074,4517,19.32,110864,40026,70838,8.34,23.1,116746,67669,49077,14.1,24.326,-5882,-1.226,46.2,1159,1173,6917
1998,7224,46684,47114,319553,318553,5294,11.149,6031,12.702,70424,33700,36724,10.579,22.108,68266,28765,39501,9.03,21.43,2158,0.677,42.86,4754,4764,22667
1998,7225,263407,362988,6983386,6926564,43003,11.87,41575,11.476,1317195,608336,708859,8.783,19.017,1200337,471208,729129,6.803,17.329,116858,1.687,34.659,28900,29893,281957
1998,8111,138820,151193,835857,832472,16461,10.923,15468,10.264,151743,62406,89337,7.496,18.228,144635,56006,88629,6.728,17.374,7108,0.854,34.748,11195,11315,39370
1998,8112,13656,15834,143997,142302,1754,10.98,2035,12.739,28722,8910,19812,6.261,20.184,25517,11102,14415,7.802,17.932,3205,2.252,35.863,1374,1464,5936
1998,8113,21081,22602,192562,191392,2230,9.89,2124,9.419,31869,8779,23090,4.587,16.651,29142,9007,20135,4.706,15.226,2727,1.425,30.453,1568,1580,5745
1998,8114,24556,26023,148202,147805,3249,12.471,3307,12.694,25022,9507,15515,6.432,16.929,24209,9243,14966,6.254,16.379,813,0.55,32.758,2585,2598,7103
1998,8121,75292,86384,476770,467926,11654,13.542,11000,12.782,105667,52119,53548,11.138,22.582,87548,41991,45557,8.974,18.71,18119,3.872,37.42,8113,8484,28191
1998,8122,15772,22080,165944,162285,1922,8.795,1470,6.726,33279,13061,20218,8.048,20.507,24718,8238,16480,5.076,15.231,8561,5.275,30.462,937,1019,5159
1998,8123,34431,40725,392421,391917,4064,9.939,4396,10.751,61865,22828,39037,5.825,15.785,60445,22311,38134,5.693,15.423,1420,0.362,30.846,3106,3211,14017
1998,8129,16767,26694,214420,208260,5009,19.483,3041,11.828,50485,23181,27304,11.131,24.241,38414,16911,21503,8.12,18.445,12071,5.796,36.891,1675,1794,8994
1998,8131,156341,156469,1457036,1445489,7515,4.83,5728,3.682,159763,21909,137854,1.516,11.053,136158,16293,119865,1.127,9.42,23605,1.633,18.839,3478,3478,9074
1998,8132,9940,11703,119616,117098,1325,11.66,647,5.693,19627,5865,13762,5.009,16.761,14662,2510,12152,2.144,12.521,4965,4.24,25.042,376,386,1319
1998,8133,8165,9776,89437,87745,928,9.625,660,6.845,15501,3776,11725,4.303,17.666,12091,2628,9463,2.995,13.78,3410,3.886,27.56,419,429,1782
1998,8134,27958,29709,308649,304955,1483,4.989,1511,5.084,40850,7021,33829,2.302,13.395,33343,6008,27335,1.97,10.934,7507,2.462,21.868,1039,1040,4043
1998,8139,63251,65156,497115,498044,3598,5.524,3543,5.44,64460,14679,49781,2.947,12.943,66123,14213,51910,2.854,13.277,-1663,-0.334,25.885,2539,2546,9524
1999,1131,324,367,3136,3193,68,19.318,38,10.795,523,210,313,6.578,16.382,651,294,357,9.209,20.392,-128,-4.009,32.764,13,13,83
1999,1132,142,205,1420,1458,38,18.859,31,15.385,390,180,210,12.346,26.749,441,204,237,13.992,30.247,-51,-3.498,53.498,14,14,52
1999,1133,11409,11480,78857,78915,1328,11.472,1520,13.131,15112,4874,10238,6.176,19.15,15248,5225,10023,6.621,19.322,-136,-0.172,38.299,1175,1175,3956
1999,1141,1344,1351,7596,7645,209,15.551,195,14.509,2118,765,1353,10.007,27.706,2150,1061,1089,13.879,28.125,-32,-0.419,55.412,120,120,472
1999,1142,281,281,2329,2232,57,21.229,32,11.918,449,164,285,7.348,20.116,249,79,170,3.539,11.156,200,8.961,22.312,23,23,68
1999,1151,4514,4840,65832,65138,545,11.26,545,11.26,14639,3753,10886,5.762,22.474,13358,4616,8742,7.086,20.507,1281,1.967,41.014,385,387,3380
1999,1152,2844,2892,17280,16912,463,16.283,366,12.871,3372,1394,1978,8.243,19.939,2659,1103,1556,6.522,15.723,713,4.216,31.446,285,285,852
1999,1153,1199,1236,14130,13903,196,16.259,135,11.199,2680,636,2044,4.575,19.276,2251,560,1691,4.028,16.191,429,3.086,32.382,94,94,413
1999,2111,5669,6840,85748,90409,547,7.773,942,13.385,11879,5384,6495,5.955,13.139,21187,6130,15057,6.78,23.435,-9308,-10.295,26.278,563,574,2827
1999,2121,841,1238,76915,79141,120,9.427,190,14.925,8249,2576,5673,3.255,10.423,12727,4428,8299,5.595,16.081,-4478,-5.658,20.846,119,126,2074
1999,2122,299,413,36817,38577,62,14.797,74,17.661,2162,1205,957,3.124,5.604,5736,663,5073,1.719,14.869,-3574,-9.265,11.209,49,50,250
1999,2123,3222,5091,102530,102205,413,8.144,374,7.375,13161,3649,9512,3.57,12.877,12540,3431,9109,3.357,12.27,621,0.608,24.539,202,207,1775
1999,2131,6628,7717,145780,158502,734,9.256,1160,14.628,23988,7528,16460,4.749,15.134,48550,16010,32540,10.101,30.631,-24562,-15.496,30.268,786,800,7507
1999,2211,1566,8700,533314,536862,929,10.997,424,5.019,48877,20333,28544,3.787,9.104,55556,9929,45627,1.849,10.348,-6679,-1.244,18.208,64,71,1025
1999,2212,556,2667,92463,95746,374,14.116,339,12.795,14094,7567,6527,7.903,14.72,20483,8560,11923,8.94,21.393,-6389,-6.673,29.44,47,52,561
1999,2213,4122,4581,36033,35441,243,5.292,264,5.75,4294,1236,3058,3.488,12.116,3169,1171,1998,3.304,8.942,1125,3.174,17.883,170,180,698
1999,2361,132510,133150,724051,696268,22738,17.337,18741,14.29,208007,76283,131724,10.956,29.875,152283,66609,85674,9.567,21.871,55724,8.003,43.743,13448,13453,49029
1999,2362,40801,41606,771138,752236,4606,11.145,4049,9.797,157213,31787,125426,4.226,20.899,119770,25523,94247,3.393,15.922,37443,4.978,31.844,2910,2912,18003
1999,2371,16199,16562,401132,389687,1570,9.583,1212,7.398,81556,15202,66354,3.901,20.929,58452,15889,42563,4.077,15,23104,5.929,29.999,911,914,12575
1999,2372,9026,9204,64694,60611,1895,21.2,1364,15.26,20316,9184,11132,15.152,33.519,12116,5426,6690,8.952,19.99,8200,13.529,39.98,1014,1014,3946
1999,2373,10728,11139,280395,272117,903,8.118,873,7.848,58398,8734,49664,3.21,21.461,41643,10612,31031,3.9,15.303,16755,6.157,30.607,630,632,6273
1999,2379,4649,4730,69218,67824,566,11.926,598,12.6,15308,3958,11350,5.836,22.57,12485,3419,9066,5.041,18.408,2823,4.162,36.816,475,476,2370
1999,2381,91926,92299,944122,906769,12126,13.286,10065,11.028,236341,58514,177827,6.453,26.064,161951,49170,112781,5.423,17.86,74390,8.204,35.72,7541,7548,36995
1999,2382,141627,143974,1683477,1633302,15370,10.763,13042,9.132,331719,71310,260409,4.366,20.31,230766,73834,156932,4.521,14.129,100953,6.181,28.258,9775,9789,55777
1999,2383,95482,96117,798616,770163,14704,15.488,12341,12.999,205421,54978,150443,7.138,26.672,148356,51617,96739,6.702,19.263,57065,7.409,38.526,9224,9226,39346
1999,2389,49854,50132,422340,408236,6997,14.209,5223,10.606,101306,28550,72756,6.994,24.816,73194,25338,47856,6.207,17.929,28112,6.886,35.859,3789,3792,16829
1999,3111,1030,1628,49588,48889,91,5.566,105,6.422,5838,1395,4443,2.853,11.941,4451,1321,3130,2.702,9.104,1387,2.837,18.209,53,56,634
1999,3112,498,852,62727,62695,32,3.741,39,4.559,4552,867,3685,1.383,7.261,4471,1071,3400,1.708,7.131,81,0.129,14.263,25,25,293
1999,3113,1435,1625,83209,83699,128,7.848,140,8.584,6919,1129,5790,1.349,8.267,8094,1645,6449,1.965,9.67,-1175,-1.404,16.533,118,120,788
1999,3114,1300,1702,171409,170847,112,6.517,145,8.438,19279,3456,15823,2.023,11.284,18433,6411,12022,3.752,10.789,846,0.495,21.578,105,105,2410
1999,3115,1158,1688,130388,130448,83,4.869,116,6.806,11864,2107,9757,1.615,9.095,11908,4050,7858,3.105,9.129,-44,-0.034,18.19,70,70,1807
1999,3116,3284,3914,481650,472703,238,6.028,306,7.751,42297,8155,34142,1.725,8.948,24693,7448,17245,1.576,5.224,17604,3.724,10.448,223,223,2839
1999,3117,647,759,42202,43115,72,9.467,75,9.862,5149,1081,4068,2.507,11.943,6991,2245,4746,5.207,16.215,-1842,-4.272,23.885,48,48,1326
1999,3118,9254,10050,291054,294960,1060,10.45,1247,12.294,34849,9222,25627,3.127,11.815,42976,12908,30068,4.376,14.57,-8127,-2.755,23.63,960,981,7387
1999,3119,2273,2635,143996,143765,195,7.409,189,7.181,13888,3210,10678,2.233,9.66,13393,3855,9538,2.681,9.316,495,0.344,18.632,145,145,2289
1999,3121,1933,2397,140213,139537,194,8.105,187,7.813,11759,1554,10205,1.114,8.427,10323,2523,7800,1.808,7.398,1436,1.029,14.796,138,139,1216
1999,3122,80,108,28047,29053,9,8.108,15,13.514,1609,25,1584,0.086,5.538,3655,182,3473,0.626,12.581,-2046,-7.042,11.076,12,12,134
1999,3131,348,587,83067,82806,48,8.255,37,6.363,8815,4564,4251,5.512,10.645,8134,1231,6903,1.487,9.823,681,0.822,19.646,22,22,259
1999,3132,1632,1956,196038,201378,118,5.976,155,7.85,12002,3478,8524,1.727,5.96,22431,3640,18791,1.808,11.139,-10429,-5.179,11.92,118,118,1013
1999,3133,2060,2214,91949,97347,161,7.055,297,13.015,8196,2157,6039,2.216,8.419,18828,7128,11700,7.322,19.341,-10632,-10.922,16.839,237,239,3414
1999,3141,2682,2922,122805,122673,224,7.56,306,10.327,13754,4658,9096,3.797,11.212,13358,4111,9247,3.351,10.889,396,0.323,21.778,230,239,2553
1999,3149,4339,4473,103798,105921,399,8.883,436,9.707,14404,5313,9091,5.016,13.599,18641,6467,12174,6.106,17.599,-4237,-4,27.198,330,332,3526
1999,3151,990,1084,85842,88999,70,6.222,152,13.511,8326,2150,6176,2.416,9.355,14693,4332,10361,4.867,16.509,-6367,-7.154,18.71,120,121,2185
1999,3152,9554,10169,413152,446113,1413,13.46,2071,19.728,56557,20255,36302,4.54,12.678,122819,56233,66586,12.605,27.531,-66262,-14.853,25.355,1604,1614,28059
1999,3159,1910,1988,50064,52796,194,9.489,307,15.016,5318,2092,3226,3.962,10.073,10785,4035,6750,7.643,20.428,-5467,-10.355,20.145,229,236,2274
1999,3161,284,307,15191,15602,20,6.26,45,14.085,1205,200,1005,1.282,7.723,2092,589,1503,3.775,13.409,-887,-5.685,15.447,31,31,236
1999,3162,308,358,33918,35812,24,6.486,48,12.973,2898,815,2083,2.276,8.092,6612,1998,4614,5.579,18.463,-3714,-10.371,16.185,31,31,340
1999,3169,917,943,24916,25964,69,7.143,115,11.905,2521,567,1954,2.184,9.71,4624,1655,2969,6.374,17.809,-2103,-8.1,19.419,87,87,1320
1999,3211,4102,4578,134278,133968,323,7.039,345,7.518,13564,3677,9887,2.745,10.125,12943,3107,9836,2.319,9.661,621,0.464,19.323,253,253,1880
1999,3212,1426,1800,117974,115780,117,6.513,110,6.123,13340,3258,10082,2.814,11.522,9066,2916,6150,2.519,7.83,4274,3.691,15.661,81,83,1525
1999,3219,9151,9939,341088,335602,944,9.493,954,9.594,45683,10328,35355,3.077,13.612,34939,12228,22711,3.644,10.411,10744,3.201,20.822,742,748,8689
1999,3221,235,535,170064,172764,29,5.446,24,4.507,8407,4594,3813,2.659,4.866,13649,4342,9307,2.513,7.9,-5242,-3.034,9.732,7,7,451
1999,3222,3457,5207,396569,397002,233,4.462,262,5.018,35790,9572,26218,2.411,9.015,36682,12872,23810,3.242,9.24,-892,-0.225,18.03,157,158,3305
1999,3231,36636,38436,826055,830758,2243,5.759,3272,8.4,80887,18684,62203,2.249,9.737,90200,34825,55375,4.192,10.858,-9313,-1.121,19.473,2559,2575,21459
1999,3241,1102,2164,111000,111371,133,6.17,116,5.382,8654,1797,6857,1.614,7.77,9221,3105,6116,2.788,8.28,-567,-0.509,15.541,56,59,902
1999,3251,1092,2368,201952,206013,123,5.207,111,4.699,8890,2487,6403,1.207,4.315,16904,2519,14385,1.223,8.205,-8014,-3.89,8.631,59,59,521
1999,3252,454,778,116363,118334,51,6.602,40,5.178,8067,1603,6464,1.355,6.817,11848,1824,10024,1.541,10.012,-3781,-3.195,13.634,22,22,777
1999,3253,652,878,36860,37139,59,6.705,63,7.159,2790,597,2193,1.607,7.512,3360,898,2462,2.418,9.047,-570,-1.535,15.025,33,37,497
1999,3254,1390,1721,211754,208338,147,8.655,102,6.005,21127,3578,17549,1.717,10.141,14464,2281,12183,1.095,6.943,6663,3.198,13.885,60,62,1113
1999,3255,1570,2025,75122,75028,83,4.054,128,6.252,6353,642,5711,0.856,8.468,6245,1563,4682,2.083,8.324,108,0.144,16.647,95,95,865
1999,3256,2079,2301,124675,125738,154,6.649,184,7.945,11573,2395,9178,1.905,9.204,13671,5319,8352,4.23,10.873,-2098,-1.669,18.408,125,125,2721
1999,3259,2122,2775,121373,123580,171,6.117,212,7.584,9711,1922,7789,1.555,7.858,14096,5404,8692,4.373,11.406,-4385,-3.548,15.716,129,129,1726
1999,3261,10560,13091,820096,816259,842,6.424,875,6.676,93344,22630,70714,2.772,11.436,84881,25981,58900,3.183,10.399,8463,1.037,20.798,574,580,11189
1999,3262,2024,2572,200531,200165,140,5.419,163,6.309,15745,3104,12641,1.551,7.866,15096,2146,12950,1.072,7.542,649,0.324,15.084,112,113,971
1999,3271,1512,1765,74830,76520,116,6.493,159,8.9,5911,640,5271,0.836,7.725,9205,2439,6766,3.187,12.03,-3294,-4.305,15.45,129,129,1159
1999,3272,1867,2156,130346,130781,190,8.926,135,6.342,9316,2361,6955,1.805,7.123,10183,1439,8744,1.1,7.786,-867,-0.663,14.247,103,103,538
1999,3273,5453,8912,204794,199522,551,6.219,448,5.056,33091,7267,25824,3.642,16.585,22410,5882,16528,2.948,11.232,10681,5.353,22.464,262,269,3217
1999,3274,247,385,20945,20585,30,7.864,23,6.029,2032,315,1717,1.53,9.872,1300,482,818,2.342,6.315,732,3.556,12.631,15,15,128
1999,3279,1995,2400,75152,75323,178,7.429,170,7.095,7734,1846,5888,2.451,10.268,7961,1702,6259,2.26,10.569,-227,-0.301,20.536,111,111,949
1999,3311,246,331,133390,135629,59,18.671,29,9.177,6219,850,5369,0.627,4.585,10907,900,10007,0.664,8.042,-4688,-3.456,9.171,14,14,114
1999,3312,530,732,65034,65589,55,7.607,37,5.118,4749,995,3754,1.517,7.241,5903,1381,4522,2.106,9,-1154,-1.759,14.481,22,25,904
1999,3313,387,561,87148,87068,33,5.951,20,3.607,6746,2527,4219,2.902,7.748,6515,2131,4384,2.448,7.483,231,0.265,14.965,8,8,231
1999,3314,711,895,79135,81208,71,7.96,65,7.287,4902,2308,2594,2.842,6.036,9044,2777,6267,3.42,11.137,-4142,-5.101,12.073,42,44,576
1999,3315,2343,2662,220440,224477,115,4.295,146,5.453,14765,2679,12086,1.193,6.578,22959,5277,17682,2.351,10.228,-8194,-3.65,13.155,98,99,1758
1999,3321,2744,2977,147050,147915,128,4.294,136,4.562,12553,2075,10478,1.403,8.487,14317,3235,11082,2.187,9.679,-1764,-1.193,16.973,89,89,1300
1999,3322,1462,1617,82437,82857,78,4.788,102,6.262,7123,2202,4921,2.658,8.597,7954,1745,6209,2.106,9.6,-831,-1.003,17.193,69,70,1256
1999,3323,11168,12040,401985,396486,771,6.419,713,5.936,49770,9330,40440,2.353,12.553,38800,10179,28621,2.567,9.786,10970,2.767,19.572,532,536,7134
1999,3324,1435,1779,104760,105848,82,4.581,104,5.81,9269,1744,7525,1.648,8.757,11454,2982,8472,2.817,10.821,-2185,-2.064,17.514,62,62,835
1999,3325,771,858,65037,65726,44,5.081,60,6.928,5116,1009,4107,1.535,7.784,6466,2759,3707,4.198,9.838,-1350,-2.054,15.568,47,47,1003
1999,3326,1631,1815,69047,69264,107,5.908,99,5.467,6438,1230,5208,1.776,9.295,6833,1945,4888,2.808,9.865,-395,-0.57,18.59,75,75,749
1999,3327,25303,25753,426795,435345,1650,6.377,1896,7.327,39627,9436,30191,2.167,9.102,56852,12996,43856,2.985,13.059,-17225,-3.957,18.205,1458,1458,9445
1999,3328,5534,6085,153572,155904,337,5.527,362,5.937,15617,4006,11611,2.57,10.017,20255,4496,15759,2.884,12.992,-4638,-2.975,20.034,269,271,2771
1999,3329,5784,6328,308654,312129,525,8.338,462,7.337,24583,6174,18409,1.978,7.876,31207,7733,23474,2.478,9.998,-6624,-2.122,15.752,336,337,3805
1999,3331,2621,2935,202703,209899,184,6.22,230,7.776,15023,3260,11763,1.553,7.157,29614,6552,23062,3.122,14.109,-14591,-6.951,14.315,174,174,2259
1999,3332,4094,4342,177872,185534,241,5.508,308,7.039,12360,3116,9244,1.679,6.662,27485,5313,22172,2.864,14.814,-15125,-8.152,13.324,214,215,2591
1999,3333,2299,2451,129251,130936,164,6.66,187,7.594,10600,1134,9466,0.866,8.096,13985,3339,10646,2.55,10.681,-3385,-2.585,16.191,130,130,1769
1999,3334,1449,1768,178462,174724,98,5.518,114,6.419,18711,3554,15157,2.034,10.709,11145,3712,7433,2.124,6.379,7566,4.33,12.757,77,79,1736
1999,3335,9407,9775,238217,243026,472,4.804,574,5.842,18616,3735,14881,1.537,7.66,28410,6544,21866,2.693,11.69,-9794,-4.03,15.32,438,442,3245
1999,3336,764,922,109618,110069,53,5.799,37,4.048,6015,896,5119,0.814,5.465,7092,855,6237,0.777,6.443,-1077,-0.978,10.93,27,27,231
1999,3339,5929,6591,349142,358167,348,5.239,450,6.775,24718,5240,19478,1.463,6.901,42903,9278,33625,2.59,11.979,-18185,-5.077,13.803,313,313,3936
1999,3341,1596,1698,211552,221978,195,11.354,234,13.624,29625,17315,12310,7.8,13.346,49053,9774,39279,4.403,22.098,-19428,-8.752,26.692,171,172,2767
1999,3342,1824,2027,244371,247361,144,7.043,179,8.755,23524,2974,20550,1.202,9.51,29366,7868,21498,3.181,11.872,-5842,-2.362,19.02,113,116,2450
1999,3343,480,517,30371,31486,58,11.175,62,11.946,2732,464,2268,1.474,8.677,5060,1603,3457,5.091,16.071,-2328,-7.394,17.354,45,45,308
1999,3344,5010,5683,545254,561853,415,7.235,521,9.083,49674,13652,36022,2.43,8.841,83076,24187,58889,4.305,14.786,-33402,-5.945,17.682,371,374,8532
1999,3345,4539,5186,498891,497449,348,6.685,387,7.434,52987,11179,41808,2.247,10.652,49112,11652,37460,2.342,9.873,3875,0.779,19.746,249,252,3951
1999,3346,743,811,46647,48277,80,9.792,92,11.261,6123,1588,4535,3.289,12.683,9531,4036,5495,8.36,19.743,-3408,-7.059,25.366,60,60,1411
1999,3351,1154,1264,74318,74438,93,7.34,99,7.814,7382,1859,5523,2.497,9.917,7511,4065,3446,5.461,10.09,-129,-0.173,19.834,67,70,1516
1999,3352,245,318,101814,102290,32,10.127,28,8.861,7504,2055,5449,2.009,7.336,8500,2370,6130,2.317,8.31,-996,-0.974,14.672,16,16,191
1999,3353,2335,2766,197007,202399,131,4.686,190,6.797,13473,2256,11217,1.115,6.657,23975,4397,19578,2.172,11.845,-10502,-5.189,13.313,122,124,1609
1999,3359,1834,2208,193827,196229,155,7.028,150,6.801,15405,3214,12191,1.638,7.851,20156,6741,13415,3.435,10.272,-4751,-2.421,15.701,92,93,1565
1999,3361,284,348,226992,227257,36,10.375,34,9.798,11441,1169,10272,0.514,5.034,12691,846,11845,0.372,5.584,-1250,-0.55,10.069,22,22,426
1999,3362,1795,2006,142010,136020,145,7.203,159,7.899,20999,3314,17685,2.436,15.438,9113,2594,6519,1.907,6.7,11886,8.738,13.4,123,123,1958
1999,3363,4484,5639,804357,804933,343,6.043,417,7.347,70717,13767,56950,1.71,8.785,71089,16525,54564,2.053,8.832,-372,-0.046,17.571,273,277,6008
1999,3364,1390,1699,460490,467445,107,6.283,115,6.753,19649,2118,17531,0.453,4.203,32916,7499,25417,1.604,7.042,-13267,-2.838,8.407,68,68,770
1999,3365,157,219,31270,30764,15,6.849,15,6.849,3925,750,3175,2.438,12.759,2883,1099,1784,3.572,9.371,1042,3.387,18.743,9,9,1017
1999,3366,1481,1591,142925,141966,186,11.702,183,11.513,14125,2666,11459,1.878,9.95,12163,3369,8794,2.373,8.568,1962,1.382,17.135,136,136,2989
1999,3369,672,703,37850,38871,82,11.681,80,11.396,3710,641,3069,1.649,9.545,5671,2655,3016,6.83,14.589,-1961,-5.045,19.089,61,61,677
1999,3371,13218,13710,394685,389885,1374,10.04,1325,9.682,46429,8083,38346,2.073,11.908,36507,12822,23685,3.289,9.364,9922,2.545,18.727,1015,1022,7140
1999,3372,3998,4212,185581,185629,253,5.972,302,7.129,19625,3647,15978,1.965,10.572,19578,5588,13990,3.01,10.547,47,0.025,21.094,227,228,2969
1999,3379,990,1107,46142,45135,78,7.04,80,7.22,6192,1592,4600,3.527,13.719,4092,1543,2549,3.419,9.066,2100,4.653,18.132,63,65,879
1999,3391,10784,11428,286046,285381,783,6.806,936,8.136,36935,9256,27679,3.243,12.942,35237,9002,26235,3.154,12.347,1698,0.595,24.695,702,703,4705
1999,3399,16954,17531,430969,434811,1868,10.686,1769,10.119,52421,14705,37716,3.382,12.056,59843,15970,43873,3.673,13.763,-7422,-1.707,24.112,1386,1392,9951
1999,4231,16611,20660,293918,291518,2018,9.673,2421,11.605,44517,14389,30128,4.936,15.271,39443,16129,23314,5.533,13.53,5074,1.741,27.06,1650,1809,9957
1999,4232,9672,10867,143371,141240,1179,10.876,1125,10.378,23162,6084,17078,4.308,16.399,18839,6776,12063,4.798,13.338,4323,3.061,26.677,846,865,4489
1999,4233,8663,11620,151987,146980,1346,11.762,994,8.686,28605,8518,20087,5.795,19.462,18415,5936,12479,4.039,12.529,10190,6.933,25.058,716,728,3764
1999,4234,28345,36279,691594,679340,4018,11.034,4289,11.778,131080,42513,88567,6.258,19.295,106733,42472,64261,6.252,15.711,24347,3.584,31.423,2812,3011,23574
1999,4235,7767,10400,162790,163148,695,6.676,715,6.868,18924,4672,14252,2.864,11.599,19467,5443,14024,3.336,11.932,-543,-0.333,23.199,463,483,3216
1999,4236,19550,29204,440363,436374,2709,9.26,2811,9.609,73103,25955,47148,5.948,16.752,65970,23760,42210,5.445,15.118,7133,1.635,30.236,1683,1776,11321
1999,4237,11081,16438,201618,197992,1198,7.303,1132,6.9,28308,8231,20077,4.157,14.298,20887,7579,13308,3.828,10.549,7421,3.748,21.099,762,808,5357
1999,4238,49092,64894,760434,757183,4551,7.001,4774,7.344,98121,28133,69988,3.715,12.959,91274,30745,60529,4.06,12.054,6847,0.904,24.109,3186,3343,18859
1999,4239,28107,30417,309156,313964,3618,11.888,3653,12.003,49841,15625,34216,4.977,15.875,59057,23511,35546,7.488,18.81,-9216,-2.935,31.75,2736,2775,14399
1999,4241,9673,12756,214454,214839,953,7.415,1147,8.924,34161,7298,26863,3.397,15.901,35066,14503,20563,6.751,16.322,-905,-0.421,31.801,670,724,4180
1999,4242,4905,6171,176110,173502,735,11.695,962,15.308,27147,7433,19714,4.284,15.647,21975,8388,13587,4.835,12.666,5172,2.981,25.331,520,527,3005
1999,4243,13750,14813,177669,179412,1803,12.12,1929,12.967,31318,8626,22692,4.808,17.456,35038,11516,23522,6.419,19.529,-3720,-2.073,34.912,1481,1495,7657
1999,4244,26998,32630,766426,759708,2813,8.554,3323,10.105,94410,25480,68930,3.354,12.427,80548,29808,50740,3.924,10.603,13862,1.825,21.205,2508,2548,17598
1999,4245,4991,7784,69530,71113,346,4.359,653,8.227,7708,1974,5734,2.776,10.839,10845,4315,6530,6.068,15.25,-3137,-4.411,21.678,428,465,2703
1999,4246,9623,13510,151454,153036,886,6.531,1000,7.371,18359,4366,13993,2.853,11.997,21647,6517,15130,4.258,14.145,-3288,-2.149,23.993,592,625,3217
1999,4247,7058,10333,127521,127747,604,5.805,746,7.17,18166,5264,12902,4.121,14.22,18569,6996,11573,5.476,14.536,-403,-0.315,28.441,400,427,3106
1999,4248,3193,4072,147723,147176,252,6.146,309,7.536,15946,5234,10712,3.556,10.835,14896,5541,9355,3.765,10.121,1050,0.713,20.242,205,219,2707
1999,4249,22399,26892,354578,352735,3396,12.651,3299,12.29,56895,17921,38974,5.081,16.13,52947,20255,32692,5.742,15.01,3948,1.119,30.021,2481,2538,12182
1999,4251,33783,36070,302955,303440,2993,8.286,3092,8.56,42362,11920,30442,3.928,13.961,43494,16299,27195,5.371,14.334,-1132,-0.373,27.921,2142,2157,10285
1999,4411,42391,45780,1168335,1155587,4373,9.56,4295,9.39,136300,42908,93392,3.713,11.795,110706,44567,66139,3.857,9.58,25594,2.215,19.16,3329,3362,33984
1999,4412,11845,12806,114104,110525,1230,9.674,1048,8.242,20097,5680,14417,5.139,18.183,13001,5515,7486,4.99,11.763,7096,6.42,23.526,800,807,4185
1999,4413,36523,60425,548061,540043,4164,6.871,4517,7.454,87088,28517,58571,5.281,16.126,71539,24430,47109,4.524,13.247,15549,2.879,26.494,2575,2939,13422
1999,4421,19952,27854,274470,271859,2369,8.51,2338,8.398,43196,13527,29669,4.976,15.889,38308,14641,23667,5.386,14.091,4888,1.798,28.182,1515,1675,7710
1999,4422,24425,32232,255439,250475,3118,9.698,2957,9.197,46979,18594,28385,7.423,18.756,37256,13029,24227,5.202,14.874,9723,3.882,29.748,1869,1997,6826
1999,4431,32831,49938,460880,448345,5456,10.963,5113,10.274,91423,34242,57181,7.637,20.391,66334,30693,35641,6.846,14.795,25089,5.596,29.591,3412,3580,17327
1999,4441,49036,70741,1047349,1020379,4187,5.913,4319,6.1,149342,55264,94078,5.416,14.636,97184,32475,64709,3.183,9.524,52158,5.112,19.049,2984,3118,17787
1999,4442,16553,20591,181186,179814,1292,6.248,1468,7.099,26310,7292,19018,4.055,14.632,23566,7447,16119,4.142,13.106,2744,1.526,26.212,1019,1084,5337
1999,4451,59687,88958,2782797,2723715,9871,11.152,8988,10.154,411676,223102,188574,8.191,15.115,288851,100568,188283,3.692,10.605,122825,4.509,21.21,6032,6143,39834
1999,4452,16655,21961,149885,140172,3758,17.615,2505,11.742,43217,20918,22299,14.923,30.832,24555,10497,14058,7.489,17.518,18662,13.314,35.036,1737,1792,6928
1999,4453,22971,26157,131680,131040,2302,8.817,2204,8.442,20426,7508,12918,5.73,15.588,19309,6655,12654,5.079,14.735,1117,0.852,29.471,1691,1710,4958
1999,4461,40357,78731,950363,945635,6183,7.819,6882,8.703,159090,54360,104730,5.749,16.824,150029,54644,95385,5.779,15.865,9061,0.958,31.731,3564,3979,23623
1999,4471,63340,115450,928483,932741,8602,7.384,10707,9.19,159432,58469,100963,6.269,17.093,168626,60058,108568,6.439,18.079,-9194,-0.986,34.186,6105,6518,32877
1999,4481,37763,84679,935740,931313,7090,8.274,9120,10.643,163180,53724,109456,5.769,17.522,151273,51403,99870,5.519,16.243,11907,1.279,32.486,4586,4943,19575
1999,4482,6641,29460,195624,197098,2609,8.963,1908,6.555,35007,17658,17349,8.959,17.761,38098,9704,28394,4.923,19.329,-3091,-1.568,35.522,682,901,4645
1999,4483,18895,28840,163055,161485,2439,8.478,2299,7.991,25820,8913,16907,5.519,15.989,22661,7869,14792,4.873,14.033,3159,1.956,28.066,1391,1549,4637
1999,4511,30268,41025,387143,386283,3931,9.488,4742,11.446,60914,26730,34184,6.92,15.769,58817,23047,35770,5.966,15.226,2097,0.543,30.453,3084,3356,12507
1999,4512,7563,13379,140817,139221,1174,8.715,1358,10.081,21211,9047,12164,6.498,15.236,17904,7262,10642,5.216,12.86,3307,2.375,25.72,881,929,3619
1999,4522,58,6047,1018498,1035403,145,2.401,128,2.12,72042,16857,55185,1.628,6.958,105772,12517,93255,1.209,10.216,-33730,-3.258,13.916,(D),(D),(D)
1999,4523,9182,29662,1466968,1467825,3172,10.921,1939,6.676,152837,47169,105668,3.214,10.412,155880,21250,134630,1.448,10.62,-3043,-0.207,20.825,1039,1119,4836
1999,4531,21709,22795,121274,122248,1795,7.764,2446,10.579,18682,5619,13063,4.596,15.282,20762,7621,13141,6.234,16.984,-2080,-1.701,30.564,1899,1938,5700
1999,4532,29714,41265,352125,344362,4789,11.622,4670,11.333,67510,30458,37052,8.845,19.604,52293,20844,31449,6.053,15.185,15217,4.419,30.371,3178,3260,11657
1999,4533,13052,16616,110232,108091,1954,11.848,1706,10.344,18805,7602,11203,7.033,17.397,14614,4832,9782,4.47,13.52,4191,3.877,27.04,1360,1381,3404
1999,4539,31218,38553,247255,243199,5546,14.576,4536,11.922,56058,25314,30744,10.409,23.05,47582,19156,28426,7.877,19.565,8476,3.485,39.13,3229,3462,14675
1999,4541,8539,9474,235141,226391,1572,16.941,1183,12.749,51236,19261,31975,8.508,22.632,33542,10981,22561,4.85,14.816,17694,7.816,29.632,832,835,6463
1999,4542,5041,5628,66765,66621,588,10.348,697,12.266,8842,3154,5688,4.734,13.272,8501,3955,4546,5.937,12.76,341,0.512,25.52,534,539,2988
1999,4543,19144,25315,224812,222883,2499,9.882,2444,9.665,36373,10658,25715,4.782,16.319,32490,11684,20806,5.242,14.577,3883,1.742,29.154,1802,1856,8665
1999,4811,634,3055,519916,511057,343,11.142,390,12.669,43755,6387,37368,1.25,8.562,26196,9669,16527,1.892,5.126,17559,3.436,10.252,80,82,1405
1999,4812,1616,1781,32743,31613,226,12.797,196,11.099,5637,1862,3775,5.89,17.831,3394,978,2416,3.094,10.736,2243,7.095,21.472,128,130,438
1999,4831,787,1188,50080,52316,150,12.706,135,11.436,8496,2682,5814,5.127,16.24,12356,7670,4686,14.661,23.618,-3860,-7.378,32.48,59,61,1372
1999,4832,480,517,18796,18563,44,8.325,67,12.677,2297,233,2064,1.255,12.374,1824,804,1020,4.331,9.826,473,2.548,19.652,47,49,328
1999,4841,36897,45463,953708,924109,9249,21.1,5991,13.667,193210,83767,109443,9.065,20.908,131701,47903,83798,5.184,14.252,61509,6.656,28.503,4378,4517,25884
1999,4842,47162,50662,497046,496534,6481,12.745,6861,13.492,93807,32347,61460,6.515,18.892,92275,34082,58193,6.864,18.584,1532,0.309,37.168,5321,5358,23634
1999,4851,441,667,35501,32608,174,28.316,69,11.229,8061,5599,2462,17.171,24.721,2120,742,1378,2.276,6.502,5941,18.22,13.003,57,57,594
1999,4852,199,374,17976,18189,45,12.346,26,7.133,1404,653,751,3.59,7.719,1775,699,1076,3.843,9.759,-371,-2.04,15.438,16,16,508
1999,4853,5687,5778,63812,62438,843,14.62,819,14.204,12192,4003,8189,6.411,19.527,9461,4019,5442,6.437,15.153,2731,4.374,30.306,666,668,3194
1999,4854,3154,4236,163502,158421,267,6.287,289,6.805,25593,6465,19128,4.081,16.155,14972,4897,10075,3.091,9.451,10621,6.704,18.902,209,212,3308
1999,4855,1218,1363,33053,32595,110,7.965,146,10.572,5152,1087,4065,3.335,15.806,4267,1483,2784,4.55,13.091,885,2.715,26.182,114,120,1248
1999,4859,2199,2390,50124,48752,398,16.832,347,14.675,10225,3723,6502,7.637,20.973,7490,3458,4032,7.093,15.363,2735,5.61,30.727,281,282,2614
1999,4861,44,330,6496,6771,21,6.131,46,13.431,924,246,678,3.633,13.647,1428,616,812,9.098,21.091,-504,-7.444,27.295,(D),(D),(D)
1999,4862,126,1603,30825,31829,170,10.729,133,8.394,3492,1417,2075,4.452,10.971,5524,1116,4408,3.506,17.356,-2032,-6.384,21.943,11,11,36
1999,4869,60,499,6114,6088,48,9.275,85,16.425,1286,659,627,10.825,21.124,1235,604,631,9.921,20.286,51,0.838,40.572,(D),(D),(D)
1999,4871,360,400,8738,8786,68,17.731,35,9.126,1081,324,757,3.688,12.304,1198,242,956,2.754,13.635,-117,-1.332,24.607,26,26,211
1999,4872,1175,1204,12532,12549,157,13.029,159,13.195,2443,792,1651,6.312,19.468,2467,1066,1401,8.495,19.66,-24,-0.191,38.937,115,115,954
1999,4879,139,143,1965,1874,17,11.684,22,15.12,492,46,446,2.455,26.261,329,111,218,5.925,17.561,163,8.7,35.121,19,19,104
1999,4881,3113,4065,119960,117459,497,12.354,413,10.266,20280,7516,12764,6.399,17.266,15136,5915,9221,5.036,12.886,5144,4.379,25.772,280,300,3632
1999,4882,446,797,20730,20173,83,10.567,60,7.638,4202,1630,2572,8.08,20.83,3022,1086,1936,5.383,14.98,1180,5.849,29.961,25,26,180
1999,4883,1751,2268,69430,70630,208,9.169,209,9.213,11796,4484,7312,6.349,16.701,13966,3773,10193,5.342,19.774,-2170,-3.072,33.402,139,141,2083
1999,4884,5933,6213,50172,49124,972,15.963,724,11.89,11053,4681,6372,9.529,22.5,8832,4311,4521,8.776,17.979,2221,4.521,35.958,554,562,3338
1999,4885,10981,14663,156717,152352,1577,10.793,1474,10.088,30999,12111,18888,7.949,20.347,22242,8854,13388,5.812,14.599,8757,5.748,29.198,998,1065,5693
1999,4889,879,939,22546,23262,193,20.477,200,21.22,3157,942,2215,4.05,13.571,4500,2160,2340,9.286,19.345,-1343,-5.773,27.143,89,89,317
1999,4921,2271,5909,507212,486986,662,11.474,383,6.638,56732,8076,48656,1.658,11.65,18410,4188,14222,0.86,3.78,38322,7.869,7.561,241,243,1771
1999,4922,4384,4850,68107,68762,782,16.201,736,15.248,15478,8291,7187,12.058,22.51,16378,9453,6925,13.747,23.818,-900,-1.309,45.019,603,618,4877
1999,4931,6632,12277,536419,524748,1255,10.343,968,7.978,102830,42493,60337,8.098,19.596,79981,28234,51747,5.38,15.242,22849,4.354,30.484,313,340,4838
1999,5111,15555,19044,681186,690308,1963,10.322,1910,10.043,67247,18829,48418,2.728,9.742,86143,28732,57411,4.162,12.479,-18896,-2.737,19.483,1425,1448,13498
1999,5112,8056,10253,300070,288447,1038,9.944,1409,13.498,64177,15332,48845,5.315,22.249,40530,17066,23464,5.917,14.051,23647,8.198,28.102,915,944,9400
1999,5121,11911,16195,253311,256009,2359,14.626,2226,13.802,60826,27894,32932,10.896,23.759,64737,17160,47577,6.703,25.287,-3911,-1.528,47.519,1250,1321,7348
1999,5122,2521,2671,21575,20950,457,17.453,352,13.443,4862,2384,2478,11.38,23.208,3647,1513,2134,7.222,17.409,1215,5.8,34.817,249,254,903
1999,5151,5407,7757,247315,243813,943,12.131,976,12.555,43452,25472,17980,10.447,17.822,37448,19104,18344,7.836,15.359,6004,2.463,30.719,700,758,10675
1999,5152,306,585,32110,31464,106,17.434,152,25,8433,2285,6148,7.262,26.802,7113,5076,2037,16.133,22.607,1320,4.195,45.214,28,31,930
1999,5173,7463,35341,1219773,1203922,7062,20.418,5555,16.061,298444,138716,159728,11.522,24.789,271976,125877,146099,10.456,22.591,26468,2.198,45.182,926,1020,13474
1999,5174,374,855,19217,16299,363,51.199,71,10.014,8312,4464,3848,27.388,50.997,2695,1240,1455,7.608,16.535,5617,34.462,33.07,34,35,375
1999,5179,5285,6338,96054,88054,2118,36.224,1136,19.429,39077,15500,23577,17.603,44.379,23157,13008,10149,14.773,26.299,15920,18.08,52.598,785,799,6989
1999,5182,4961,8992,344296,336015,1575,18.436,677,7.925,68641,26771,41870,7.967,20.428,52892,18831,34061,5.604,15.741,15749,4.687,31.482,419,425,3263
1999,5191,3004,3668,57543,54115,423,11.857,222,6.223,12338,5099,7239,9.423,22.8,5413,1778,3635,3.286,10.003,6925,12.797,20.006,142,142,671
1999,5211,14,43,22876,22385,(D),(D),0,0,1109,(D),1007,(D),4.954,113,0,113,0,0.505,996,4.449,1.01,0,0,0
1999,5221,18675,104448,1951683,1959637,8899,8.459,10414,9.899,298157,102552,195605,5.233,15.215,323853,163416,160437,8.339,16.526,-25696,-1.311,30.43,624,1132,19701
1999,5222,18213,45183,654716,630762,7523,16.754,6960,15.501,177090,80631,96459,12.783,28.076,131911,61934,69977,9.819,20.913,45179,7.163,41.826,1838,2355,20269
1999,5223,13418,18627,207842,198875,4351,24.861,2100,11.999,59553,26069,33484,13.108,29.945,41426,19118,22308,9.613,20.83,18127,9.115,41.66,1276,1367,9768
1999,5231,11306,31876,484588,471089,5336,17.285,3327,10.777,103472,29512,73960,6.265,21.964,78372,36561,41811,7.761,16.636,25100,5.328,33.273,997,1088,9442
1999,5232,51,62,6542,6366,22,40,8,14.545,1010,433,577,6.802,15.867,628,445,183,6.991,9.866,382,6.001,19.731,4,4,102
1999,5239,23464,26172,273936,265747,4248,16.543,3261,12.699,55556,19237,36319,7.239,20.906,38961,16903,22058,6.361,14.661,16595,6.245,29.322,2135,2165,7614
1999,5241,4820,41192,1554317,1563269,7734,19.444,4903,12.326,263572,110872,152700,7.092,16.86,282626,94789,187837,6.064,18.079,-19054,-1.219,33.721,266,311,6263
1999,5242,112998,124421,832592,824604,11684,9.411,11140,8.973,149987,57526,92461,6.976,18.189,136414,63109,73305,7.653,16.543,13573,1.646,33.086,7680,7907,28701
1999,5259,391,416,4431,3660,176,49.788,51,14.427,2009,900,1109,24.594,54.898,494,204,290,5.575,13.499,1515,41.399,26.998,26,26,79
1999,5311,87951,99297,518183,514815,10774,10.847,10835,10.908,105983,47934,58049,9.311,20.587,99121,47450,51671,9.217,19.254,6862,1.333,38.507,8347,8626,35813
1999,5312,48856,55005,257411,247106,8668,16.083,6450,11.967,67271,31268,36003,12.654,27.224,47035,19848,27187,8.032,19.034,20236,8.189,38.069,4336,4495,12355
1999,5313,43258,50435,470094,466321,7803,15.952,4767,9.745,91769,39861,51908,8.548,19.679,85175,33301,51874,7.141,18.265,6594,1.414,36.531,3072,3185,16791
1999,5321,4416,10262,174780,173603,1193,11.697,1067,10.462,26274,12466,13808,7.181,15.135,23275,10410,12865,5.996,13.407,2999,1.728,26.814,485,534,2825
1999,5322,16167,31540,253755,251344,4176,13.36,3610,11.549,53284,23896,29388,9.507,21.2,48305,17134,31171,6.817,19.219,4979,1.981,38.437,2362,2604,11552
1999,5323,3496,5820,40129,39992,531,9.097,565,9.68,7600,3180,4420,7.952,19.004,7184,3147,4037,7.869,17.964,416,1.04,35.927,269,331,2036
1999,5324,7233,11360,147299,143198,1930,17.46,1318,11.923,34807,16553,18254,11.56,24.307,26282,11030,15252,7.703,18.354,8525,5.953,36.707,777,886,7687
1999,5331,1685,1802,22569,21378,229,12.74,220,12.239,5239,2601,2638,12.167,24.507,2899,1101,1798,5.15,13.561,2340,10.946,27.122,147,147,696
1999,5411,155262,162598,1086535,1071188,13881,8.535,13941,8.572,146546,41861,104685,3.908,13.681,115876,40981,74895,3.826,10.818,30670,2.863,21.635,10174,10270,29369
1999,5412,85061,91360,1141517,1114349,9798,10.797,8581,9.455,232012,63824,168188,5.727,20.82,174893,50930,123963,4.57,15.695,57119,5.126,31.389,5763,5823,25355
1999,5413,81876,92388,1218778,1199463,10607,11.62,8395,9.197,213321,67124,146197,5.596,17.785,175824,46418,129406,3.87,14.659,37497,3.126,29.317,5813,5895,27073
1999,5414,23679,23900,129918,127508,3690,15.718,2843,12.11,27906,10032,17874,7.868,21.886,23093,9391,13702,7.365,18.111,4813,3.775,36.222,2167,2172,7346
1999,5415,68568,76979,1016316,950148,20372,28.282,10476,14.544,313368,128601,184767,13.535,32.981,180422,72455,107967,7.626,18.989,132946,13.992,37.978,7061,7226,39996
1999,5416,61119,65063,578737,552148,13403,21.135,10110,15.942,158641,67912,90729,12.3,28.732,105226,48844,56382,8.846,19.058,53415,9.674,38.115,7284,7348,29510
1999,5417,9381,12047,549117,531017,1819,15.545,1128,9.64,91333,33915,57418,6.387,17.2,54990,14690,40300,2.766,10.356,36343,6.844,20.711,700,705,3965
1999,5418,32345,35666,452506,450923,4267,11.986,4133,11.61,79288,23884,55404,5.297,17.583,75483,30349,45134,6.73,16.74,3805,0.844,33.479,3036,3092,18114
1999,5419,44337,51099,444959,435625,6586,13.25,3801,7.647,89746,32297,57449,7.414,20.602,71550,23330,48220,5.356,16.425,18196,4.177,32.849,2410,2426,13941
1999,5511,28083,51945,3277854,3295044,6655,12.923,5761,11.187,567412,203827,363585,6.186,17.22,599304,202523,396781,6.146,18.188,-31892,-0.968,34.44,1262,1333,24972
1999,5611,19149,21371,392279,376329,3313,15.512,3285,15.381,113428,39168,74260,10.408,30.141,79899,36976,42923,9.825,21.231,33529,8.909,42.462,2055,2084,20177
1999,5612,1334,2625,120850,115284,664,26.64,399,16.008,30353,14760,15593,12.803,26.329,19313,8663,10650,7.514,16.753,11040,9.576,33.505,99,111,3667
1999,5613,25648,43211,3924647,3756451,7382,17.649,4614,11.031,1183086,353508,829578,9.411,31.495,838064,225067,612997,5.991,22.31,345022,9.185,44.62,2671,2792,120686
1999,5614,25708,30777,679850,664448,4368,14.274,4018,13.13,159684,63649,96035,9.579,24.033,128768,45403,83365,6.833,19.38,30916,4.653,38.759,2967,3032,24003
1999,5615,23958,31926,296746,296963,2426,7.45,3705,11.377,47668,16142,31526,5.436,16.052,48176,18315,29861,6.167,16.223,-508,-0.171,32.104,2638,2742,11899
1999,5616,15498,19561,698916,691979,2519,12.909,2423,12.417,143846,51967,91879,7.51,20.788,129152,44659,84493,6.454,18.664,14694,2.123,37.328,1652,1662,16021
1999,5617,114502,120587,1443938,1419522,18110,15.125,16413,13.707,292519,84319,208200,5.94,20.607,243437,91610,151827,6.454,17.149,49082,3.458,34.298,12710,12750,66045
1999,5619,20749,22698,380463,366191,2896,12.739,2965,13.043,93749,24442,69307,6.675,25.601,67462,26896,40566,7.345,18.423,26287,7.179,36.845,2250,2298,19543
1999,5621,6087,7421,152041,151986,885,11.709,1160,15.347,27130,9729,17401,6.401,17.85,26539,16920,9619,11.133,17.462,591,0.389,34.923,851,874,7754
1999,5622,1420,2157,51136,51933,256,11.703,317,14.491,8819,2787,6032,5.367,16.982,10342,5725,4617,11.024,19.914,-1523,-2.933,33.963,173,181,1959
1999,5629,5347,5926,89842,89529,767,13.091,633,10.804,19683,6508,13175,7.269,21.985,18815,6264,12551,6.997,21.016,868,0.97,42.031,440,444,3555
1999,6111,16102,18234,692860,675804,1010,5.608,560,3.11,70106,17469,52637,2.585,10.374,36349,6743,29606,0.998,5.379,33757,4.995,10.757,359,372,3998
1999,6112,529,795,74758,74693,35,4.408,33,4.156,6080,951,5129,1.273,8.14,5884,1869,4015,2.502,7.878,196,0.262,15.755,19,20,1270
1999,6113,2312,2908,1304571,1287230,142,4.928,89,3.089,82966,6935,76031,0.539,6.445,48195,2095,46100,0.163,3.744,34771,2.701,7.488,53,53,859
1999,6114,5349,5867,59751,59353,946,16.334,795,13.727,14080,4488,9592,7.562,23.723,13395,6191,7204,10.431,22.569,685,1.154,45.137,573,589,3879
1999,6115,5277,6165,73102,70579,687,11.148,682,11.067,15028,4218,10810,5.976,21.293,10131,3698,6433,5.24,14.354,4897,6.938,28.708,493,506,2569
1999,6116,20396,22087,188078,178384,3232,14.945,2310,10.682,45758,17840,27918,10.001,25.651,26768,10264,16504,5.754,15.006,18990,10.646,30.012,1721,1746,6868
1999,6117,3191,3423,33161,36361,574,17.017,474,14.053,6939,2343,4596,6.444,19.084,13762,1957,11805,5.382,37.848,-6823,-18.765,38.167,349,352,1331
1999,6211,157255,178743,1680262,1649971,14783,8.25,15660,8.74,300363,105900,194463,6.418,18.204,239941,98810,141131,5.989,14.542,60422,3.662,29.084,11057,11529,59819
1999,6212,106026,109667,678762,671178,5011,4.569,5012,4.57,88933,21965,66968,3.273,13.25,73906,21915,51991,3.265,11.011,15027,2.239,22.023,3814,3879,16449
1999,6213,77099,82766,419516,421022,8734,10.611,7824,9.505,76167,28472,47695,6.763,18.091,78740,36418,42322,8.65,18.702,-2573,-0.611,36.182,5593,5742,22846
1999,6214,10246,21864,543157,535988,2442,11.332,1812,8.409,93726,36370,57356,6.786,17.487,78682,31380,47302,5.855,14.68,15044,2.807,29.36,829,927,12396
1999,6215,5368,8481,150071,151508,1131,13.007,1559,17.93,28295,13070,15225,8.627,18.676,31643,17049,14594,11.253,20.885,-3348,-2.21,37.351,592,644,6026
1999,6216,10284,16231,795618,843702,2024,11.941,3463,20.43,142243,40903,101340,4.848,16.859,236755,97847,138908,11.597,28.061,-94512,-11.202,33.719,1950,2123,49668
1999,6219,4336,6507,179880,176172,866,13.59,597,9.368,35315,11643,23672,6.609,20.046,28305,8721,19584,4.95,16.067,7010,3.979,32.133,353,365,4064
1999,6221,3451,5428,4556278,4546083,117,2.153,131,2.41,256244,58856,197388,1.295,5.637,237267,64542,172725,1.42,5.219,18977,0.417,10.438,49,49,13046
1999,6222,495,784,244542,245189,38,4.822,46,5.838,12334,1594,10740,0.65,5.03,13710,5514,8196,2.249,5.592,-1376,-0.561,10.061,16,18,2592
1999,6223,273,446,152604,152691,45,10.216,34,7.719,8962,3262,5700,2.136,5.869,9081,3202,5879,2.097,5.947,-119,-0.078,11.739,15,15,1348
1999,6231,7828,15520,1533865,1545785,1045,6.745,992,6.403,151133,52386,98747,3.389,9.777,176678,65023,111655,4.206,11.43,-25545,-1.653,19.554,542,598,37215
1999,6232,7460,21070,385848,379806,1956,9.493,1024,4.97,60953,21365,39588,5.625,16.048,48877,14812,34065,3.9,12.869,12076,3.18,25.738,473,580,8949
1999,6233,12467,16119,474110,453709,2686,17.268,1557,10.01,88039,44182,43857,9.738,19.404,46782,18270,28512,4.027,10.311,41257,9.093,20.622,1132,1166,13014
1999,6239,3393,5856,144938,141730,467,8.029,388,6.671,22021,4936,17085,3.483,15.537,15816,4634,11182,3.27,11.159,6205,4.378,22.319,224,236,2875
1999,6241,29870,42319,733126,716618,3605,8.604,2769,6.608,111219,27797,83422,3.879,15.52,78088,19347,58741,2.7,10.897,33131,4.623,21.793,1662,1714,10417
1999,6242,8140,10142,114762,111804,713,7.128,435,4.349,16669,3946,12723,3.529,14.909,10744,2223,8521,1.988,9.61,5925,5.299,19.219,241,250,1070
1999,6243,5211,7871,302040,300814,563,7.176,513,6.538,41140,10171,30969,3.381,13.676,38970,4545,34425,1.511,12.955,2170,0.721,25.91,266,271,1920
1999,6244,47234,58925,663648,653016,6777,11.602,5749,9.842,110356,43102,67254,6.6,16.899,89081,33508,55573,5.131,13.641,21275,3.258,27.283,4265,4375,24307
1999,7111,7628,7708,116860,114683,1051,13.711,966,12.602,24899,7446,17453,6.493,21.711,20644,6800,13844,5.929,18.001,4255,3.71,36.002,679,681,4939
1999,7112,3221,3368,91666,90261,565,16.934,502,15.046,15523,5936,9587,6.576,17.198,12549,3746,8803,4.15,13.903,2974,3.295,27.806,389,389,2861
1999,7113,3270,3409,66324,64857,495,14.858,340,10.206,12601,3817,8784,5.885,19.429,9454,2338,7116,3.605,14.577,3147,4.852,29.153,222,228,1213
1999,7114,2286,2337,14833,14383,365,15.842,299,12.977,3749,1366,2383,9.498,26.066,2902,1247,1655,8.67,20.177,847,5.889,40.355,220,221,813
1999,7115,8649,8668,37299,34740,1695,19.934,1365,16.053,15320,5499,9821,15.829,44.099,10106,4079,6027,11.742,29.09,5214,15.009,58.181,824,826,2379
1999,7121,4979,5370,100189,97571,355,6.705,204,3.853,11060,1251,9809,1.282,11.335,5737,826,4911,0.847,5.88,5323,5.456,11.76,125,125,678
1999,7131,1649,2639,123750,131409,266,9.792,421,15.498,13582,2716,10866,2.067,10.336,28523,5787,22736,4.404,21.706,-14941,-11.37,20.671,245,248,2552
1999,7132,1662,2008,163269,162026,238,11.903,221,11.053,16325,6711,9614,4.142,10.076,13846,3547,10299,2.189,8.546,2479,1.53,17.091,169,172,2211
1999,7139,44548,48772,903858,880803,5065,10.451,4445,9.172,163388,48586,114802,5.516,18.55,115844,40506,75338,4.599,13.152,47544,5.398,26.304,3365,3418,29984
1999,7211,34159,43584,1666665,1651813,4890,11.352,3872,8.989,235177,110336,124841,6.68,14.238,206125,83466,122659,5.053,12.479,29052,1.759,24.957,2674,2739,45670
1999,7212,5040,5428,37393,36615,460,8.451,490,9.002,6961,1883,5078,5.143,19.011,5445,1699,3746,4.64,14.871,1516,4.14,29.742,337,346,1247
1999,7213,2898,2963,14684,15066,157,5.159,318,10.448,1996,497,1499,3.299,13.248,2795,1068,1727,7.089,18.552,-799,-5.303,26.497,214,218,704
1999,7223,10107,23646,474614,475475,3423,14.626,2939,12.558,86435,43382,43053,9.124,18.179,87923,38911,49012,8.184,18.492,-1488,-0.313,36.357,1120,1236,9050
1999,7224,45748,46201,324899,323332,5167,11.068,6136,13.143,72619,35415,37204,10.953,22.46,69554,30237,39317,9.352,21.512,3065,0.948,43.023,4759,4775,23234
1999,7225,263575,362726,7098552,7039748,42331,11.668,42442,11.699,1312056,653753,658303,9.287,18.638,1199096,490599,708497,6.969,17.033,112960,1.605,34.066,27846,29561,289470
1999,8111,138988,151918,852966,845447,15848,10.457,15129,9.982,154862,61577,93285,7.283,18.317,139723,56935,82788,6.734,16.527,15139,1.791,33.053,11105,11337,41059
1999,8112,13079,15109,144708,144354,1482,9.575,2218,14.331,28506,10073,18433,6.978,19.747,27986,11231,16755,7.78,19.387,520,0.36,38.774,1451,1520,6743
1999,8113,21200,22709,196667,194114,2181,9.627,2074,9.155,32965,8653,24312,4.458,16.982,27799,9234,18565,4.757,14.321,5166,2.661,28.642,1483,1514,6203
1999,8114,24204,25630,144418,145631,2923,11.329,3266,12.658,21864,7797,14067,5.354,15.013,24531,9865,14666,6.774,16.845,-2667,-1.831,30.027,2525,2550,6692
1999,8121,74460,85646,486254,482775,10047,11.693,10599,12.336,94390,40568,53822,8.403,19.552,87075,38055,49020,7.883,18.036,7315,1.515,36.073,7971,8212,26706
1999,8122,15074,21200,156873,162651,960,4.47,1512,7.04,13675,3994,9681,2.456,8.408,24801,7848,16953,4.825,15.248,-11126,-6.84,16.815,848,912,4026
1999,8123,33798,40321,392330,392855,3822,9.442,4139,10.225,54894,21559,33335,5.488,13.973,56052,21369,34683,5.439,14.268,-1158,-0.295,27.946,3057,3161,15027
1999,8129,18532,28222,227413,220674,4987,18.131,3553,12.918,55771,25961,29810,11.764,25.273,42916,17853,25063,8.09,19.448,12855,5.825,38.895,1842,1898,9664
1999,8131,158699,158828,1511237,1487613,7855,4.979,5708,3.618,167582,24184,143398,1.626,11.265,120288,17868,102420,1.201,8.086,47294,3.179,16.172,3321,3321,8669
1999,8132,10306,12116,124152,122684,1180,9.914,752,6.318,18082,4981,13101,4.06,14.739,15070,6544,8526,5.334,12.284,3012,2.455,24.567,444,458,2556
1999,8133,8500,10206,95002,91869,1149,11.502,717,7.177,15748,3996,11752,4.35,17.142,9537,2803,6734,3.051,10.381,6211,6.761,20.762,390,396,1364
1999,8134,27808,29567,308521,306588,1350,4.557,1460,4.929,35807,5675,30132,1.851,11.679,31819,5729,26090,1.869,10.378,3988,1.301,20.757,1015,1015,3831
1999,8139,62217,64228,500854,499010,3231,5.002,3975,6.153,65182,13104,52078,2.626,13.062,61563,16120,45443,3.23,12.337,3619,0.725,24.674,2840,2850,11470
2000,1131,347,391,3187,3302,69,18.087,50,13.106,524,243,281,7.36,15.872,761,143,618,4.331,23.05,-237,-7.179,31.743,29,29,79
2000,1132,160,223,1748,1610,32,14.815,18,8.333,544,93,451,5.778,33.799,280,96,184,5.965,17.397,264,16.403,34.793,14,14,49
2000,1133,10963,11033,77724,78219,1097,9.745,1544,13.717,14393,3809,10584,4.87,18.401,15462,6185,9277,7.907,19.768,-1069,-1.367,36.802,1177,1177,4278
2000,1141,1381,1391,7761,7654,226,16.442,193,14.041,1974,1090,884,14.241,25.79,1820,705,1115,9.211,23.778,154,2.012,47.557,125,125,472
2000,1142,294,294,2510,2403,42,14.685,26,9.091,458,160,298,6.66,19.063,229,69,160,2.872,9.532,229,9.532,19.063,19,19,37
2000,1151,4063,4357,63461,62310,529,12.098,560,12.807,13814,4619,9195,7.413,22.17,11548,3413,8135,5.477,18.533,2266,3.637,37.066,384,386,2355
2000,1152,2987,3036,18446,17992,456,15.238,369,12.331,3869,1715,2154,9.532,21.505,2917,1265,1652,7.031,16.213,952,5.291,32.426,272,272,854
2000,1153,1239,1274,14918,14599,172,13.694,136,10.828,3144,728,2416,4.987,21.536,2563,853,1710,5.843,17.557,581,3.98,35.113,80,80,679
2000,2111,5619,6857,78500,81570,685,9.997,675,9.851,13968,5618,8350,6.887,17.124,20574,6275,14299,7.693,25.223,-6606,-8.099,34.248,408,410,1470
2000,2121,798,1155,70753,73922,123,10.345,191,16.064,8660,3873,4787,5.239,11.715,14788,6211,8577,8.402,20.005,-6128,-8.29,23.43,109,115,2456
2000,2122,307,408,33941,36407,61,14.681,76,18.291,2139,577,1562,1.585,5.875,7148,1843,5305,5.062,19.634,-5009,-13.758,11.75,44,51,617
2000,2123,3225,5171,100710,101605,404,7.861,340,6.616,13607,4487,9120,4.416,13.392,15719,4639,11080,4.566,15.471,-2112,-2.079,26.784,215,216,1567
2000,2131,6491,7699,165517,158259,865,11.198,916,11.858,42513,10711,31802,6.768,26.863,28249,7965,20284,5.033,17.85,14264,9.013,35.7,593,608,3299
2000,2211,1574,9122,526689,529830,830,9.31,416,4.666,53971,24385,29586,4.602,10.186,60846,9039,51807,1.706,11.484,-6875,-1.298,20.373,70,74,926
2000,2212,546,2553,89436,90390,196,7.587,257,9.948,11623,5226,6397,5.782,12.859,13651,3499,10152,3.871,15.102,-2028,-2.244,25.717,46,57,455
2000,2213,4369,4887,38454,37681,550,11.585,271,5.708,5765,2685,3080,7.126,15.299,4172,1214,2958,3.222,11.072,1593,4.228,22.144,196,197,767
2000,2361,133463,134128,760525,741880,19956,14.951,18654,13.975,194880,63543,131337,8.565,26.268,157208,63784,93424,8.598,21.19,37672,5.078,42.381,13366,13395,48263
2000,2362,40761,41620,807381,788176,4138,9.939,4167,10.009,169324,27187,142137,3.449,21.483,130242,30205,100037,3.832,16.524,39082,4.959,33.049,2960,2962,18220
2000,2371,16550,17067,450048,425228,1810,10.773,1279,7.612,107696,30339,77357,7.135,25.327,57906,12016,45890,2.826,13.618,49790,11.709,27.235,929,929,8107
2000,2372,9801,9980,73149,70328,2101,21.805,1412,14.654,20463,8799,11664,12.511,29.097,14927,6061,8866,8.618,21.225,5536,7.872,42.45,1025,1027,4123
2000,2373,10570,11012,296804,286666,774,7.002,859,7.771,58802,7040,51762,2.456,20.512,38530,7254,31276,2.53,13.441,20272,7.072,26.882,626,626,5538
2000,2379,4539,4635,75704,72190,563,12.027,655,13.993,19162,4858,14304,6.73,26.544,12136,4054,8082,5.616,16.811,7026,9.733,33.623,514,516,3015
2000,2381,93673,94090,1007669,975578,12079,12.962,10275,11.026,244001,58327,185674,5.979,25.011,179728,52712,127016,5.403,18.423,64273,6.588,36.845,7493,7493,38408
2000,2382,143211,146022,1818106,1755114,15175,10.465,13159,9.074,370468,86360,284108,4.92,21.108,244991,78272,166719,4.46,13.959,125477,7.149,27.917,9783,9805,57507
2000,2383,96880,97592,837509,818373,14432,14.915,12773,13.2,199626,55452,144174,6.776,24.393,161514,52802,108712,6.452,19.736,38112,4.657,39.472,9416,9419,40739
2000,2389,51444,51765,454215,438181,7259,14.214,5866,11.487,111546,32038,79508,7.312,25.457,79372,26337,53035,6.011,18.114,32174,7.343,36.228,4282,4283,19284
2000,3111,1069,1642,49475,49194,103,6.298,90,5.503,5460,1389,4071,2.824,11.099,4919,1610,3309,3.273,9.999,541,1.1,19.999,50,51,620
2000,3112,494,858,61040,61952,44,5.125,45,5.242,4070,738,3332,1.191,6.57,5878,1315,4563,2.123,9.488,-1808,-2.918,13.139,25,25,418
2000,3113,1399,1580,83445,83263,111,6.948,146,9.139,9461,1285,8176,1.543,11.363,8888,2946,5942,3.538,10.675,573,0.688,21.349,95,96,1222
2000,3114,1286,1683,168199,170401,120,7.082,143,8.439,16814,3864,12950,2.268,9.867,21072,6427,14645,3.772,12.366,-4258,-2.499,19.735,91,95,2162
2000,3115,1128,1641,132124,131652,75,4.509,120,7.214,11254,2050,9204,1.557,8.548,10419,3969,6450,3.015,7.914,835,0.634,15.828,72,74,1488
2000,3116,3199,3831,490370,486542,229,5.96,251,6.533,38561,5279,33282,1.085,7.926,30727,8394,22333,1.725,6.315,7834,1.61,12.631,184,185,2488
2000,3117,639,752,40323,41033,59,7.789,70,9.241,5210,1419,3791,3.458,12.697,6609,1519,5090,3.702,16.107,-1399,-3.409,25.394,47,47,671
2000,3118,9057,9861,298368,294803,939,9.456,1078,10.855,40986,9889,31097,3.354,13.903,34224,12819,21405,4.348,11.609,6762,2.294,23.218,825,831,5420
2000,3119,2264,2630,143216,143882,210,7.964,224,8.495,14759,4222,10537,2.934,10.258,16019,4477,11542,3.112,11.133,-1260,-0.876,20.515,154,154,1814
2000,3121,1994,2465,138341,139408,243,9.951,197,8.067,14413,4450,9963,3.192,10.339,16477,3831,12646,2.748,11.819,-2064,-1.481,20.677,147,147,1579
2000,3122,74,104,27173,27592,11,10.377,15,14.151,1912,210,1702,0.761,6.93,2760,927,1833,3.36,10.003,-848,-3.073,13.859,10,10,305
2000,3131,357,589,80289,81641,49,8.348,45,7.666,6930,2479,4451,3.036,8.488,9668,2844,6824,3.484,11.842,-2738,-3.354,16.977,26,26,631
2000,3132,1572,1882,181397,188693,114,5.956,178,9.3,11498,2094,9404,1.11,6.094,25998,8811,17187,4.67,13.778,-14500,-7.684,12.187,126,126,2291
2000,3133,1949,2081,85948,88430,123,5.758,233,10.908,8371,2107,6264,2.383,9.466,13415,4751,8664,5.373,15.17,-5044,-5.704,18.932,181,185,2956
2000,3141,2601,2849,120136,121573,227,7.872,296,10.265,14339,4765,9574,3.919,11.795,17183,3503,13680,2.881,14.134,-2844,-2.339,23.589,243,245,2038
2000,3149,4301,4437,102289,103089,434,9.75,463,10.401,14071,3653,10418,3.544,13.649,15435,5374,10061,5.213,14.973,-1364,-1.323,27.299,364,364,3967
2000,3151,924,1007,75890,80179,76,7.339,133,12.844,6645,1912,4733,2.385,8.288,15178,5393,9785,6.726,18.93,-8533,-10.643,16.576,99,100,1369
2000,3152,9456,9957,361632,385842,1581,15.625,1904,18.817,54667,21464,33203,5.563,14.168,102262,46764,55498,12.12,26.504,-47595,-12.335,28.337,1476,1501,25792
2000,3159,1771,1843,46460,47878,169,8.876,291,15.284,6690,2487,4203,5.194,13.973,9625,3715,5910,7.759,20.103,-2935,-6.13,27.946,222,227,2362
2000,3161,276,297,13939,14695,21,6.897,36,11.823,1118,436,682,2.967,7.608,2599,650,1949,4.423,17.687,-1481,-10.079,15.217,29,29,258
2000,3162,312,351,29016,31268,32,8.976,43,12.062,1603,375,1228,1.199,5.127,6007,2186,3821,6.991,19.212,-4404,-14.085,10.253,21,22,466
2000,3169,893,916,23688,24336,70,7.515,101,10.843,2365,256,2109,1.052,9.718,3703,1190,2513,4.89,15.216,-1338,-5.498,19.436,75,75,727
2000,3211,3996,4469,133593,133836,282,6.229,399,8.813,13209,2737,10472,2.045,9.87,13654,4119,9535,3.078,10.202,-445,-0.332,19.739,302,304,2106
2000,3212,1437,1816,121338,119587,109,6.032,91,5.036,11224,2124,9100,1.776,9.386,7758,2004,5754,1.676,6.487,3466,2.898,12.975,63,63,945
2000,3219,9215,10020,344085,343584,938,9.395,867,8.683,44139,11557,32582,3.364,12.847,43058,11599,31459,3.376,12.532,1081,0.315,25.064,666,671,6765
2000,3221,248,542,167754,168677,25,4.625,22,4.07,8209,4986,3223,2.956,4.867,10517,2376,8141,1.409,6.235,-2308,-1.368,9.733,8,8,85
2000,3222,3388,5144,393492,395550,220,4.257,267,5.167,31406,7668,23738,1.939,7.94,35684,16097,19587,4.07,9.021,-4278,-1.082,15.88,162,164,2599
2000,3231,35172,36977,811268,817122,2036,5.412,3325,8.838,77429,17258,60171,2.112,9.476,89448,31812,57636,3.893,10.947,-12019,-1.471,18.952,2641,2658,20249
2000,3241,1064,2120,110764,110597,123,5.76,154,7.211,9555,1797,7758,1.625,8.639,9170,2688,6482,2.43,8.291,385,0.348,16.583,58,58,758
2000,3251,1104,2345,196768,198875,113,4.819,113,4.819,10953,2864,8089,1.44,5.507,15133,2928,12205,1.472,7.609,-4180,-2.102,11.015,42,42,541
2000,3252,474,802,117516,117370,60,7.585,38,4.804,8761,1945,6816,1.657,7.464,8583,1428,7155,1.217,7.313,178,0.152,14.626,20,20,169
2000,3253,643,868,35774,36247,49,5.622,56,6.426,2630,497,2133,1.371,7.256,3618,724,2894,1.997,9.982,-988,-2.726,14.512,37,37,195
2000,3254,1379,1722,222571,217809,125,7.242,133,7.706,21629,3379,18250,1.551,9.93,12563,3073,9490,1.411,5.768,9066,4.162,11.536,87,87,1530
2000,3255,1562,2014,74966,75029,100,4.942,119,5.881,6842,1646,5196,2.194,9.119,6952,2022,4930,2.695,9.266,-110,-0.147,18.238,69,69,544
2000,3256,2053,2282,123623,123705,139,6.067,157,6.853,11329,1792,9537,1.449,9.158,11526,2731,8795,2.208,9.317,-197,-0.159,18.316,108,110,1962
2000,3259,2137,2792,119372,120837,189,6.783,178,6.388,10772,3070,7702,2.541,8.914,13745,3323,10422,2.75,11.375,-2973,-2.46,17.829,112,123,2337
2000,3261,10320,12905,835484,828161,700,5.389,871,6.705,97840,20869,76971,2.52,11.814,82963,24164,58799,2.918,10.018,14877,1.796,20.035,561,566,9030
2000,3262,1975,2566,206558,204670,149,5.801,154,5.996,16013,2493,13520,1.218,7.824,12212,2059,10153,1.006,5.967,3801,1.857,11.933,113,113,804
2000,3271,1438,1686,75010,74611,112,6.512,180,10.465,7441,1243,6198,1.666,9.973,6654,1765,4889,2.366,8.918,787,1.055,17.837,138,138,922
2000,3272,1885,2177,130988,130491,171,7.884,155,7.146,11043,1477,9566,1.132,8.463,9703,2469,7234,1.892,7.436,1340,1.027,14.872,108,108,798
2000,3273,5333,9024,216082,210616,568,6.332,460,5.128,33251,7645,25606,3.63,15.787,22023,6516,15507,3.094,10.456,11228,5.331,20.913,274,287,3944
2000,3274,244,382,20923,20893,30,7.853,30,7.853,1705,636,1069,3.044,8.161,1646,322,1324,1.541,7.878,59,0.282,15.757,21,21,91
2000,3279,2027,2446,75530,75345,198,8.152,164,6.752,7439,2061,5378,2.735,9.873,7148,2273,4875,3.017,9.487,291,0.386,18.974,108,111,1095
2000,3311,368,469,136847,135368,112,26.322,25,5.875,9267,3026,6241,2.235,6.846,6367,998,5369,0.737,4.703,2900,2.142,9.407,16,16,142
2000,3312,578,784,65804,65258,78,10.25,32,4.205,5865,2012,3853,3.083,8.987,4703,1000,3703,1.532,7.207,1162,1.781,14.414,17,17,328
2000,3313,399,570,87055,87373,35,6.178,28,4.943,4791,842,3949,0.964,5.483,5709,759,4950,0.869,6.534,-918,-1.051,10.967,13,13,151
2000,3314,721,915,76253,77715,67,7.383,52,5.73,5396,983,4413,1.265,6.943,8450,1702,6748,2.19,10.873,-3054,-3.93,13.887,32,32,366
2000,3315,2290,2611,220549,220801,94,3.558,156,5.905,18437,1938,16499,0.878,8.35,19108,3489,15619,1.58,8.654,-671,-0.304,16.7,122,123,1763
2000,3321,2658,2897,147809,147728,96,3.265,183,6.223,12980,1594,11386,1.079,8.786,12815,3561,9254,2.411,8.675,165,0.112,17.349,137,137,1480
2000,3322,1451,1604,80551,80760,98,6.093,107,6.652,6285,1296,4989,1.605,7.782,6852,1509,5343,1.868,8.484,-567,-0.702,15.565,76,76,502
2000,3323,11036,11987,413508,407000,774,6.458,769,6.417,52906,12427,40479,3.053,12.999,39702,11175,28527,2.746,9.755,13204,3.244,19.51,556,566,7620
2000,3324,1388,1731,101149,102842,70,3.993,114,6.503,8884,1059,7825,1.03,8.639,12251,3270,8981,3.18,11.913,-3367,-3.274,17.277,82,82,1421
2000,3325,769,858,67754,66842,44,5.119,47,5.468,6461,1106,5355,1.655,9.666,4728,946,3782,1.415,7.073,1733,2.593,14.147,33,33,398
2000,3326,1627,1815,71221,70635,121,6.669,120,6.613,7443,1499,5944,2.122,10.537,6289,1428,4861,2.022,8.904,1154,1.634,17.807,86,87,805
2000,3327,25019,25488,430853,429385,1598,6.236,1870,7.298,50829,11617,39212,2.705,11.838,48105,12156,35949,2.831,11.203,2724,0.634,22.406,1436,1438,7924
2000,3328,5422,5996,155325,154518,311,5.154,388,6.43,18055,3343,14712,2.164,11.685,16423,4492,11931,2.907,10.629,1632,1.056,21.257,307,309,2916
2000,3329,5799,6365,310471,310156,471,7.396,477,7.491,28187,6416,21771,2.069,9.088,27765,7838,19927,2.527,8.952,422,0.136,17.904,345,345,3701
2000,3331,2559,2881,198037,200541,157,5.404,206,7.09,17086,3116,13970,1.554,8.52,22212,6451,15761,3.217,11.076,-5126,-2.556,17.04,140,140,1990
2000,3332,4029,4269,183490,180938,288,6.695,354,8.229,23935,7196,16739,3.977,13.228,19251,7093,12158,3.92,10.64,4684,2.589,21.279,249,250,2260
2000,3333,2237,2403,131470,132591,151,6.226,196,8.081,12321,2494,9827,1.881,9.293,14574,3617,10957,2.728,10.992,-2253,-1.699,18.585,151,152,1910
2000,3334,1413,1739,180368,179740,90,5.137,116,6.621,16063,3230,12833,1.797,8.937,14821,4583,10238,2.55,8.246,1242,0.691,16.492,69,69,1378
2000,3335,9182,9574,234590,236543,426,4.413,584,6.05,21278,5514,15764,2.331,8.995,24968,5517,19451,2.332,10.555,-3690,-1.56,17.991,459,460,3873
2000,3336,751,913,111132,111186,38,4.148,44,4.803,7728,554,7174,0.498,6.951,7642,1716,5926,1.543,6.873,86,0.077,13.746,26,26,672
2000,3339,5776,6461,342991,345020,312,4.792,413,6.343,30250,8882,21368,2.574,8.768,34556,7591,26965,2.2,10.016,-4306,-1.248,17.535,290,292,3890
2000,3341,1588,1690,197198,203634,207,12.296,194,11.524,21222,5312,15910,2.609,10.422,32827,10094,22733,4.957,16.121,-11605,-5.699,20.843,139,139,1628
2000,3342,1774,1990,230363,236085,160,7.99,185,9.238,25811,5879,19932,2.49,10.933,36456,7613,28843,3.225,15.442,-10645,-4.509,21.866,125,125,1748
2000,3343,494,520,30444,30228,61,11.787,56,10.821,4426,947,3479,3.133,14.642,4015,2017,1998,6.673,13.283,411,1.36,26.565,33,35,400
2000,3344,4885,5602,568240,556636,389,6.893,471,8.347,84172,18121,66051,3.255,15.122,60359,17901,42458,3.216,10.844,23813,4.278,21.687,314,317,5154
2000,3345,4382,5046,477033,487821,287,5.62,408,7.99,42926,7931,34995,1.626,8.8,63392,27637,35755,5.665,12.995,-20466,-4.195,17.599,249,252,3798
2000,3346,764,826,42032,43708,113,13.976,78,9.647,4555,932,3623,2.132,10.422,7744,2380,5364,5.445,17.718,-3189,-7.296,20.843,58,59,762
2000,3351,1146,1258,74939,75021,91,7.216,97,7.692,7294,1633,5661,2.177,9.723,7322,2536,4786,3.38,9.76,-28,-0.037,19.445,77,77,942
2000,3352,248,318,103654,102334,28,8.777,30,9.404,9711,1754,7957,1.714,9.49,6817,2052,4765,2.005,6.662,2894,2.828,13.323,19,19,309
2000,3353,2283,2713,197707,197878,109,3.972,172,6.267,16791,3052,13739,1.542,8.486,17297,4005,13292,2.024,8.741,-506,-0.256,16.971,108,109,745
2000,3359,1853,2245,202414,198742,189,8.475,159,7.13,24529,5766,18763,2.901,12.342,17183,5107,12076,2.57,8.646,7346,3.696,17.292,105,105,1474
2000,3361,288,351,225860,225100,47,13.506,41,11.782,20791,6426,14365,2.855,9.236,19343,12034,7309,5.346,8.593,1448,0.643,17.186,25,25,372
2000,3362,1759,1981,151877,146441,153,7.719,155,7.82,19913,5203,14710,3.553,13.598,8959,2470,6489,1.687,6.118,10954,7.48,12.236,117,117,1574
2000,3363,4370,5521,825712,814985,306,5.493,406,7.288,84198,16668,67530,2.045,10.331,62571,18381,44190,2.255,7.678,21627,2.654,15.355,275,277,5734
2000,3364,1372,1706,417582,439298,129,7.579,121,7.109,28136,6798,21338,1.547,6.405,72991,5032,67959,1.145,16.615,-44855,-10.211,12.81,82,82,1385
2000,3365,148,212,29291,30199,13,6.047,19,8.837,2452,319,2133,1.056,8.119,4341,313,4028,1.036,14.375,-1889,-6.255,16.239,12,12,83
2000,3366,1502,1620,144780,144203,172,10.723,140,8.728,14343,2924,11419,2.028,9.946,13169,2222,10947,1.541,9.132,1174,0.814,18.265,104,104,1253
2000,3369,665,690,37753,37694,83,12.064,79,11.483,4842,888,3954,2.356,12.846,4782,1450,3332,3.847,12.686,60,0.159,25.373,59,59,418
2000,3371,13271,13774,411406,403375,1384,10.071,1322,9.619,51188,9856,41332,2.443,12.69,34970,11270,23700,2.794,8.669,16218,4.021,17.339,1003,1012,7959
2000,3372,3911,4133,188571,186429,255,6.134,303,7.289,21377,3814,17563,2.046,11.467,17201,5022,12179,2.694,9.227,4176,2.24,18.453,226,226,3155
2000,3379,958,1084,48441,47050,52,4.764,67,6.138,6611,1231,5380,2.616,14.051,3791,733,3058,1.558,8.057,2820,5.994,16.115,51,52,626
2000,3391,10667,11311,290511,288861,771,6.794,847,7.463,38094,9028,29066,3.125,13.188,34690,10917,23773,3.779,12.009,3404,1.178,24.018,605,606,3516
2000,3399,17068,17635,431612,429262,1857,10.583,1682,9.585,55430,14889,40541,3.469,12.913,50681,16746,33935,3.901,11.807,4749,1.106,23.613,1337,1341,9510
2000,4231,16363,20840,305183,302154,2165,10.386,2175,10.434,45118,18383,26735,6.084,14.932,39039,14487,24552,4.795,12.92,6079,2.012,25.841,1559,1623,9521
2000,4232,9863,11112,152171,147920,1259,11.45,1026,9.331,26923,8098,18825,5.475,18.201,18326,7104,11222,4.803,12.389,8597,5.812,24.778,742,768,4985
2000,4233,8940,12075,167046,160614,1427,12.018,1025,8.632,32309,12321,19988,7.671,20.116,19295,6461,12834,4.023,12.013,13014,8.103,24.027,672,686,3807
2000,4234,28172,36399,709272,703284,4402,12.105,4332,11.913,142955,52200,90755,7.422,20.327,130546,52028,78518,7.398,18.562,12409,1.764,37.125,2774,2869,17483
2000,4235,7621,10352,167683,165799,738,7.119,768,7.408,20705,5189,15516,3.13,12.488,17004,5544,11460,3.344,10.256,3701,2.232,20.512,499,512,3110
2000,4236,19623,29763,470688,457858,3330,11.255,2979,10.068,95104,35871,59233,7.835,20.772,70174,26568,43606,5.803,15.327,24930,5.445,30.653,1569,1692,10385
2000,4237,10879,16472,211832,207133,1124,6.827,1109,6.736,31781,7753,24028,3.743,15.343,22184,7059,15125,3.408,10.71,9597,4.633,21.42,721,756,4671
2000,4238,48255,64160,763306,761520,4316,6.689,5037,7.807,98346,29016,69330,3.81,12.914,94930,35071,59859,4.605,12.466,3416,0.449,24.932,3221,3533,20015
2000,4239,28708,31036,324148,318747,3852,12.505,3388,10.999,56205,18073,38132,5.67,17.633,45800,17355,28445,5.445,14.369,10405,3.264,28.738,2547,2585,12365
2000,4241,9575,12476,219338,217221,870,6.892,1164,9.221,33812,8044,25768,3.703,15.566,30121,15199,14922,6.997,13.867,3691,1.699,27.733,616,639,3152
2000,4242,4974,6360,194588,186788,941,15.014,756,12.062,40155,15668,24487,8.388,21.498,24029,10925,13104,5.849,12.864,16126,8.633,25.729,492,496,4202
2000,4243,13826,14928,189979,187729,1876,12.598,1803,12.108,33609,9988,23621,5.32,17.903,29179,10319,18860,5.497,15.543,4430,2.36,31.086,1391,1408,6317
2000,4244,26598,32224,772378,770188,2833,8.735,3249,10.018,101507,25891,75616,3.362,13.18,97639,33933,63706,4.406,12.677,3868,0.502,25.355,2361,2438,19276
2000,4245,4839,7591,68973,69285,336,4.37,531,6.906,8328,1900,6428,2.742,12.02,8940,3032,5908,4.376,12.903,-612,-0.883,24.04,331,368,2135
2000,4246,9489,13599,160676,156494,1173,8.652,1091,8.047,28304,9746,18558,6.228,18.086,19940,7382,12558,4.717,12.742,8364,5.345,25.483,645,661,3477
2000,4247,6880,9922,126184,127041,478,4.711,925,9.117,17580,3554,14026,2.798,13.838,19423,8131,11292,6.4,15.289,-1843,-1.451,27.676,355,377,3000
2000,4248,3141,3993,154094,151257,246,6.089,340,8.416,16945,2977,13968,1.968,11.203,11273,5085,6188,3.362,7.453,5672,3.75,14.906,229,237,2626
2000,4249,22523,27113,367227,362236,3249,12.011,3124,11.549,62905,20895,42010,5.768,17.366,53065,21448,31617,5.921,14.649,9840,2.716,29.299,2283,2325,11265
2000,4251,33567,35819,303108,303700,2950,8.215,3128,8.711,45821,11727,34094,3.861,15.088,47436,17344,30092,5.711,15.619,-1615,-0.532,30.175,2118,2135,10589
2000,4411,42850,46413,1216245,1194284,4508,9.76,4057,8.784,152187,47763,104424,3.999,12.743,107987,45542,62445,3.813,9.042,44200,3.701,18.084,3066,3124,30713
2000,4412,12172,13184,125420,120244,1314,10.081,1015,7.787,24058,7163,16895,5.957,20.008,13651,5238,8413,4.356,11.353,10407,8.655,22.706,785,797,3908
2000,4413,35669,59771,550808,547519,4406,7.338,4957,8.255,74665,25775,48890,4.708,13.637,68088,28374,39714,5.182,12.436,6577,1.201,24.871,2618,3059,14718
2000,4421,19809,27780,287868,281660,2217,7.967,2313,8.312,45571,13468,32103,4.782,16.179,33129,12573,20556,4.464,11.762,12442,4.417,23.524,1536,1675,7154
2000,4422,24725,32901,269864,262947,3620,11.11,2983,9.155,55737,27436,28301,10.434,21.197,41920,15596,26324,5.931,15.942,13817,5.255,31.885,1884,2164,10605
2000,4431,32481,50243,487205,474296,5363,10.699,5127,10.228,92694,34134,58560,7.197,19.543,66520,25518,41002,5.38,14.025,26174,5.518,28.05,3607,3764,16743
2000,4441,48382,69863,1093601,1068674,3984,5.677,4623,6.587,157194,48326,108868,4.522,14.709,107303,57325,49978,5.364,10.041,49891,4.668,20.082,2958,3148,18497
2000,4442,16480,20530,190005,186067,1353,6.567,1500,7.28,29880,7584,22296,4.076,16.059,22108,7374,14734,3.963,11.882,7772,4.177,23.764,1069,1083,5051
2000,4451,60166,87943,2700722,2743703,8907,10.049,10299,11.619,328685,140926,187759,5.136,11.98,417708,208875,208833,7.613,15.224,-89023,-3.245,23.959,5865,6042,42440
2000,4452,17499,22020,155259,153976,3031,13.651,3397,15.3,36953,14571,22382,9.463,23.999,34085,18989,15096,12.332,22.137,2868,1.863,44.273,1806,1902,8230
2000,4453,22909,26065,134422,133303,2140,8.193,2250,8.614,20905,6979,13926,5.235,15.682,18713,7150,11563,5.364,14.038,2192,1.644,28.076,1634,1656,5270
2000,4461,40057,77539,905769,941760,6075,7.774,7294,9.334,130784,49347,81437,5.24,13.887,203026,70718,132308,7.509,21.558,-72242,-7.671,27.774,3218,3497,19119
2000,4471,61608,113781,936263,931973,8182,7.146,9617,8.399,159172,55961,103211,6.005,17.079,150152,55038,95114,5.906,16.111,9020,0.968,32.222,5630,6052,33024
2000,4481,36847,83943,1006921,972531,8651,10.261,9383,11.129,208536,80182,128354,8.245,21.443,138492,59701,78791,6.139,14.24,70044,7.202,28.481,4138,4529,17362
2000,4482,6459,28396,194310,194958,2065,7.139,3127,10.81,38809,11940,26869,6.124,19.906,40149,13843,26306,7.101,20.594,-1340,-0.687,39.813,598,690,2581
2000,4483,19016,29290,170421,167019,2585,8.875,2256,7.746,28747,9930,18817,5.945,17.212,21845,8354,13491,5.002,13.079,6902,4.132,26.159,1302,1384,4763
2000,4511,29584,40324,393371,390993,3876,9.538,4499,11.072,70380,31816,38564,8.137,18,65316,24746,40570,6.329,16.705,5064,1.295,33.41,2926,3137,12262
2000,4512,7218,12914,150140,145634,974,7.418,1406,10.708,28224,9774,18450,6.711,19.38,19286,8366,10920,5.745,13.243,8938,6.137,26.486,805,958,4610
2000,4522,55,5930,1027324,1020226,180,3.027,212,3.565,89988,21493,68495,2.107,8.82,72829,23921,48908,2.345,7.139,17159,1.682,14.277,(D),(D),(D)
2000,4523,9126,31531,1534819,1503779,3707,12.102,1909,6.232,178559,80135,98424,5.329,11.874,115039,32705,82334,2.175,7.65,63520,4.224,15.3,1000,1083,10715
2000,4531,20988,22034,121134,121044,1793,8.009,2500,11.167,20144,5612,14532,4.636,16.642,19969,8973,10996,7.413,16.497,175,0.145,32.995,1917,1975,6957
2000,4532,29337,41017,360531,357372,4227,10.284,4400,10.705,62091,27497,34594,7.694,17.374,55377,18474,36903,5.169,15.496,6714,1.879,30.991,2932,3014,10259
2000,4533,12682,16385,114161,112171,1695,10.288,1875,11.381,19261,7213,12048,6.43,17.171,15238,5535,9703,4.934,13.585,4023,3.587,27.169,1490,1505,4130
2000,4539,31461,39470,252933,249872,5459,13.971,4665,11.939,52864,23098,29766,9.244,21.156,46542,19847,26695,7.943,18.626,6322,2.53,37.253,3345,3480,14005
2000,4541,10042,10976,268235,252505,2594,25.341,1115,10.892,64887,28606,36281,11.329,25.697,33527,9874,23653,3.91,13.278,31360,12.42,26.556,788,791,4813
2000,4542,4951,5535,66654,66516,593,10.637,673,12.072,8740,2210,6530,3.323,13.14,8528,3697,4831,5.558,12.821,212,0.319,25.642,541,545,3008
2000,4543,19456,25494,228795,226470,2688,10.591,2459,9.689,37690,11107,26583,4.904,16.642,33344,12838,20506,5.669,14.723,4346,1.919,29.447,1605,1658,8263
2000,4811,661,3141,522693,508415,294,9.495,205,6.62,47700,4738,42962,0.932,9.382,18713,6292,12421,1.238,3.681,28987,5.701,7.361,70,84,1955
2000,4812,1656,1808,34565,33436,276,15.428,238,13.304,6558,1787,4771,5.345,19.614,4251,2008,2243,6.006,12.714,2307,6.9,25.428,149,151,829
2000,4831,799,1186,51120,50711,149,12.558,150,12.642,9503,2412,7091,4.756,18.74,8902,1832,7070,3.613,17.555,601,1.185,35.109,72,80,1102
2000,4832,483,526,19023,18982,62,11.821,59,11.249,1994,399,1595,2.102,10.505,1908,422,1486,2.223,10.052,86,0.453,20.103,42,42,182
2000,4841,38743,47599,988364,972402,8995,19.267,7169,15.356,191026,65970,125056,6.784,19.645,162568,60688,101880,6.241,16.718,28458,2.927,33.436,5293,5429,27617
2000,4842,45868,49366,503862,500584,5812,11.643,6918,13.858,91318,25755,65563,5.145,18.242,84963,32793,52170,6.551,16.973,6355,1.27,33.946,5292,5336,21945
2000,4851,458,694,39599,38111,100,14.62,80,11.696,5775,2801,2974,7.35,15.153,2902,1802,1100,4.728,7.615,2873,7.539,15.229,37,37,701
2000,4852,209,379,21205,19803,35,9.186,39,10.236,4398,291,4107,1.47,22.209,1516,722,794,3.646,7.656,2882,14.554,15.311,23,23,190
2000,4853,5812,5914,68378,66023,968,16.536,848,14.486,13780,4684,9096,7.094,20.872,9074,4368,4706,6.616,13.744,4706,7.128,27.487,677,679,3297
2000,4854,3079,4137,161909,162784,250,5.975,344,8.222,17221,4535,12686,2.786,10.579,19167,9990,9177,6.137,11.774,-1946,-1.195,21.158,216,228,3529
2000,4855,1192,1332,33532,33190,123,9.121,156,11.568,5303,937,4366,2.823,15.978,4627,1847,2780,5.565,13.941,676,2.037,27.882,120,120,994
2000,4859,2253,2443,52297,51102,364,15.038,319,13.179,10502,2843,7659,5.563,20.551,8157,3918,4239,7.667,15.962,2345,4.589,31.924,225,228,1840
2000,4861,40,306,6544,6517,30,9.464,52,16.404,1470,480,990,7.365,22.556,1439,813,626,12.475,22.081,31,0.476,44.161,3,3,5
2000,4862,125,2012,36610,35398,618,33.614,271,14.74,11565,8442,3123,23.849,32.672,9290,3870,5420,10.933,26.245,2275,6.427,52.49,11,11,181
2000,4869,57,513,6529,6299,80,15.842,64,12.673,1392,510,882,8.097,22.101,979,395,584,6.271,15.543,413,6.557,31.087,(D),(D),(D)
2000,4871,366,409,8792,8655,52,12.84,44,10.864,1352,232,1120,2.681,15.622,1072,261,811,3.016,12.387,280,3.235,24.773,31,31,161
2000,4872,1172,1202,13357,12932,143,11.877,147,12.209,2729,530,2199,4.098,21.103,1922,405,1517,3.132,14.862,807,6.24,29.725,112,112,356
2000,4879,142,146,2063,2010,17,11.765,14,9.689,343,57,286,2.836,17.065,241,108,133,5.373,11.99,102,5.075,23.98,12,12,99
2000,4881,3142,4122,130099,125844,423,10.318,378,9.221,23292,5700,17592,4.529,18.509,14981,7747,7234,6.156,11.904,8311,6.604,23.809,238,242,1802
2000,4882,423,765,22777,21725,62,7.985,85,10.947,5773,2410,3363,11.093,26.574,3844,1576,2268,7.254,17.694,1929,8.879,35.389,32,34,403
2000,4883,1720,2248,79413,74744,202,8.926,232,10.252,19550,4979,14571,6.661,26.156,10193,2181,8012,2.918,13.637,9357,12.519,27.274,142,155,1098
2000,4884,6002,6288,54315,52104,868,13.88,799,12.777,13161,4566,8595,8.763,25.259,8778,3890,4888,7.466,16.847,4383,8.412,33.694,601,604,2790
2000,4885,10865,14545,164513,160361,1414,9.687,1517,10.393,31873,10221,21652,6.374,19.876,23675,10061,13614,6.274,14.764,8198,5.112,29.527,960,1054,6428
2000,4889,1023,1114,25178,23873,280,26.975,128,12.331,4501,1901,2600,7.963,18.854,1928,690,1238,2.89,8.076,2573,10.778,16.152,94,94,322
2000,4921,2403,6371,551777,530320,1136,18.49,682,11.1,91135,22620,68515,4.265,17.185,46511,23336,23175,4.4,8.77,44624,8.415,17.541,297,332,2559
2000,4922,4339,4780,68454,68208,666,13.819,745,15.458,11791,3551,8240,5.206,17.287,10986,5054,5932,7.41,16.107,805,1.18,32.213,600,616,3596
2000,4931,6698,12612,558433,547106,1275,10.227,986,7.909,103325,40636,62689,7.427,18.886,81116,27833,53283,5.087,14.826,22209,4.059,29.653,354,373,4633
2000,5111,15405,19345,690238,732511,2110,10.976,1867,9.712,76650,26079,50571,3.56,10.464,160441,21057,139384,2.875,21.903,-83791,-11.439,20.928,1368,1373,9994
2000,5112,7631,10071,335869,319423,1387,13.665,1545,15.222,89801,29577,60224,9.26,28.114,56770,27057,29713,8.471,17.773,33031,10.341,35.545,937,1000,11752
2000,5121,11966,16102,271284,266675,2085,12.914,2171,13.447,60996,20496,40500,7.686,22.873,51017,22818,28199,8.556,19.131,9979,3.742,38.262,1261,1303,6393
2000,5122,2539,2736,23524,22632,435,16.064,379,13.996,6072,2967,3105,13.11,26.829,4447,2218,2229,9.8,19.649,1625,7.18,39.298,305,305,1532
2000,5151,5225,7652,247189,246591,803,10.423,907,11.773,34569,14743,19826,5.979,14.019,33408,15533,17875,6.299,13.548,1161,0.471,27.096,596,671,10158
2000,5152,308,558,33596,32918,99,17.308,127,22.203,5330,1812,3518,5.505,16.192,3870,2191,1679,6.656,11.756,1460,4.435,23.513,46,86,1388
2000,5173,8002,39732,1362951,1294000,7681,20.405,3501,9.301,300314,149277,151037,11.536,23.208,162457,55986,106471,4.327,12.555,137857,10.654,25.109,1049,1464,17542
2000,5174,425,647,19059,17588,136,20.133,193,28.571,6278,2132,4146,12.122,35.695,3360,1343,2017,7.636,19.104,2918,16.591,38.208,44,45,472
2000,5179,6709,8019,139790,118687,2896,40.006,1336,18.456,66293,33995,32298,28.643,55.855,24081,12894,11187,10.864,20.29,42212,35.566,40.579,1005,1027,9628
2000,5182,5510,9559,373126,359424,2137,23.04,1569,16.916,88722,38113,50609,10.604,24.685,60567,17163,43404,4.775,16.851,28155,7.833,33.702,425,427,4224
2000,5191,3656,4364,82390,72581,797,19.46,260,6.348,25400,13122,12278,18.079,34.995,5388,2066,3322,2.846,7.423,20012,27.572,14.847,145,148,1210
2000,5211,14,43,22279,22575,(D),(D),0,0,332,(D),326,(D),1.471,918,0,918,0,4.067,-586,-2.596,2.941,0,0,0
2000,5221,18369,107196,1988478,1972409,9618,9.087,6922,6.54,333266,147617,185649,7.484,16.896,303340,98765,204575,5.007,15.379,29926,1.517,30.758,612,979,11831
2000,5222,17902,45387,621347,637841,6291,13.904,6011,13.285,136144,64084,72060,10.047,21.345,170821,69780,101041,10.94,26.781,-34677,-5.437,42.689,2132,2379,15803
2000,5223,13970,20602,211031,210281,4945,25.176,3024,15.396,56280,27492,28788,13.074,26.764,54188,24745,29443,11.768,25.769,2092,0.995,51.539,1726,1906,12390
2000,5231,11660,36829,534897,509924,7632,22.231,2634,7.673,106439,40943,65496,8.029,20.874,56276,19228,37048,3.771,11.036,50163,9.837,22.072,945,980,5897
2000,5232,81,92,6870,6720,35,44.025,10,12.579,522,180,342,2.679,7.768,241,33,208,0.491,3.587,281,4.182,7.173,9,9,32
2000,5239,25046,28526,318789,298028,5561,20.292,3319,12.111,80994,37678,43316,12.642,27.177,39969,18949,21020,6.358,13.411,41025,13.766,26.822,2205,2242,8661
2000,5241,5016,36328,1493634,1524524,5230,13.487,10129,26.121,234726,69611,165115,4.566,15.397,297141,117489,179652,7.707,19.491,-62415,-4.094,30.793,341,419,8149
2000,5242,112173,123597,819182,818836,11304,9.119,12031,9.706,143836,47962,95874,5.857,17.566,142821,66973,75848,8.179,17.442,1015,0.124,34.884,7886,8134,31870
2000,5259,585,625,5538,5365,245,45.328,76,14.061,3044,2381,663,44.384,56.743,2766,739,2027,13.776,51.561,278,5.182,103.122,50,50,239
2000,5311,87456,99723,529090,523642,10225,10.266,9980,10.02,100571,44898,55673,8.574,19.206,89426,36046,53380,6.884,17.078,11145,2.128,34.155,7538,7698,25399
2000,5312,49487,55898,271376,266850,7556,13.623,6690,12.062,61448,23165,38283,8.681,23.027,51754,22637,29117,8.483,19.394,9694,3.633,38.789,4364,4470,12391
2000,5313,44969,52391,494670,484263,7193,13.948,5554,10.77,95496,34961,60535,7.219,19.72,74103,28611,45492,5.908,15.302,21393,4.418,30.604,3459,3528,15599
2000,5321,4457,10409,178992,176888,1091,10.545,965,9.327,24517,7800,16717,4.41,13.86,20402,12711,7691,7.186,11.534,4115,2.326,23.068,468,498,2637
2000,5322,14699,30695,251752,252349,3039,9.788,3748,12.071,47326,19020,28306,7.537,18.754,47484,17978,29506,7.124,18.817,-158,-0.063,37.508,2420,2876,12420
2000,5323,3401,5800,39527,39552,410,7.077,397,6.853,5748,1605,4143,4.058,14.533,5684,2937,2747,7.426,14.371,64,0.162,28.742,303,320,2577
2000,5324,7190,11444,158485,153350,1408,12.342,1336,11.711,37104,15030,22074,9.801,24.196,27190,11588,15602,7.557,17.731,9914,6.465,35.461,732,838,6030
2000,5331,1689,1827,23078,22526,228,12.541,210,11.551,5265,1867,3398,8.288,23.373,4242,1509,2733,6.699,18.832,1023,4.541,37.663,147,150,1267
2000,5411,154293,161790,1093162,1090242,13204,8.145,13848,8.542,135080,40966,94114,3.758,12.39,129355,40747,88608,3.737,11.865,5725,0.525,23.73,9820,9915,29002
2000,5412,85295,92395,1188745,1150174,9695,10.563,8467,9.225,253719,72622,181097,6.314,22.059,175376,74084,101292,6.441,15.248,78343,6.811,30.496,5736,5812,33638
2000,5413,82409,93128,1237076,1222160,10084,10.902,8822,9.538,205651,60933,144718,4.986,16.827,175186,62881,112305,5.145,14.334,30465,2.493,28.668,5735,5851,27222
2000,5414,24019,24261,137343,133924,3539,14.698,3173,13.178,29913,10649,19264,7.952,22.336,22866,9791,13075,7.311,17.074,7047,5.262,34.148,2397,2401,7512
2000,5415,73227,82647,1175684,1102120,18523,23.172,13100,16.388,366013,149655,216358,13.579,33.21,218768,85852,132916,7.79,19.85,147245,13.36,39.699,9172,9272,45219
2000,5416,64891,69308,629717,607309,14349,21.326,10301,15.31,161322,66606,94716,10.967,26.563,116781,51565,65216,8.491,19.229,44541,7.334,38.459,7470,7540,28495
2000,5417,9682,12516,582248,566634,1771,14.398,1340,10.894,100028,33465,66563,5.906,17.653,69634,19119,50515,3.374,12.289,30394,5.364,24.578,739,753,5611
2000,5418,32052,35569,487452,472432,4222,11.87,4219,11.862,104930,30819,74111,6.523,22.211,74434,33133,41301,7.013,15.755,30496,6.455,31.511,3125,3183,17359
2000,5419,47383,54385,483252,467542,7029,13.252,4338,8.179,97209,32789,64420,7.013,20.792,66575,21253,45322,4.546,14.239,30634,6.552,28.479,2927,2951,13310
2000,5511,28283,53076,3349347,3321867,6450,12.279,5352,10.189,627824,214002,413822,6.442,18.9,578002,168418,409584,5.07,17.4,49822,1.5,34.8,1237,1397,20732
2000,5611,19722,21739,436299,418074,3298,15.243,3091,14.287,110760,43657,67103,10.442,26.493,74569,34058,40511,8.146,17.836,36191,8.657,35.673,2022,2086,21801
2000,5612,1463,3156,129671,126752,765,26.375,254,8.757,28695,10555,18140,8.327,22.639,22833,9640,13193,7.605,18.014,5862,4.625,36.028,99,101,3195
2000,5613,26484,45223,4482112,4234599,7298,16.448,5593,12.605,1315248,334000,981248,7.887,31.06,823360,301833,521527,7.128,19.444,491888,11.616,38.887,2732,2862,88953
2000,5614,25405,30596,714770,698069,4157,13.567,4244,13.851,171575,59026,112549,8.456,24.579,137183,52309,84874,7.493,19.652,34392,4.927,39.304,2981,3077,27520
2000,5615,22426,30377,302826,300714,2723,8.758,4151,13.351,59508,21317,38191,7.089,19.789,55064,25182,29882,8.374,18.311,4444,1.478,36.622,2629,2704,13727
2000,5616,15529,19796,705845,703066,2488,12.642,2257,11.468,112591,38245,74346,5.44,16.014,108878,31380,77498,4.463,15.486,3713,0.528,30.972,1552,1567,16590
2000,5617,115670,121649,1507314,1477463,17577,14.495,16799,13.854,322962,101272,221690,6.854,21.859,263643,102605,161038,6.945,17.844,59319,4.015,35.689,12652,12675,68830
2000,5619,20022,22122,472884,428959,2214,9.893,2729,12.194,142567,17742,124825,4.136,33.236,58382,17850,40532,4.161,13.61,84185,19.625,27.22,2031,2058,10947
2000,5621,5790,7196,152496,151979,834,11.455,1003,13.777,30620,12104,18516,7.964,20.148,29345,15349,13996,10.099,19.309,1275,0.839,38.617,739,754,8019
2000,5622,1415,2338,52681,51876,442,19.631,269,11.948,12861,7137,5724,13.758,24.792,11307,6329,4978,12.2,21.796,1554,2.996,43.592,159,162,2413
2000,5629,5318,5898,93897,91740,664,11.246,677,11.466,21469,4694,16775,5.117,23.402,17035,6518,10517,7.105,18.569,4434,4.833,37.138,458,472,3201
2000,6111,16524,18843,740961,720842,1033,5.539,648,3.474,79708,20828,58880,2.889,11.058,39983,8763,31220,1.216,5.547,39725,5.511,11.093,397,403,5035
2000,6112,528,789,80392,78537,28,3.529,37,4.663,8553,320,8233,0.407,10.89,4620,799,3821,1.017,5.883,3933,5.008,11.765,24,28,566
2000,6113,2355,2990,1337957,1322424,159,5.373,98,3.311,86257,4702,81555,0.356,6.523,55256,876,54380,0.066,4.178,31001,2.344,8.357,67,67,676
2000,6114,5486,6026,64546,62543,967,16.244,821,13.791,15649,6268,9381,10.022,25.021,11724,4216,7508,6.741,18.746,3925,6.276,37.491,594,615,2795
2000,6115,5298,6229,79687,76848,706,11.383,652,10.513,16128,5671,10457,7.38,20.987,10289,4164,6125,5.418,13.389,5839,7.598,26.778,443,462,2728
2000,6116,21172,23010,203256,194387,3309,14.669,2404,10.657,46487,16037,30450,8.25,23.915,28477,10425,18052,5.363,14.65,18010,9.265,29.299,1759,1780,7847
2000,6117,3262,3533,39084,36405,563,16.185,454,13.052,10768,5301,5467,14.561,29.579,5265,1442,3823,3.961,14.462,5503,15.116,28.925,325,328,1047
2000,6211,157542,178413,1752842,1716424,14750,8.257,15199,8.508,304857,108684,196173,6.332,17.761,232278,104657,127621,6.097,13.533,72579,4.229,27.065,9891,10447,55253
2000,6212,106224,110270,705554,692323,5385,4.896,4824,4.386,98169,26331,71838,3.803,14.18,71705,19874,51831,2.871,10.357,26464,3.822,20.714,3682,3743,15144
2000,6213,78462,84265,419253,420353,9134,10.937,7631,9.137,85717,31710,54007,7.544,20.392,87302,47208,40094,11.231,20.769,-1585,-0.377,40.783,5196,5292,17579
2000,6214,10442,21928,554788,548744,2350,10.721,2332,10.639,94010,30408,63602,5.541,17.132,81795,34982,46813,6.375,14.906,12215,2.226,29.812,729,780,8453
2000,6215,5474,8670,158438,154270,1508,17.57,1334,15.542,38335,21572,16763,13.983,24.849,31205,13996,17209,9.072,20.228,7130,4.622,40.455,490,644,5467
2000,6216,10148,15010,784956,790629,1886,12.06,3144,20.104,149974,38032,111942,4.81,18.969,161865,76348,85517,9.657,20.473,-11891,-1.504,37.938,1365,1541,28010
2000,6219,4473,6730,183139,181753,855,12.912,638,9.635,37457,13750,23707,7.565,20.609,34696,15375,19321,8.459,19.09,2761,1.519,38.179,323,351,4841
2000,6221,3413,5470,4557834,4561566,212,3.889,174,3.192,238016,56053,181963,1.229,5.218,245147,80853,164294,1.772,5.374,-7131,-0.156,10.436,58,58,28912
2000,6222,508,753,239182,242154,38,4.935,72,9.351,11045,4610,6435,1.904,4.561,16831,8043,8788,3.321,6.951,-5786,-2.389,9.122,17,32,5103
2000,6223,290,437,145481,149139,43,9.663,59,13.258,11008,3777,7231,2.533,7.381,18471,10054,8417,6.741,12.385,-7463,-5.004,14.762,15,15,3110
2000,6231,7896,15743,1520521,1528058,1278,8.166,1092,6.978,158857,58742,100115,3.844,10.396,172366,65328,107038,4.275,11.28,-13509,-0.884,20.792,473,553,29620
2000,6232,7451,22454,404594,395147,2429,11.165,1033,4.748,65576,26605,38971,6.733,16.595,46713,11931,34782,3.019,11.822,18863,4.774,23.643,396,437,4767
2000,6233,12494,16507,512385,493717,2047,12.554,1645,10.088,85413,33979,51434,6.882,17.3,48294,20082,28212,4.068,9.782,37119,7.518,19.563,1140,1181,11061
2000,6239,3435,6014,149543,147503,512,8.63,350,5.899,20574,5479,15095,3.715,13.948,16596,4119,12477,2.792,11.251,3978,2.697,22.503,191,200,1747
2000,6241,30556,43463,793256,768643,3573,8.31,2635,6.129,123204,29500,93704,3.838,16.029,74244,18328,55916,2.384,9.659,48960,6.37,19.318,1604,1648,9990
2000,6242,8302,10361,122769,119234,612,5.957,437,4.254,17872,3571,14301,2.995,14.989,10730,2993,7737,2.51,8.999,7142,5.99,17.998,237,252,1865
2000,6243,5172,7961,316194,310205,563,7.098,504,6.354,45579,8163,37416,2.631,14.693,33690,4478,29212,1.444,10.861,11889,3.833,21.721,242,246,1856
2000,6244,47772,60024,700392,683364,6900,11.594,5883,9.885,120635,45713,74922,6.689,17.653,87248,32877,54371,4.811,12.767,33387,4.886,25.535,4246,4324,22940
2000,7111,7574,7650,122532,119615,925,12.054,972,12.667,26395,6560,19835,5.484,22.067,20560,6244,14316,5.22,17.188,5835,4.878,34.377,660,663,4312
2000,7112,3265,3417,98172,96259,539,15.851,506,14.88,18116,3904,14212,4.056,18.82,14175,5153,9022,5.353,14.726,3941,4.094,29.452,365,365,2957
2000,7113,3469,3650,76325,70761,573,16.15,369,10.4,18887,5425,13462,7.667,26.691,7746,2271,5475,3.209,10.947,11141,15.745,21.894,263,263,1636
2000,7114,2464,2517,16013,15317,409,16.776,251,10.295,4242,1811,2431,11.823,27.695,2794,1217,1577,7.945,18.241,1448,9.454,36.482,184,184,750
2000,7115,9019,9041,40164,39107,1723,19.401,1403,15.798,14918,5909,9009,15.11,38.147,12774,4603,8171,11.77,32.665,2144,5.482,65.329,853,854,2578
2000,7121,5092,5496,108221,105686,342,6.269,261,4.784,12542,2052,10490,1.942,11.867,7459,1053,6406,0.996,7.058,5083,4.81,14.115,157,158,611
2000,7131,1627,2410,130286,124929,318,12.552,565,22.301,26217,4715,21502,3.774,20.986,16145,7122,9023,5.701,12.923,10072,8.062,25.847,235,428,6015
2000,7132,1643,2036,183375,173326,252,12.481,218,10.797,32818,10392,22426,5.996,18.934,11640,2836,8804,1.636,6.716,21178,12.219,13.431,160,161,1695
2000,7139,44717,49104,952588,925717,4814,9.828,4573,9.336,165278,47597,117681,5.142,17.854,111613,38125,73488,4.118,12.057,53665,5.797,24.114,3403,3426,26801
2000,7211,34494,44328,1713874,1698315,4645,10.564,3927,8.931,234529,102944,131585,6.062,13.81,203361,77893,125468,4.586,11.974,31168,1.835,23.949,2551,2611,38140
2000,7212,5020,5432,38506,37865,438,8.083,412,7.603,6611,1561,5050,4.123,17.459,5271,1629,3642,4.302,13.921,1340,3.539,27.841,288,292,1260
2000,7213,2772,2832,14821,14825,142,4.891,284,9.783,2346,519,1827,3.501,15.825,2365,930,1435,6.273,15.953,-19,-0.128,31.65,205,205,664
2000,7223,10638,24685,503916,489953,3403,14.029,2548,10.504,90916,39783,51133,8.12,18.556,62865,27838,35027,5.682,12.831,28051,5.725,25.662,1171,1195,8199
2000,7224,44738,45227,327176,327238,4901,10.712,5950,13.005,69494,32272,37222,9.862,21.237,69551,31485,38066,9.621,21.254,-57,-0.017,42.473,4610,4624,23630
2000,7225,262658,363095,7296627,7195748,40079,11.05,39299,10.835,1316010,603179,712831,8.382,18.289,1112841,422066,690775,5.865,15.465,203169,2.823,30.931,27205,28943,271523
2000,8111,138183,150329,869542,862406,14394,9.527,15900,10.524,153912,56496,97416,6.551,17.847,139769,59068,80701,6.849,16.207,14143,1.64,32.414,10884,11216,40976
2000,8112,12425,14323,146101,145651,1350,9.198,2057,14.016,28089,11567,16522,7.942,19.285,26941,11980,14961,8.225,18.497,1148,0.788,36.994,1462,1495,6134
2000,8113,20831,22409,196801,195719,1886,8.375,2106,9.352,31545,7895,23650,4.034,16.117,29176,8614,20562,4.401,14.907,2369,1.21,29.814,1551,1560,5830
2000,8114,23669,24788,139074,141556,2656,10.56,3383,13.45,20756,7298,13458,5.156,14.663,26227,15023,11204,10.613,18.528,-5471,-3.865,29.325,2378,2466,7741
2000,8121,73918,85258,501293,494220,10206,11.947,10540,12.338,97516,40188,57328,8.132,19.731,83631,39261,44370,7.944,16.922,13885,2.809,33.844,7704,8067,26579
2000,8122,14948,21290,162142,159602,1093,5.144,1009,4.749,19472,6573,12899,4.118,12.2,14877,5251,9626,3.29,9.321,4595,2.879,18.643,657,684,3304
2000,8123,33010,39471,392216,392258,3496,8.765,4322,10.836,57689,19288,38401,4.917,14.707,57423,22224,35199,5.666,14.639,266,0.068,29.278,3145,3273,14776
2000,8129,19967,30731,231316,230802,5773,19.528,3437,11.626,53999,29005,24994,12.567,23.396,53126,17689,35437,7.664,23.018,873,0.378,46.036,2131,2160,8637
2000,8131,160541,160661,1566240,1536898,7891,4.94,6037,3.779,182604,29071,153533,1.892,11.881,124264,20856,103408,1.357,8.085,58340,3.796,16.171,3177,3177,9166
2000,8132,10624,12461,132827,128943,1102,8.947,814,6.609,21503,5018,16485,3.892,16.676,13602,5139,8463,3.985,10.549,7901,6.128,21.098,444,445,1573
2000,8133,8955,10748,105456,102698,1021,9.674,633,5.998,16148,3484,12664,3.392,15.724,10615,2811,7804,2.737,10.336,5533,5.388,20.672,381,382,1616
2000,8134,27562,29353,320475,315646,1271,4.313,1499,5.087,39300,5260,34040,1.666,12.451,29680,5777,23903,1.83,9.403,9620,3.048,18.806,948,948,3024
2000,8139,61954,63999,519754,512938,3209,4.999,3602,5.611,68992,13305,55687,2.594,13.45,55593,13223,42370,2.578,10.838,13399,2.612,21.676,2492,2504,8946
2001,1131,347,385,3036,3061,53,13.856,48,12.549,512,203,309,6.633,16.729,583,168,415,5.489,19.049,-71,-2.32,33.459,24,24,86
2001,1132,163,226,2056,1873,29,13.093,20,9.029,686,129,557,6.887,36.626,314,86,228,4.592,16.765,372,19.861,33.529,14,14,57
2001,1133,10664,10727,72145,75531,982,8.953,1465,13.356,10604,2932,7672,3.882,14.039,17392,5437,11955,7.198,23.026,-6788,-8.987,28.079,1070,1071,3877
2001,1141,1392,1402,7333,7587,227,16.191,227,16.191,1381,526,855,6.933,18.203,1829,840,989,11.072,24.109,-448,-5.905,36.407,141,141,308
2001,1142,323,323,2595,2516,48,15.335,28,8.946,388,159,229,6.32,15.421,234,50,184,1.987,9.3,154,6.121,18.601,19,19,33
2001,1151,4184,4506,59496,60910,572,12.72,554,12.319,13376,4253,9123,6.982,21.96,15978,7892,8086,12.957,26.232,-2602,-4.272,43.921,360,360,4499
2001,1152,3518,3574,20807,20363,565,16.257,368,10.588,4056,1695,2361,8.324,19.919,3154,1071,2083,5.26,15.489,902,4.43,30.979,265,265,726
2001,1153,1283,1323,15346,15284,172,13.07,158,12.006,2659,585,2074,3.828,17.397,2560,564,1996,3.69,16.75,99,0.648,33.499,106,106,444
2001,2111,5686,6906,85045,82039,689,10.017,634,9.217,19120,7731,11389,9.424,23.306,12783,5847,6936,7.127,15.582,6337,7.724,31.163,363,370,2479
2001,2121,758,1129,70559,70562,133,11.636,161,14.086,11252,3896,7356,5.521,15.946,11456,4046,7410,5.734,16.235,-204,-0.289,31.893,99,100,1728
2001,2122,279,379,32299,33264,35,8.827,70,17.654,1724,455,1269,1.368,5.183,3656,358,3298,1.076,10.991,-1932,-5.808,10.366,49,53,195
2001,2123,3271,5267,99279,100474,426,8.117,389,7.412,11628,3129,8499,3.114,11.573,13980,3209,10771,3.194,13.914,-2352,-2.341,23.146,225,226,1804
2001,2131,6863,8137,195330,180849,1059,13.272,744,9.324,46486,9745,36741,5.388,25.704,17769,6793,10976,3.756,9.825,28717,15.879,19.651,488,510,3915
2001,2211,1576,9097,524550,526987,752,8.235,822,9.001,59803,29919,29884,5.677,11.348,65150,15977,49173,3.032,12.363,-5347,-1.015,22.696,72,86,1381
2001,2212,523,2480,89637,90213,232,9.212,309,12.269,16236,2785,13451,3.087,17.997,17440,4997,12443,5.539,19.332,-1204,-1.335,35.995,53,78,804
2001,2213,4514,5167,39784,39242,493,9.753,269,5.321,6040,3046,2994,7.762,15.392,5015,2189,2826,5.578,12.78,1025,2.612,25.56,176,177,1072
2001,2361,132853,133556,729046,728583,20007,15.064,18523,13.947,167670,63959,103711,8.779,23.013,166742,66551,100191,9.134,22.886,928,0.127,45.772,12573,12578,46236
2001,2362,43391,44272,830719,826496,4175,9.424,4239,9.568,151967,29027,122940,3.512,18.387,142904,29912,112992,3.619,17.29,9063,1.097,34.581,2968,2973,20629
2001,2371,18643,19234,478670,468247,1971,10.42,1334,7.052,98106,19120,78986,4.083,20.952,78042,17217,60825,3.677,16.667,20064,4.285,33.334,953,953,11655
2001,2372,10159,10318,79365,79856,1733,16.844,1674,16.271,17071,6262,10809,7.842,21.377,17816,7209,10607,9.028,22.31,-745,-0.933,42.755,1240,1240,5024
2001,2373,10845,11340,304415,308456,865,7.625,875,7.713,50335,12154,38181,3.94,16.318,58288,12052,46236,3.907,18.897,-7953,-2.578,32.637,589,589,5603
2001,2379,4347,4471,72594,73352,556,12.313,645,14.284,15385,3760,11625,5.126,20.974,16941,3469,13472,4.729,23.096,-1556,-2.121,41.949,500,500,2716
2001,2381,92091,92520,973466,973224,11357,12.31,10832,11.741,205148,54083,151065,5.557,21.079,204253,56021,148232,5.756,20.987,895,0.092,41.975,7722,7724,41288
2001,2382,142291,145199,1819983,1804437,14658,10.13,13653,9.436,337406,80595,256811,4.466,18.699,306045,101136,204909,5.605,16.961,31361,1.738,33.921,9670,9677,60883
2001,2383,95779,96529,814554,808447,14190,14.804,12841,13.396,179941,52955,126986,6.55,22.258,168152,55082,113070,6.813,20.799,11789,1.458,41.599,9286,9300,38850
2001,2389,47946,48273,404402,408751,5712,11.736,6506,13.368,81598,26770,54828,6.549,19.963,90103,30345,59758,7.424,22.043,-8505,-2.081,39.926,4626,4627,21221
2001,3111,1105,1678,48318,49044,111,6.582,128,7.59,5244,1712,3532,3.491,10.693,6612,2024,4588,4.127,13.482,-1368,-2.789,21.385,58,58,417
2001,3112,487,845,58560,59621,37,4.335,54,6.327,3654,685,2969,1.149,6.129,5791,1062,4729,1.781,9.713,-2137,-3.584,12.257,29,30,347
2001,3113,1449,1626,84629,84135,139,8.631,108,6.706,8328,1880,6448,2.235,9.898,7277,1909,5368,2.269,8.649,1051,1.249,17.298,78,81,605
2001,3114,1259,1661,166767,167619,107,6.379,140,8.346,18661,4733,13928,2.824,11.133,20281,6445,13836,3.845,12.099,-1620,-0.966,22.266,94,96,1671
2001,3115,1127,1631,131260,131773,82,4.994,104,6.334,11230,2687,8543,2.039,8.522,11980,4402,7578,3.341,9.091,-750,-0.569,17.044,66,67,1377
2001,3116,3147,3780,492689,492218,234,6.122,318,8.32,35494,5461,30033,1.109,7.211,34264,6962,27302,1.414,6.961,1230,0.25,13.922,241,242,3096
2001,3117,610,723,39196,39843,54,7.317,84,11.382,4691,914,3777,2.294,11.774,5949,1723,4226,4.325,14.931,-1258,-3.157,23.548,61,61,1128
2001,3118,9048,9870,301758,300310,1008,10.201,1030,10.424,36658,9379,27279,3.123,12.207,33959,12998,20961,4.328,11.308,2699,0.899,22.616,787,796,7292
2001,3119,2286,2661,138967,141943,210,7.889,212,7.964,13852,2885,10967,2.033,9.759,19681,6828,12853,4.81,13.865,-5829,-4.107,19.518,145,147,2487
2001,3121,2192,2667,143612,141952,252,9.511,217,8.19,17767,3985,13782,2.807,12.516,14508,4982,9526,3.51,10.22,3259,2.296,20.441,147,148,1666
2001,3122,95,124,23114,25180,24,20.779,7,6.061,747,189,558,0.751,2.967,4856,431,4425,1.712,19.286,-4109,-16.319,5.933,4,4,48
2001,3131,364,582,69181,74464,52,8.844,64,10.884,5045,2353,2692,3.16,6.775,15779,5773,10006,7.753,21.19,-10734,-14.415,13.55,26,29,714
2001,3132,1548,1841,165794,173742,108,5.763,174,9.285,9595,1886,7709,1.086,5.523,25587,6132,19455,3.529,14.727,-15992,-9.204,11.045,125,126,1451
2001,3133,1813,1947,78722,81983,142,7.072,264,13.147,6728,1986,4742,2.422,8.207,13266,4742,8524,5.784,16.181,-6538,-7.975,16.413,194,196,2497
2001,3141,2555,2792,112516,116866,203,7.167,284,10.026,8117,2242,5875,1.918,6.946,16741,5161,11580,4.416,14.325,-8624,-7.379,13.891,217,219,1877
2001,3149,4349,4489,94463,98411,441,9.775,486,10.772,10606,4178,6428,4.245,10.777,18484,6341,12143,6.443,18.782,-7878,-8.005,21.555,380,381,4580
2001,3151,859,937,67712,72077,64,6.584,134,13.786,4973,1098,3875,1.523,6.9,13548,3594,9954,4.986,18.797,-8575,-11.897,13.799,108,109,1791
2001,3152,9162,9586,312851,337496,1457,14.836,1926,19.612,41179,17867,23312,5.294,12.201,90169,42246,47923,12.517,26.717,-48990,-14.516,24.403,1540,1557,25598
2001,3159,1576,1631,40909,43396,122,7.141,277,16.213,4368,1150,3218,2.65,10.066,9231,4139,5092,9.538,21.272,-4863,-11.206,20.131,207,220,1790
2001,3161,269,283,11320,12671,18,6.218,31,10.708,499,139,360,1.097,3.938,3139,1223,1916,9.652,24.774,-2640,-20.836,7.877,17,21,954
2001,3162,312,348,25144,26516,34,9.812,31,8.947,2254,303,1951,1.143,8.501,4909,1854,3055,6.992,18.513,-2655,-10.013,17.001,22,22,504
2001,3169,892,917,21498,22544,93,10.131,95,10.349,2571,999,1572,4.431,11.405,4672,924,3748,4.099,20.724,-2101,-9.32,22.809,78,78,780
2001,3211,3873,4345,123800,128964,264,5.986,394,8.934,8946,2455,6491,1.904,6.937,19143,5669,13474,4.396,14.844,-10197,-7.907,13.874,286,292,3267
2001,3212,1468,1861,117271,120225,104,5.593,101,5.432,8342,2349,5993,1.954,6.939,14255,4112,10143,3.42,11.857,-5913,-4.918,13.877,66,66,1693
2001,3219,9303,10114,319630,333332,920,9.076,966,9.529,33447,12172,21275,3.652,10.034,61034,17889,43145,5.367,18.31,-27587,-8.276,20.068,690,701,9951
2001,3221,266,545,160242,164215,22,4.022,26,4.753,4772,1953,2819,1.189,2.906,12729,5471,7258,3.332,7.751,-7957,-4.845,5.812,9,9,316
2001,3222,3343,5058,377486,385725,188,3.682,284,5.562,24924,4847,20077,1.257,6.462,41600,16102,25498,4.174,10.785,-16676,-4.323,12.923,151,164,4841
2001,3231,34218,36007,782229,795030,2082,5.706,3050,8.358,67004,16686,50318,2.099,8.428,92738,29446,63292,3.704,11.665,-25734,-3.237,16.856,2426,2435,19448
2001,3241,1045,2160,105686,108354,186,8.663,160,7.452,8317,3717,4600,3.43,7.676,13637,3816,9821,3.522,12.586,-5320,-4.91,15.352,58,60,859
2001,3251,1115,2288,187579,192324,96,4.129,170,7.312,9540,2328,7212,1.21,4.96,18710,5353,13357,2.783,9.728,-9170,-4.768,9.921,51,51,1120
2001,3252,486,811,112182,115168,47,5.76,57,6.985,5182,1786,3396,1.551,4.5,11175,1989,9186,1.727,9.703,-5993,-5.204,8.999,34,34,564
2001,3253,650,877,34707,35230,76,8.622,85,9.643,3573,1024,2549,2.907,10.142,4586,1707,2879,4.845,13.017,-1013,-2.875,20.284,56,57,885
2001,3254,1378,1733,230450,226899,130,7.528,118,6.833,24493,5095,19398,2.245,10.795,17166,3902,13264,1.72,7.565,7327,3.229,15.131,77,78,1148
2001,3255,1577,2019,72469,74199,105,5.178,123,6.065,6173,1635,4538,2.204,8.32,9722,2355,7367,3.174,13.103,-3549,-4.783,16.639,65,65,465
2001,3256,2023,2268,121764,123164,165,7.251,180,7.91,14440,5586,8854,4.535,11.724,16562,6535,10027,5.306,13.447,-2122,-1.723,23.449,123,125,1297
2001,3259,2141,2798,121438,120978,180,6.407,203,7.225,13338,3675,9663,3.038,11.025,12555,4180,8375,3.455,10.378,783,0.647,20.756,127,128,1546
2001,3261,10152,12738,796207,816838,647,5.04,847,6.598,68286,18713,49573,2.291,8.36,109641,29840,79801,3.653,13.423,-41355,-5.063,16.72,555,564,12078
2001,3262,1910,2495,193986,199904,113,4.462,188,7.423,11139,2908,8231,1.455,5.572,22874,5659,17215,2.831,11.443,-11735,-5.87,11.144,117,119,2352
2001,3271,1421,1661,72742,74241,129,7.633,187,11.065,8625,4020,4605,5.415,11.618,11315,5154,6161,6.942,15.241,-2690,-3.623,23.235,136,143,3436
2001,3272,1893,2193,128412,129837,170,7.733,181,8.233,7701,1433,6268,1.104,5.931,10395,2270,8125,1.748,8.006,-2694,-2.075,11.863,118,118,781
2001,3273,5271,9124,218964,218444,593,6.506,573,6.287,29252,8017,21235,3.67,13.391,28155,7952,20203,3.64,12.889,1097,0.502,25.778,295,314,3734
2001,3274,243,384,19697,20287,31,8.105,28,7.32,1590,644,946,3.174,7.838,2724,702,2022,3.46,13.427,-1134,-5.59,15.675,18,18,102
2001,3279,2256,2664,77572,77036,257,9.826,160,6.117,8831,2283,6548,2.964,11.463,7749,2157,5592,2.8,10.059,1082,1.405,20.118,111,113,1472
2001,3311,446,545,137708,139007,98,18.543,65,12.299,7841,3119,4722,2.244,5.641,10477,2125,8352,1.529,7.537,-2636,-1.896,11.281,48,48,1807
2001,3312,585,790,62775,64266,72,9.225,53,6.791,4868,1942,2926,3.022,7.575,7663,1853,5810,2.883,11.924,-2795,-4.349,15.15,29,30,658
2001,3313,424,590,80048,83660,46,7.857,37,6.319,3872,1531,2341,1.83,4.628,11253,3401,7852,4.065,13.451,-7381,-8.823,9.257,12,12,200
2001,3314,709,900,75335,75853,63,6.946,77,8.49,5944,824,5120,1.086,7.836,6950,1687,5263,2.224,9.162,-1006,-1.326,15.672,46,51,802
2001,3315,2271,2591,205484,213517,104,3.969,163,6.22,12799,2515,10284,1.178,5.994,28931,5100,23831,2.389,13.55,-16132,-7.555,11.989,118,121,2282
2001,3321,2582,2815,144381,146349,88,3.08,172,6.02,14244,3620,10624,2.474,9.733,18152,5703,12449,3.897,12.403,-3908,-2.67,19.466,111,116,2312
2001,3322,1395,1544,73464,76963,61,3.872,124,7.871,4058,714,3344,0.928,5.273,11123,3497,7626,4.544,14.452,-7065,-9.18,10.545,88,88,581
2001,3323,11703,12690,425142,425834,907,7.195,740,5.87,51762,15747,36015,3.698,12.155,53366,16063,37303,3.772,12.532,-1604,-0.377,24.311,510,513,7020
2001,3324,1338,1671,97992,100146,46,2.698,114,6.686,7403,1168,6235,1.166,7.392,11756,2535,9221,2.531,11.739,-4353,-4.347,14.784,77,78,1272
2001,3325,749,833,62042,64701,32,3.789,55,6.513,3104,762,2342,1.178,4.797,8432,1242,7190,1.92,13.032,-5328,-8.235,9.595,37,38,558
2001,3326,1631,1811,69462,70515,108,5.942,121,6.657,6169,1176,4993,1.668,8.749,8176,1993,6183,2.826,11.595,-2007,-2.846,17.497,86,88,979
2001,3327,25174,25655,427609,429560,1701,6.635,1661,6.479,47870,10141,37729,2.361,11.144,51796,13082,38714,3.045,12.058,-3926,-0.914,22.288,1281,1284,8828
2001,3328,5455,6057,154025,155563,357,5.875,397,6.533,16455,4534,11921,2.915,10.578,19552,4831,14721,3.106,12.569,-3097,-1.991,21.155,306,306,3345
2001,3329,5654,6221,303437,307349,459,7.338,528,8.441,26056,7742,18314,2.519,8.478,34010,10295,23715,3.35,11.066,-7954,-2.588,16.955,388,389,4486
2001,3331,2540,2868,194186,196413,171,5.929,203,7.039,16459,2564,13895,1.305,8.38,20984,4595,16389,2.339,10.684,-4525,-2.304,16.76,144,145,2233
2001,3332,3958,4201,175370,179665,272,6.415,350,8.255,20235,5319,14916,2.961,11.263,28309,7412,20897,4.125,15.757,-8074,-4.494,22.525,249,251,3802
2001,3333,2171,2343,127884,130308,126,5.284,209,8.765,16551,2396,14155,1.839,12.701,21497,8449,13048,6.484,16.497,-4946,-3.796,25.403,141,141,2158
2001,3334,1420,1747,179019,179657,88,5.019,101,5.76,15435,2188,13247,1.218,8.591,16752,3413,13339,1.9,9.324,-1317,-0.733,17.183,73,73,1097
2001,3335,9096,9490,222574,228745,438,4.573,614,6.411,16840,3787,13053,1.656,7.362,29074,6646,22428,2.905,12.71,-12234,-5.348,14.724,457,458,3486
2001,3336,733,899,103607,107425,44,4.875,51,5.651,6841,1572,5269,1.463,6.368,14588,3100,11488,2.886,13.58,-7747,-7.212,12.736,33,33,260
2001,3339,5712,6407,337151,340967,335,5.177,463,7.155,32171,10018,22153,2.938,9.435,39886,11222,28664,3.291,11.698,-7715,-2.263,18.87,322,325,3485
2001,3341,1511,1610,189993,192559,177,10.783,240,14.621,34235,17422,16813,9.048,17.779,39729,23850,15879,12.386,20.632,-5494,-2.853,35.558,173,173,2418
2001,3342,1783,2009,249431,239714,209,10.403,209,10.403,48319,9997,38322,4.17,20.157,28345,13057,15288,5.447,11.825,19974,8.332,23.649,126,129,2831
2001,3343,515,540,28816,29652,63,11.754,55,10.261,2234,523,1711,1.764,7.534,3986,737,3249,2.486,13.443,-1752,-5.909,15.068,41,41,275
2001,3344,4856,5582,597556,583002,445,7.938,493,8.794,91013,21660,69353,3.715,15.611,62538,21448,41090,3.679,10.727,28475,4.884,21.454,331,332,7719
2001,3345,4436,5112,473035,475209,374,7.33,355,6.957,50230,17915,32315,3.77,10.57,54906,21649,33257,4.556,11.554,-4676,-0.984,21.14,207,207,3172
2001,3346,790,863,39429,40708,119,13.902,105,12.266,5034,1503,3531,3.692,12.366,7341,2796,4545,6.868,18.033,-2307,-5.667,24.732,70,71,689
2001,3351,1112,1222,73125,74010,62,4.998,99,7.981,5356,1747,3609,2.36,7.237,7256,1281,5975,1.731,9.804,-1900,-2.567,14.474,79,79,1063
2001,3352,248,316,95973,99887,27,8.477,32,10.047,4045,358,3687,0.358,4.05,11724,2171,9553,2.173,11.737,-7679,-7.688,8.099,21,21,216
2001,3353,2229,2657,193440,195891,135,5.007,213,7.901,16744,3602,13142,1.839,8.548,21574,5275,16299,2.693,11.013,-4830,-2.466,17.095,146,146,1313
2001,3359,1802,2207,203775,203401,154,6.937,180,8.108,19672,4151,15521,2.041,9.672,18793,3860,14933,1.898,9.239,879,0.432,18.479,126,127,1845
2001,3361,281,345,204562,214718,37,10.694,39,11.272,4865,910,3955,0.424,2.266,25185,792,24393,0.369,11.729,-20320,-9.464,4.532,27,27,301
2001,3362,1758,1991,134596,144162,153,7.665,163,8.166,10976,4662,6314,3.234,7.614,29999,4246,25753,2.945,20.809,-19023,-13.196,15.227,111,113,1712
2001,3363,4314,5478,761442,795151,303,5.482,401,7.255,48458,11061,37397,1.391,6.094,115681,16164,99517,2.033,14.548,-67223,-8.454,12.188,274,281,7638
2001,3364,1357,1679,409776,413786,104,6.134,137,8.08,23459,1811,21648,0.438,5.669,31691,15344,16347,3.708,7.659,-8232,-1.989,11.339,99,99,1253
2001,3365,143,207,26523,28014,15,7.126,22,10.451,1685,824,861,2.941,6.015,4688,944,3744,3.37,16.734,-3003,-10.72,12.03,13,13,408
2001,3366,1539,1662,137702,141907,163,9.825,157,9.464,8994,2318,6676,1.633,6.338,17269,1948,15321,1.373,12.169,-8275,-5.831,12.676,111,111,953
2001,3369,678,704,38291,38381,81,11.555,75,10.699,4869,1086,3783,2.83,12.686,5028,733,4295,1.91,13.1,-159,-0.414,25.372,58,58,415
2001,3371,13968,14459,400036,409175,1463,10.161,1341,9.314,37282,9949,27333,2.431,9.112,55313,17898,37415,4.374,13.518,-18031,-4.407,18.223,983,989,10789
2001,3372,3998,4227,183896,187722,241,5.653,314,7.365,14963,2676,12287,1.426,7.971,22432,6153,16279,3.278,11.95,-7469,-3.979,15.942,224,227,3113
2001,3379,941,1067,47019,47818,61,5.677,76,7.073,3344,558,2786,1.167,6.993,4937,1086,3851,2.271,10.325,-1593,-3.331,13.987,60,61,730
2001,3391,10669,11324,290525,290317,823,7.246,890,7.836,31195,6557,24638,2.259,10.745,30732,12358,18374,4.257,10.586,463,0.159,21.171,665,667,5740
2001,3399,16922,17491,413799,422704,1614,9.198,1727,9.842,43208,10749,32459,2.543,10.222,60521,17335,43186,4.101,14.318,-17313,-4.096,20.444,1317,1322,10663
2001,4231,16022,20737,301977,305570,2188,10.519,2313,11.12,42649,18324,24325,5.997,13.957,49659,20856,28803,6.825,16.251,-7010,-2.294,27.914,1534,1641,11184
2001,4232,9950,11233,153924,154106,1224,10.949,1117,9.992,22092,6125,15967,3.975,14.336,22310,8439,13871,5.476,14.477,-218,-0.141,28.671,802,826,4238
2001,4233,9165,12667,169908,168978,1774,14.289,1271,10.237,29962,14005,15957,8.288,17.731,27790,9089,18701,5.379,16.446,2172,1.285,32.892,684,912,5760
2001,4234,27582,35577,733591,723971,3994,11.093,4849,13.468,158306,63192,95114,8.729,21.866,139154,66248,72906,9.151,19.221,19152,2.645,38.442,2822,3102,28934
2001,4235,7581,10300,161324,164415,699,6.767,757,7.329,16275,4424,11851,2.691,9.899,22539,7293,15246,4.436,13.709,-6264,-3.81,19.797,444,471,2917
2001,4236,19626,30171,505426,492687,3738,12.441,3488,11.609,114916,48250,66666,9.793,23.324,89380,37569,51811,7.625,18.141,25536,5.183,36.283,1662,1782,13181
2001,4237,10741,16530,210564,211860,1283,7.758,1300,7.86,27440,9402,18038,4.438,12.952,30249,9810,20439,4.63,14.278,-2809,-1.326,25.904,713,756,4132
2001,4238,47178,63556,762057,765038,4414,6.909,5077,7.947,95404,27616,67788,3.61,12.47,101680,37809,63871,4.942,13.291,-6276,-0.82,24.941,3166,3399,19668
2001,4239,28640,31024,325249,324889,3621,11.687,3541,11.428,53183,16644,36539,5.123,16.37,52776,19203,33573,5.911,16.244,407,0.125,32.489,2674,2708,13908
2001,4241,9373,12287,216080,217418,872,7.051,1032,8.345,26623,7061,19562,3.248,12.245,29146,10814,18332,4.974,13.406,-2523,-1.16,24.49,615,621,3252
2001,4242,5028,6425,221891,209008,754,11.796,688,10.763,51025,15437,35588,7.386,24.413,24117,10134,13983,4.849,11.539,26908,12.874,23.078,456,472,4075
2001,4243,13732,14878,190170,191703,1863,12.513,1883,12.648,30989,11322,19667,5.906,16.165,33709,10508,23201,5.481,17.584,-2720,-1.419,32.33,1453,1474,6945
2001,4244,26269,32057,773830,777070,3068,9.534,3314,10.298,98465,28901,69564,3.719,12.671,104561,38774,65787,4.99,13.456,-6096,-0.784,25.343,2335,2421,20522
2001,4245,4676,7345,67153,68399,405,5.4,714,9.521,9212,3004,6208,4.392,13.468,11648,4498,7150,6.576,17.03,-2436,-3.561,26.936,374,411,2078
2001,4246,9391,14372,160426,160637,1931,13.804,1165,8.328,25081,10832,14249,6.743,15.614,25468,8243,17225,5.131,15.854,-387,-0.241,31.227,606,635,2880
2001,4247,6638,9670,124027,125252,574,5.866,806,8.236,19529,7125,12404,5.689,15.592,21387,7339,14048,5.859,17.075,-1858,-1.483,31.184,373,385,2520
2001,4248,3109,3952,156895,155374,309,7.769,360,9.051,16490,4200,12290,2.703,10.613,13220,6553,6667,4.218,8.509,3270,2.105,17.017,230,244,3359
2001,4249,22763,27335,378943,379433,3438,12.548,3564,13.008,63180,23896,39284,6.298,16.651,63897,24797,39100,6.535,16.84,-717,-0.189,33.302,2328,2397,12990
2001,4251,32984,35099,288681,296423,2653,7.494,3262,9.214,42020,15042,26978,5.075,14.176,57168,18768,38400,6.331,19.286,-15148,-5.11,28.351,2111,2148,9634
2001,4411,43113,46782,1219097,1219625,4332,9.26,4332,9.26,127199,43182,84017,3.541,10.429,128330,44251,84079,3.628,10.522,-1131,-0.093,20.859,3334,3385,32102
2001,4412,12418,13450,129831,128014,1327,9.922,1175,8.786,21616,7066,14550,5.52,16.886,18134,6505,11629,5.081,14.166,3482,2.72,28.331,867,898,5000
2001,4413,35039,59344,520331,534067,3658,6.138,4167,6.992,59002,21143,37859,3.959,11.048,87331,25513,61818,4.777,16.352,-28329,-5.304,22.095,2489,2779,14271
2001,4421,19755,27607,277725,282994,2542,9.159,2836,10.218,40468,13828,26640,4.886,14.3,49929,19887,30042,7.027,17.643,-9461,-3.343,28.6,1588,1910,9318
2001,4422,25296,33549,295105,283795,3372,10.087,3131,9.366,60267,22208,38059,7.825,21.236,38773,14275,24498,5.03,13.662,21494,7.574,27.325,1923,2047,8280
2001,4431,32235,50544,490020,490273,5362,10.594,5498,10.863,82915,33229,49686,6.778,16.912,83739,29738,54001,6.066,17.08,-824,-0.168,33.824,3848,4008,19789
2001,4441,48429,70295,1089654,1094699,4466,6.345,4653,6.61,142917,78208,64709,7.144,13.055,155553,38708,116845,3.536,14.21,-12636,-1.154,26.111,3068,3257,20413
2001,4442,17516,21441,194967,198278,1438,6.667,1695,7.858,25472,8276,17196,4.174,12.847,32114,10593,21521,5.343,16.196,-6642,-3.35,25.693,1078,1125,5651
2001,4451,59788,87000,2628964,2663843,8727,9.976,9692,11.079,303868,127110,176758,4.772,11.407,375430,146820,228610,5.512,14.094,-71562,-2.686,22.814,6200,6333,44861
2001,4452,17297,21720,149234,151300,2808,12.867,3016,13.82,30574,12235,18339,8.087,20.208,34828,18710,16118,12.366,23.019,-4254,-2.812,40.415,2018,2140,9465
2001,4453,22906,26041,135550,134975,2127,8.148,2255,8.638,20644,6761,13883,5.009,15.295,19386,7448,11938,5.518,14.363,1258,0.932,28.725,1670,1686,5620
2001,4461,39727,77488,948756,929642,5539,7.139,5733,7.389,141926,37169,104757,3.998,15.267,104610,36586,68024,3.935,11.253,37316,4.014,22.505,3203,3457,18219
2001,4471,60299,112832,930907,935208,8449,7.454,9478,8.362,151439,54806,96633,5.86,16.193,160093,52125,107968,5.574,17.118,-8654,-0.925,32.386,5683,6218,32404
2001,4481,36140,84003,1020219,1013951,8894,10.585,8936,10.635,187015,78511,108504,7.743,18.444,175745,62345,113400,6.149,17.333,11270,1.111,34.665,3943,4714,21227
2001,4482,6225,26948,191600,193385,2064,7.457,3523,12.729,36753,14306,22447,7.398,19.005,40489,20766,19723,10.738,20.937,-3736,-1.932,38.01,611,1916,9941
2001,4483,18990,29751,174285,172773,2686,9.083,2329,7.876,27594,11803,15791,6.832,15.971,24559,7808,16751,4.519,14.215,3035,1.757,28.429,1393,1527,4536
2001,4511,29026,39770,414198,404184,3660,9.13,4293,10.709,79113,27517,51596,6.808,19.574,59742,25196,34546,6.234,14.781,19371,4.793,29.562,2925,3093,14941
2001,4512,6949,12666,141662,146100,985,7.703,1228,9.603,18858,7370,11488,5.044,12.908,26938,6517,20421,4.461,18.438,-8080,-5.53,25.815,760,782,3107
2001,4522,55,5614,955834,984880,173,3.046,303,5.335,57238,16778,40460,1.704,5.812,114722,35570,79152,3.612,11.648,-57484,-5.837,11.623,(D),(D),(D)
2001,4523,8899,32394,1608398,1578891,2786,8.704,2014,6.292,183424,79999,103425,5.067,11.617,124974,38709,86265,2.452,7.915,58450,3.702,15.831,1083,1107,4794
2001,4531,20721,21758,124088,123963,1829,8.3,2384,10.819,20790,6022,14768,4.858,16.771,20623,7982,12641,6.439,16.636,167,0.135,33.273,1886,1916,6101
2001,4532,28968,40788,345795,353337,4217,10.311,4441,10.858,50493,22836,27657,6.463,14.29,65608,23421,42187,6.629,18.568,-15115,-4.278,28.581,3110,3267,13242
2001,4533,12433,16253,115747,115357,1629,9.97,1802,11.028,17372,6411,10961,5.558,15.059,16730,5717,11013,4.956,14.503,642,0.557,29.006,1392,1428,3932
2001,4539,30860,38827,247023,249891,4636,11.877,5051,12.94,45784,17173,28611,6.872,18.322,51087,20488,30599,8.199,20.444,-5303,-2.122,36.643,3495,3635,13883
2001,4541,10470,11410,270245,271536,2137,19.103,1690,15.107,55303,20555,34748,7.57,20.367,58563,20474,38089,7.54,21.567,-3260,-1.201,40.734,1264,1297,11448
2001,4542,4854,5457,64101,65410,568,10.334,647,11.771,6976,3183,3793,4.866,10.665,9627,4117,5510,6.294,14.718,-2651,-4.053,21.33,523,524,2183
2001,4543,19451,25534,231010,229712,2870,11.287,2657,10.449,37702,12783,24919,5.565,16.413,34783,13056,21727,5.684,15.142,2919,1.271,30.284,1721,1757,7392
2001,4811,624,3136,522420,522759,336,10.754,313,10.018,49614,6415,43199,1.227,9.491,51987,6947,45040,1.329,9.945,-2373,-0.454,18.982,78,86,950
2001,4812,1713,1863,36242,35780,282,15.359,228,12.418,5936,1813,4123,5.067,16.59,5098,1264,3834,3.533,14.248,838,2.342,28.496,169,173,986
2001,4831,767,1174,52407,52518,130,11.064,132,11.234,8715,2996,5719,5.705,16.594,8862,2531,6331,4.819,16.874,-147,-0.28,33.189,77,86,1700
2001,4832,481,527,19252,19217,51,9.632,56,10.576,3412,1144,2268,5.953,17.756,3485,1284,2201,6.682,18.135,-73,-0.38,35.511,38,38,396
2001,4841,39384,48691,983810,986412,8767,18.145,8016,16.591,155144,60140,95004,6.097,15.728,159536,69796,89740,7.076,16.173,-4392,-0.445,31.456,5777,6034,41972
2001,4842,45383,48866,493977,500167,5797,11.754,6701,13.587,79633,25521,54112,5.103,15.921,92165,32592,59573,6.516,18.427,-12532,-2.506,31.843,5028,5059,21254
2001,4851,493,718,40761,41371,103,14.466,91,12.781,4137,1415,2722,3.42,10,5347,3146,2201,7.604,12.925,-1210,-2.925,20,39,50,1059
2001,4852,202,402,20229,20778,61,15.621,38,9.731,2792,845,1947,4.067,13.438,3911,623,3288,2.998,18.823,-1119,-5.386,26.875,22,25,236
2001,4853,5908,6021,69468,68937,953,15.936,871,14.565,12246,4829,7417,7.005,17.764,11131,4891,6240,7.095,16.147,1115,1.617,32.293,687,688,3839
2001,4854,3062,4228,169290,165808,330,7.858,273,6.501,22299,8764,13535,5.286,13.449,15003,4131,10872,2.491,9.048,7296,4.4,18.097,195,195,2053
2001,4855,1157,1300,33527,33337,112,8.533,137,10.438,4898,1521,3377,4.562,14.692,4585,1107,3478,3.321,13.753,313,0.939,27.507,101,105,855
2001,4859,2278,2478,54052,53136,394,16.036,352,14.326,10690,4814,5876,9.06,20.118,8840,3471,5369,6.532,16.637,1850,3.482,33.273,265,265,1811
2001,4861,42,244,6402,6509,29,10.526,92,33.394,922,310,612,4.763,14.166,1159,686,473,10.54,17.807,-237,-3.641,28.332,0,0,0
2001,4862,130,2075,35104,35787,210,10.287,143,7.005,4538,1835,2703,5.128,12.681,6017,2319,3698,6.48,16.813,-1479,-4.133,25.361,5,5,46
2001,4869,56,466,5925,6229,46,9.378,95,19.368,883,256,627,4.11,14.176,1506,718,788,11.527,24.177,-623,-10.002,28.351,4,4,7
2001,4871,392,432,8673,8547,70,16.548,52,12.293,1216,417,799,4.879,14.228,969,396,573,4.633,11.338,247,2.89,22.676,31,31,194
2001,4872,1216,1248,13120,12831,177,14.361,146,11.846,2504,635,1869,4.949,19.515,1928,652,1276,5.081,15.026,576,4.489,30.052,118,118,471
2001,4879,131,135,1949,2004,12,8.511,24,17.021,164,16,148,0.798,8.184,279,125,154,6.238,13.922,-115,-5.739,16.367,18,18,99
2001,4881,3198,4183,132794,131813,505,12.12,472,11.328,23844,8191,15653,6.214,18.089,21772,9890,11882,7.503,16.517,2072,1.572,33.035,284,289,2067
2001,4882,427,789,22646,22867,74,9.332,82,10.34,4167,1593,2574,6.966,18.223,4567,1493,3074,6.529,19.972,-400,-1.749,36.446,35,46,657
2001,4883,1701,2204,78727,79122,197,8.834,249,11.166,12177,3199,8978,4.043,15.39,13049,2859,10190,3.613,16.492,-872,-1.102,30.781,136,140,689
2001,4884,6179,6507,58432,56605,934,14.519,786,12.218,13151,4783,8368,8.45,23.233,9501,4291,5210,7.581,16.785,3650,6.448,33.57,588,590,2509
2001,4885,11066,15003,171559,169253,1829,12.34,1466,9.891,34332,13100,21232,7.74,20.284,29656,10359,19297,6.12,17.522,4676,2.763,35.044,921,973,5778
2001,4889,999,1104,26173,25727,193,17.674,169,15.476,4230,1449,2781,5.632,16.442,3296,809,2487,3.145,12.812,934,3.63,25.623,140,140,588
2001,4921,2549,6677,517280,534931,1111,17.123,734,11.312,32284,12949,19335,2.421,6.035,67117,8819,58298,1.649,12.547,-34833,-6.512,12.07,336,341,2278
2001,4922,4356,4792,60913,64737,705,14.672,731,15.213,9405,3628,5777,5.604,14.528,17040,5419,11621,8.371,26.322,-7635,-11.794,29.056,580,601,4669
2001,4931,6843,12925,582176,572559,1440,11.226,1245,9.706,116279,45899,70380,8.016,20.309,96607,36801,59806,6.427,16.873,19672,3.436,33.746,374,473,5208
2001,5111,15133,19523,689768,691331,2114,10.862,1993,10.24,84932,33771,51161,4.885,12.285,87763,39183,48580,5.668,12.695,-2831,-0.41,24.571,1342,1375,13009
2001,5112,7462,10102,367566,353473,1492,14.774,1485,14.705,93347,32556,60791,9.21,26.409,66253,30774,35479,8.706,18.743,27094,7.665,37.487,908,976,15836
2001,5121,12188,15883,265444,269369,2111,13.135,2487,15.475,55896,16846,39050,6.254,20.751,62831,23499,39332,8.724,23.325,-6935,-2.575,41.502,1238,1281,6981
2001,5122,2573,2768,22234,22832,378,13.659,377,13.622,3647,1213,2434,5.313,15.974,4860,1678,3182,7.349,21.286,-1213,-5.313,31.947,279,280,989
2001,5151,4836,8366,256354,251822,2036,25.496,1275,15.966,61286,39584,21702,15.719,24.337,49795,34785,15010,13.813,19.774,11491,4.563,39.548,622,667,7902
2001,5152,310,591,33983,33926,109,18.842,84,14.52,7358,4060,3298,11.967,21.688,7549,2325,5224,6.853,22.251,-191,-0.563,43.377,40,45,1487
2001,5173,7760,44092,1466375,1420238,10287,24.562,5868,14.011,326978,175369,151609,12.348,23.023,240554,109086,131468,7.681,16.938,86424,6.085,33.875,1247,1610,26744
2001,5174,425,652,20453,20721,106,16.358,98,15.123,5116,1835,3281,8.856,24.69,5690,2178,3512,10.511,27.46,-574,-2.77,49.38,57,58,608
2001,5179,6326,7630,137218,138204,1870,24.174,2081,26.902,43162,17560,25602,12.706,31.231,44701,24354,20347,17.622,32.344,-1539,-1.114,62.461,1649,1686,17646
2001,5182,5988,10834,415733,400223,2517,24.625,1292,12.64,99916,41760,58156,10.434,24.965,69419,26144,43275,6.532,17.345,30497,7.62,34.69,462,470,6764
2001,5191,3859,4717,89470,84522,811,18.121,328,7.329,22346,9940,12406,11.76,26.438,12462,4548,7914,5.381,14.744,9884,11.694,29.488,224,241,2520
2001,5211,15,52,22282,22443,(D),(D),(D),(D),346,(D),321,(D),1.542,656,(D),570,(D),2.923,-310,-1.381,3.083,0,0,0
2001,5221,17866,107671,2050005,2016353,11002,10.252,10281,9.581,433221,183966,249255,9.124,21.485,357055,170861,186194,8.474,17.708,76166,3.777,35.416,652,1131,15510
2001,5222,17672,44960,628702,627324,6713,14.824,7364,16.261,158069,70313,87756,11.208,25.197,154393,71290,83103,11.364,24.611,3676,0.586,49.223,2013,2310,15927
2001,5223,15354,23041,225971,218333,5201,23.693,3023,13.771,63670,27907,35763,12.782,29.162,48345,21361,26984,9.784,22.143,15325,7.019,44.286,1577,1735,10328
2001,5231,12086,37648,559554,552331,5519,14.757,5022,13.428,123086,60008,63078,10.864,22.285,105855,51242,54613,9.277,19.165,17231,3.12,38.33,1031,1161,11704
2001,5232,30,41,6299,6436,9,19.355,20,43.011,206,73,133,1.134,3.201,491,45,446,0.699,7.63,-285,-4.429,6.402,16,16,35
2001,5239,27163,30387,346546,333381,5561,18.732,4160,14.013,86554,34298,52256,10.288,25.962,59195,24420,34775,7.325,17.756,27359,8.207,35.512,2434,2460,10980
2001,5241,5209,37409,1526745,1515916,4931,13.353,3969,10.748,262158,103151,159007,6.805,17.294,239168,98696,140472,6.511,15.777,22990,1.517,31.554,377,399,4934
2001,5242,113084,124783,835007,830353,12746,10.243,12060,9.691,145456,60909,84547,7.335,17.517,135362,58058,77304,6.992,16.302,10094,1.216,32.603,8220,8456,32022
2001,5259,624,671,5550,5462,209,33.413,118,18.865,1513,882,631,16.148,27.7,1349,862,487,15.782,24.698,164,3.003,49.396,80,80,556
2001,5311,86037,100295,535801,532137,10661,10.666,9976,9.981,99384,45489,53895,8.548,18.676,92288,39992,52296,7.515,17.343,7096,1.333,34.686,7504,7684,27218
2001,5312,51537,58127,280244,278247,8632,15.059,7023,12.252,63940,29777,34163,10.702,22.98,59371,25631,33740,9.212,21.338,4569,1.642,42.675,4398,4562,13195
2001,5313,46416,53035,505431,504096,7237,13.699,6828,12.924,89935,38176,51759,7.573,17.841,88082,37411,50671,7.421,17.473,1853,0.368,34.947,3575,3664,17366
2001,5321,4452,10896,183185,180841,1888,17.738,1384,13.003,35180,16648,18532,9.206,19.454,29774,11436,18338,6.324,16.464,5406,2.989,32.928,481,536,2940
2001,5322,13851,29923,251263,251567,2666,8.787,3504,11.548,43814,15587,28227,6.196,17.416,45139,18319,26820,7.282,17.943,-1325,-0.527,34.833,1992,2160,9154
2001,5323,3364,5860,39062,39750,441,7.546,410,7.015,5284,1925,3359,4.843,13.293,6639,2106,4533,5.298,16.702,-1355,-3.409,26.586,257,286,1462
2001,5324,7118,11849,163368,162361,1600,13.692,1273,10.894,33658,12535,21123,7.72,20.73,31663,13019,18644,8.019,19.502,1995,1.229,39.003,711,744,5179
2001,5331,1740,1857,22878,22661,224,11.985,248,13.269,4692,1800,2892,7.943,20.705,4253,2141,2112,9.448,18.768,439,1.937,37.536,164,168,903
2001,5411,153948,161585,1112918,1103328,13559,8.38,14005,8.655,147273,44241,103032,4.01,13.348,127674,47097,80577,4.269,11.572,19599,1.776,23.143,9895,10069,32683
2001,5412,86369,93710,1186151,1166462,9345,10.012,8600,9.214,236016,65462,170554,5.612,20.233,198815,55467,143348,4.755,17.044,37201,3.189,34.089,5653,5726,27840
2001,5413,83709,94925,1304359,1276762,10699,11.378,8916,9.482,219722,62397,157325,4.887,17.209,164737,53096,111641,4.159,12.903,54985,4.307,25.805,5872,5941,27269
2001,5414,24930,25192,143653,141157,3892,15.678,3157,12.717,30668,10354,20314,7.335,21.726,25473,10786,14687,7.641,18.046,5195,3.68,36.092,2385,2387,8103
2001,5415,76872,86764,1267230,1230938,19125,22.523,15424,18.164,358617,138331,220286,11.238,29.134,285827,114616,171211,9.311,23.22,72790,5.913,46.441,10775,10865,63973
2001,5416,71460,76489,685127,658560,16710,22.65,11279,15.289,191467,86936,104531,13.201,29.074,138388,63672,74716,9.668,21.014,53079,8.06,42.027,8092,8147,35318
2001,5417,10200,13190,621259,601304,2022,15.703,1395,10.834,136725,45428,91297,7.555,22.738,95583,33449,62134,5.563,15.896,41142,6.842,31.792,762,778,8762
2001,5418,31883,35432,478228,482576,4174,11.751,4349,12.244,84630,29627,55003,6.139,17.537,93423,35210,58213,7.296,19.359,-8793,-1.822,35.074,2999,3046,17560
2001,5419,46799,53977,491170,485740,6697,12.508,5826,10.881,92449,34469,57980,7.096,19.033,80299,29924,50375,6.16,16.531,12150,2.501,33.063,3412,3423,15068
2001,5511,28173,52637,3298248,3327537,5608,10.609,6059,11.462,585190,192910,392280,5.797,17.586,643860,230670,413190,6.932,19.349,-58670,-1.763,35.173,1301,1363,25105
2001,5611,20207,22194,445413,438278,3821,17.398,3357,15.285,103798,44885,58913,10.241,23.683,89973,41014,48959,9.358,20.529,13825,3.154,41.058,2127,2144,23436
2001,5612,1536,3342,133493,131991,536,16.602,309,9.571,20523,7998,12525,6.06,15.549,17483,6755,10728,5.118,13.246,3040,2.303,26.491,87,93,2583
2001,5613,27467,47511,4375931,4468452,7678,16.529,5559,11.967,1115339,343821,771518,7.694,24.96,1303918,305607,998311,6.839,29.181,-188579,-4.22,49.921,2979,3113,127375
2001,5614,25220,30609,736007,729864,4068,13.311,3971,12.994,173831,59949,113882,8.214,23.817,160763,60116,100647,8.237,22.026,13068,1.79,44.053,2754,2868,22837
2001,5615,21360,29277,305491,305471,2271,7.602,3463,11.592,46497,14219,32278,4.655,15.221,46590,17482,29108,5.723,15.252,-93,-0.03,30.443,2430,2499,10948
2001,5616,15882,20191,717878,713758,2570,12.771,2435,12.1,125363,42307,83056,5.927,17.564,116136,51722,64414,7.246,16.271,9227,1.293,32.542,1573,1643,20551
2001,5617,120159,126495,1551272,1539222,18551,14.791,16408,13.082,319328,120543,198785,7.831,20.746,294156,112940,181216,7.337,19.111,25172,1.635,38.221,11834,11863,54962
2001,5619,19535,21810,470654,473047,2440,11.149,2591,11.839,76929,20735,56194,4.383,16.262,81186,22355,58831,4.726,17.162,-4257,-0.9,32.525,1856,1909,12435
2001,5621,5952,7460,154479,154626,933,12.687,721,9.804,26255,11042,15213,7.141,16.98,26639,10431,16208,6.746,17.228,-384,-0.248,33.959,483,487,3510
2001,5622,1458,2429,53704,53227,313,12.979,278,11.528,9961,4673,5288,8.779,18.714,9106,3688,5418,6.929,17.108,855,1.606,34.216,132,134,974
2001,5629,5697,6331,100508,99291,810,13.028,583,9.377,19980,5952,14028,5.995,20.123,17424,5797,11627,5.838,17.549,2556,2.574,35.097,393,402,3941
2001,6111,16018,18216,718708,706483,1010,5.585,747,4.131,67059,13736,53323,1.944,9.492,42582,10877,31705,1.54,6.027,24477,3.465,12.055,431,439,7217
2001,6112,525,805,81150,79237,60,7.59,31,3.922,8525,996,7529,1.257,10.759,4747,1226,3521,1.547,5.991,3778,4.768,11.982,19,19,372
2001,6113,2195,2852,1263486,1253974,160,5.657,113,3.995,74721,4410,70311,0.352,5.959,54861,3121,51740,0.249,4.375,19860,1.584,8.75,62,64,1446
2001,6114,5584,6112,63715,63299,1015,16.794,879,14.543,15246,6573,8673,10.384,24.086,14293,5661,8632,8.943,22.58,953,1.506,45.16,599,610,3301
2001,6115,5276,6233,84933,81898,697,11.246,627,10.116,18421,6646,11775,8.115,22.493,12497,5678,6819,6.933,15.259,5924,7.233,30.519,452,463,3670
2001,6116,21634,23601,211006,204599,3414,14.753,2493,10.773,46265,16016,30249,7.828,22.613,33324,12126,21198,5.927,16.288,12941,6.325,32.575,1778,1802,8013
2001,6117,3350,3644,43925,41666,600,16.833,441,12.372,10346,3399,6947,8.158,24.831,5815,2449,3366,5.878,13.956,4531,10.875,27.912,321,321,1720
2001,6211,160115,180441,1823820,1792067,15619,8.693,14101,7.848,295545,98661,196884,5.505,16.492,231850,96667,135183,5.394,12.938,63695,3.554,25.875,9234,9599,47968
2001,6212,106662,110838,727462,717163,5243,4.74,4807,4.346,98674,25006,73668,3.487,13.759,78339,22150,56189,3.089,10.923,20335,2.835,21.847,3604,3688,16804
2001,6213,81031,87305,447910,434303,9920,11.565,6869,8.008,92040,37976,54064,8.744,21.193,65158,24262,40896,5.586,15.003,26882,6.19,30.006,4807,4911,15800
2001,6214,10723,22636,568469,558398,2558,11.52,1697,7.642,88237,31278,56959,5.601,15.802,67846,24953,42893,4.469,12.15,20391,3.652,24.3,601,713,9248
2001,6215,5734,10209,168885,172802,2370,25.021,896,9.459,42099,18605,23494,10.767,24.363,47600,13876,33724,8.03,27.546,-5501,-3.183,48.725,461,492,3535
2001,6216,10263,15272,770101,780812,2211,14.632,1888,12.495,124870,33707,91163,4.317,15.992,146954,45208,101746,5.79,18.821,-22084,-2.828,31.985,1002,1092,22672
2001,6219,4560,7136,182690,183416,1091,15.835,599,8.694,31639,10652,20987,5.808,17.25,33590,11855,21735,6.463,18.314,-1951,-1.064,34.5,332,358,4501
2001,6221,3346,5351,4604206,4583770,132,2.445,228,4.223,249734,52461,197273,1.144,5.448,208516,79036,129480,1.724,4.549,41218,0.899,9.098,64,86,41761
2001,6222,503,665,239354,239639,37,5.2,130,18.271,11584,3988,7596,1.664,4.834,11714,8483,3231,3.54,4.888,-130,-0.054,9.668,18,18,1410
2001,6223,294,505,157908,151977,100,21.075,39,8.219,21144,13547,7597,8.914,13.913,9510,3011,6499,1.981,6.258,11634,7.655,12.515,15,21,1986
2001,6231,7931,15836,1539108,1525972,1233,7.824,1080,6.853,179436,73346,106090,4.807,11.759,154842,61376,93466,4.022,10.147,24594,1.612,20.294,472,548,25953
2001,6232,7312,24083,417482,409107,2910,12.538,1164,5.015,68782,26620,42162,6.507,16.813,52077,14680,37397,3.588,12.729,16705,4.083,25.459,375,431,4755
2001,6233,12528,16783,536490,523510,1959,11.78,1652,9.934,83404,32434,50970,6.195,15.932,57254,26019,31235,4.97,10.937,26150,4.995,21.873,1092,1157,17089
2001,6239,3315,5916,149601,147679,522,8.815,533,9.001,20289,6086,14203,4.121,13.739,16377,4993,11384,3.381,11.09,3912,2.649,22.179,210,233,1967
2001,6241,29863,43431,806621,788319,4099,9.572,2881,6.728,120995,32774,88221,4.157,15.348,84461,21462,62999,2.723,10.714,36534,4.634,21.428,1596,1649,10561
2001,6242,7807,9951,121446,119151,589,5.949,490,4.949,16021,3698,12323,3.104,13.446,11374,2798,8576,2.348,9.546,4647,3.9,19.092,278,286,1390
2001,6243,4957,7733,307132,307372,569,7.332,625,8.053,42070,7254,34816,2.36,13.687,42362,10011,32351,3.257,13.782,-292,-0.095,27.374,263,318,2683
2001,6244,47897,60560,735302,715125,6959,11.576,6072,10.1,130878,42941,87937,6.005,18.301,89802,35623,54179,4.981,12.558,41076,5.744,25.115,4255,4340,24299
2001,7111,7298,7381,118380,117237,980,13.327,925,12.579,24241,6182,18059,5.273,20.677,21946,6798,15148,5.799,18.719,2295,1.958,37.439,621,621,4197
2001,7112,3336,3492,104153,101477,510,14.588,518,14.817,19777,7609,12168,7.498,19.489,14663,4257,10406,4.195,14.45,5114,5.04,28.899,387,390,2300
2001,7113,3472,3655,78759,77172,539,14.958,436,12.099,16009,7455,8554,9.66,20.745,12827,3863,8964,5.006,16.621,3182,4.123,33.243,280,282,1672
2001,7114,2496,2553,15806,15891,395,15.684,326,12.944,3053,1235,1818,7.772,19.212,3254,1321,1933,8.313,20.477,-201,-1.265,38.424,237,237,855
2001,7115,9391,9414,40390,40571,1818,19.652,1492,16.128,12871,6869,6002,16.931,31.725,13207,5010,8197,12.349,32.553,-336,-0.828,63.449,895,895,2660
2001,7121,4850,5263,107410,105847,326,6.236,256,4.897,10648,1829,8819,1.728,10.06,7642,1782,5860,1.684,7.22,3006,2.84,14.44,153,153,1116
2001,7131,1586,2338,120195,123048,277,11.7,336,14.192,9572,3225,6347,2.621,7.779,14926,3313,11613,2.692,12.13,-5354,-4.351,15.558,219,239,2008
2001,7132,1572,1941,193892,190764,194,9.778,280,14.113,23552,5181,18371,2.716,12.346,17661,5080,12581,2.663,9.258,5891,3.088,18.516,208,211,3540
2001,7139,44866,49475,966404,958552,5009,10.16,4657,9.446,147365,47693,99672,4.976,15.374,132085,46518,85567,4.853,13.78,15280,1.594,27.559,3396,3440,31327
2001,7211,35290,45227,1706124,1713381,4735,10.543,4107,9.144,218589,91508,127081,5.341,12.758,234754,101859,132895,5.945,13.701,-16165,-0.943,25.516,2499,2585,41439
2001,7212,5091,5528,38517,38599,506,9.214,433,7.885,5742,1557,4185,4.034,14.876,5877,1654,4223,4.285,15.226,-135,-0.35,29.752,296,302,1083
2001,7213,2647,2695,14254,14416,162,5.891,272,9.891,2047,668,1379,4.634,14.2,2345,780,1565,5.411,16.267,-298,-2.067,28.4,188,190,446
2001,7223,10607,25355,519467,512025,3299,13.198,2580,10.322,85768,38549,47219,7.529,16.751,70608,30687,39921,5.993,13.79,15160,2.961,27.58,1236,1250,8467
2001,7224,44042,44540,331891,329771,5022,11.182,5763,12.832,69285,32576,36709,9.878,21.01,64795,28192,36603,8.549,19.648,4490,1.362,39.297,4482,4494,21695
2001,7225,265450,368225,7376501,7345749,43520,11.88,39757,10.852,1268842,625229,643613,8.511,17.273,1209430,453056,756374,6.168,16.464,59412,0.809,32.929,26883,28541,290204
2001,8111,138207,150827,882488,876697,15178,10.066,15089,10.007,151490,57610,93880,6.571,17.28,140391,55169,85222,6.293,16.014,11099,1.266,32.027,10851,11048,38665
2001,8112,11946,13745,137752,141154,1375,9.796,1958,13.949,23978,8532,15446,6.044,16.987,30541,16232,14309,11.499,21.637,-6563,-4.65,33.974,1374,1388,6632
2001,8113,21022,22569,197622,198642,1985,8.764,2146,9.475,29781,8032,21749,4.043,14.992,31521,10420,21101,5.246,15.868,-1740,-0.876,29.985,1467,1484,6414
2001,8114,22774,23964,131046,134736,2537,10.452,3154,12.994,20159,8253,11906,6.125,14.962,27525,9432,18093,7,20.429,-7366,-5.467,29.924,2434,2447,6977
2001,8121,74288,86279,513974,507694,11206,13.058,10282,11.981,101522,47152,54370,9.287,19.997,89517,38388,51129,7.561,17.632,12005,2.365,35.264,7600,7803,26471
2001,8122,14854,21120,166026,164144,884,4.167,1070,5.044,18513,4550,13963,2.772,11.279,14809,4236,10573,2.581,9.022,3704,2.257,18.044,579,617,2296
2001,8123,32384,38749,384681,387893,3428,8.758,4210,10.756,48272,17531,30741,4.52,12.445,54747,21049,33698,5.427,14.114,-6475,-1.669,24.889,3099,3244,15271
2001,8129,18574,29021,235971,230546,3713,12.711,4091,14.005,52475,16542,35933,7.175,22.761,41918,20247,21671,8.782,18.182,10557,4.579,36.364,2449,2522,10461
2001,8131,155291,155421,1537600,1518120,7549,4.879,6164,3.984,164864,27369,137495,1.803,10.86,125301,20290,105011,1.337,8.254,39563,2.606,16.507,3444,3444,10979
2001,8132,10352,12307,130686,128901,1143,9.463,685,5.671,17251,4031,13220,3.127,13.383,13698,3224,10474,2.501,10.627,3553,2.756,21.254,451,453,2084
2001,8133,8617,10549,105348,102757,1088,10.525,664,6.424,15484,3618,11866,3.521,15.069,10392,2984,7408,2.904,10.113,5092,4.955,20.226,395,398,1999
2001,8134,26710,28582,316888,314190,1233,4.292,1529,5.322,36058,5245,30813,1.669,11.477,30544,5507,25037,1.753,9.722,5514,1.755,19.443,1001,1005,3356
2001,8139,60453,62492,506640,510621,2813,4.464,3850,6.11,56643,10293,46350,2.016,11.093,64357,15131,49226,2.963,12.604,-7714,-1.511,22.186,2557,2571,9755
2002,1131,515,566,4815,4411,76,13.768,48,8.696,1491,1010,481,22.897,33.802,655,188,467,4.262,14.849,836,18.953,29.698,28,28,106
2002,1132,224,290,2540,2649,34,11.826,29,10.087,483,107,376,4.04,18.237,728,119,609,4.493,27.487,-245,-9.251,36.473,18,18,81
2002,1133,9934,10005,68700,70457,982,9.493,1662,16.066,12115,3530,8585,5.01,17.195,15535,6208,9327,8.811,22.049,-3420,-4.854,34.39,1173,1174,4513
2002,1141,1245,1260,6681,6828,188,14.406,278,21.303,1464,677,787,9.915,21.441,1774,757,1017,11.087,25.981,-310,-4.54,42.882,178,178,529
2002,1142,322,322,2646,2627,46,14.375,42,13.125,377,136,241,5.177,14.351,337,94,243,3.578,12.828,40,1.523,25.657,21,21,52
2002,1151,4107,4455,59119,60479,524,11.686,582,12.979,12534,5846,6688,9.666,20.725,15499,5589,9910,9.241,25.627,-2965,-4.903,41.449,380,380,3781
2002,1152,3723,3780,22295,22218,508,13.538,453,12.072,3857,1405,2452,6.324,17.36,3662,1198,2464,5.392,16.483,195,0.878,32.965,326,326,813
2002,1153,1347,1398,14396,15093,191,13.653,193,13.796,2342,781,1561,5.175,15.518,3711,943,2768,6.248,24.588,-1369,-9.071,31.035,108,108,507
2002,2111,5703,6947,86526,85602,680,9.779,694,9.98,19615,6597,13018,7.707,22.914,18093,8413,9680,9.828,21.136,1522,1.778,42.272,369,373,2852
2002,2121,740,1132,76882,75189,149,13.233,137,12.167,13835,5648,8187,7.512,18.4,10416,3176,7240,4.224,13.853,3419,4.547,27.706,67,69,1497
2002,2122,223,304,25766,28965,36,10.762,97,28.999,973,242,731,0.835,3.359,7522,2214,5308,7.644,25.969,-6549,-22.61,6.718,45,45,161
2002,2123,3278,5299,93385,96771,447,8.362,540,10.102,14411,4539,9872,4.69,14.892,20975,7071,13904,7.307,21.675,-6564,-6.783,29.784,239,240,2202
2002,2131,6832,8372,192181,197440,1267,15.43,946,11.52,34393,16941,17452,8.58,17.419,46087,14488,31599,7.338,23.342,-11694,-5.923,34.839,537,543,4225
2002,2211,1536,9547,533204,530927,789,8.464,338,3.626,59967,30335,29632,5.714,11.295,55785,12110,43675,2.281,10.507,4182,0.788,21.014,83,83,1223
2002,2212,504,2552,90498,94810,161,6.234,222,8.596,7204,2710,4494,2.858,7.598,16001,5000,11001,5.274,16.877,-8797,-9.279,15.197,38,38,250
2002,2213,4539,5295,43909,42808,339,6.405,334,6.311,7579,3158,4421,7.377,17.705,5502,2135,3367,4.987,12.853,2077,4.852,25.706,214,214,1345
2002,2361,137205,138052,760068,754914,22438,16.406,19870,14.528,183329,76412,106917,10.122,24.285,172468,66680,105788,8.833,22.846,10861,1.439,45.692,12345,12347,44249
2002,2362,38247,39148,724252,744028,4062,10.302,4625,11.73,133458,35288,98170,4.743,17.937,173127,39744,133383,5.342,23.269,-39669,-5.332,35.874,3118,3178,25245
2002,2371,18896,19638,514019,526145,1910,9.773,1721,8.806,98544,27687,70857,5.262,18.729,124091,28020,96071,5.326,23.585,-25547,-4.856,37.459,1091,1095,13548
2002,2372,9803,9917,58279,58363,1730,17.521,1644,16.65,15360,6739,8621,11.547,26.318,15614,7264,8350,12.446,26.753,-254,-0.435,52.637,1160,1177,5178
2002,2373,10325,10843,316313,315310,923,8.403,1205,10.971,64317,14590,49727,4.627,20.398,62663,14900,47763,4.726,19.873,1654,0.525,39.747,674,675,7615
2002,2379,4271,4427,85614,84613,558,12.334,752,16.622,19638,5557,14081,6.568,23.209,17658,4676,12982,5.526,20.869,1980,2.34,41.738,497,497,2868
2002,2381,90125,90601,960855,970614,12457,13.688,13266,14.577,211794,66257,145537,6.826,21.821,231314,64421,166893,6.637,23.832,-19520,-2.011,43.641,8402,8407,43217
2002,2382,141372,144629,1746223,1781418,14981,10.382,14312,9.919,299953,88823,211130,4.986,16.838,371165,97615,273550,5.48,20.835,-71212,-3.997,33.676,9974,9979,65640
2002,2383,94578,95433,797406,803430,15089,15.885,14199,14.948,180885,61863,119022,7.7,22.514,192233,59174,133059,7.365,23.927,-11348,-1.412,45.028,9502,9513,42098
2002,2389,46287,46683,421727,426712,6122,12.857,7986,16.772,88549,28408,60141,6.657,20.751,98934,34902,64032,8.179,23.185,-10385,-2.434,41.503,5035,5036,23579
2002,3111,1146,1742,46882,48019,131,7.55,117,6.744,5654,2470,3184,5.144,11.775,8077,2390,5687,4.977,16.821,-2423,-5.046,23.549,66,66,1239
2002,3112,474,809,56485,57391,34,4.129,63,7.65,4475,1394,3081,2.429,7.797,6254,1876,4378,3.269,10.897,-1779,-3.1,15.595,26,27,515
2002,3113,1542,1728,82408,85014,156,8.999,167,9.634,7366,2668,4698,3.138,8.664,12755,3912,8843,4.602,15.003,-5389,-6.339,17.329,122,122,2517
2002,3114,1281,1673,165452,169027,112,6.661,129,7.672,17857,6072,11785,3.592,10.565,25211,9386,15825,5.553,14.915,-7354,-4.351,21.129,89,91,4869
2002,3115,1080,1589,132221,132285,99,6.176,127,7.923,11526,2947,8579,2.228,8.713,11551,3447,8104,2.606,8.732,-25,-0.019,17.426,71,73,1028
2002,3116,3100,3733,497802,496714,234,6.2,316,8.373,45734,13326,32408,2.683,9.207,43738,13112,30626,2.64,8.805,1996,0.402,17.611,221,222,6127
2002,3117,576,676,39368,39901,48,6.872,93,13.314,5792,2096,3696,5.253,14.516,6838,2530,4308,6.341,17.137,-1046,-2.621,29.032,59,60,1571
2002,3118,9635,10648,307245,310503,1145,10.773,1105,10.397,38457,14032,24425,4.519,12.385,44632,14423,30209,4.645,14.374,-6175,-1.989,24.771,806,812,6984
2002,3119,2443,2862,157559,154121,269,9.396,271,9.466,24922,6158,18764,3.996,16.17,18390,6952,11438,4.511,11.932,6532,4.238,23.864,162,163,2502
2002,3121,2170,2645,137807,139932,277,10.52,253,9.609,16373,3845,12528,2.748,11.701,20707,4482,16225,3.203,14.798,-4334,-3.097,23.401,160,162,2767
2002,3122,78,104,23415,23810,7,6.167,26,22.907,1559,39,1520,0.164,6.548,2228,1610,618,6.762,9.357,-669,-2.81,13.095,13,13,78
2002,3131,359,553,65562,69970,42,7.292,88,15.278,5868,3047,2821,4.355,8.386,14588,5659,8929,8.088,20.849,-8720,-12.462,16.773,33,36,1527
2002,3132,1433,1686,142051,154938,119,6.806,244,13.955,9982,3391,6591,2.189,6.443,35213,14353,20860,9.264,22.727,-25231,-16.285,12.885,153,165,7587
2002,3133,1388,1488,61313,67072,124,7.863,302,19.15,5598,2712,2886,4.043,8.346,16876,7641,9235,11.392,25.161,-11278,-16.815,16.693,223,231,5087
2002,3141,2609,2811,103626,107483,198,6.912,305,10.648,8152,3268,4884,3.04,7.584,15854,4240,11614,3.945,14.75,-7702,-7.166,15.169,234,240,2556
2002,3149,4626,4778,90408,95724,494,10.331,501,10.478,11436,5019,6417,5.243,11.947,22010,7435,14575,7.767,22.993,-10574,-11.046,23.894,364,365,4661
2002,3151,738,801,52915,60232,51,5.951,163,19.02,3886,1751,2135,2.907,6.452,18452,7749,10703,12.865,30.635,-14566,-24.183,12.904,127,130,4166
2002,3152,8249,8557,242670,273316,1374,15.343,2171,24.242,36757,20053,16704,7.337,13.449,98450,48669,49781,17.807,36.021,-61693,-22.572,26.897,1732,1750,29818
2002,3159,1215,1255,28274,31511,115,8.614,275,20.599,3556,1327,2229,4.211,11.285,10032,4301,5731,13.649,31.837,-6476,-20.552,22.57,211,214,2487
2002,3161,230,241,9195,10125,25,10.081,39,15.726,643,202,441,1.995,6.351,2512,775,1737,7.655,24.811,-1869,-18.46,12.702,28,28,480
2002,3162,297,329,20505,22775,33,9.72,54,15.906,1130,347,783,1.524,4.962,5529,2328,3201,10.222,24.277,-4399,-19.315,9.923,38,38,448
2002,3169,822,838,17118,18331,85,9.815,141,16.282,1827,715,1112,3.9,9.967,4222,1251,2971,6.825,23.032,-2395,-13.065,19.933,98,98,736
2002,3211,3601,4064,113805,117304,292,7.029,473,11.385,10776,3809,6967,3.247,9.186,17670,6357,11313,5.419,15.063,-6894,-5.877,18.373,334,338,3674
2002,3212,1478,1877,113052,115545,106,5.608,132,6.984,9845,2453,7392,2.123,8.52,14754,4940,9814,4.275,12.769,-4909,-4.249,17.041,92,99,2564
2002,3219,9523,10337,314006,321495,955,9.173,1102,10.585,36808,12337,24471,3.837,11.449,51757,15424,36333,4.798,16.099,-14949,-4.65,22.898,790,800,8019
2002,3221,285,582,165871,172178,42,7.107,60,10.152,6766,3796,2970,2.205,3.93,19408,6947,12461,4.035,11.272,-12642,-7.342,7.859,34,36,3061
2002,3222,3228,4858,339402,352887,206,4.17,369,7.47,22590,6774,15816,1.92,6.401,49868,15733,34135,4.458,14.131,-27278,-7.73,12.803,206,208,5912
2002,3231,33681,35472,721296,759232,2156,5.97,3442,9.531,57660,21410,36250,2.82,7.595,133513,42324,91189,5.575,17.585,-75853,-9.991,15.189,2670,2691,25958
2002,3241,1060,2235,97739,101532,181,8.148,154,6.932,8695,2877,5818,2.834,8.564,16364,8479,7885,8.351,16.117,-7669,-7.553,17.128,56,57,2752
2002,3251,1166,2323,183068,189838,97,4.108,173,7.327,9801,2887,6914,1.521,5.163,23073,5687,17386,2.996,12.154,-13272,-6.991,10.326,67,69,920
2002,3252,612,937,102233,108857,49,5.166,72,7.591,4810,1977,2833,1.816,4.419,17896,3968,13928,3.645,16.44,-13086,-12.021,8.837,35,37,1534
2002,3253,653,911,31052,31979,107,11.902,83,9.232,3390,1400,1990,4.378,10.601,5271,1689,3582,5.282,16.483,-1881,-5.882,21.201,43,44,356
2002,3254,1361,1749,243333,240234,130,7.433,130,7.433,31261,4245,27016,1.767,13.013,24564,4717,19847,1.964,10.225,6697,2.788,20.45,79,79,1838
2002,3255,1521,1949,70490,71785,134,6.764,198,9.995,7702,3685,4017,5.133,10.729,10301,3235,7066,4.507,14.35,-2599,-3.621,21.459,119,123,1414
2002,3256,2032,2299,112435,117357,196,8.489,216,9.355,11201,5038,6163,4.293,9.544,21125,6838,14287,5.827,18.001,-9924,-8.456,19.089,140,140,3184
2002,3259,2172,2803,113526,117158,191,6.772,226,8.013,8737,2377,6360,2.029,7.457,16180,4365,11815,3.726,13.81,-7443,-6.353,14.915,115,116,1341
2002,3261,10000,12618,755435,782958,773,6.06,1048,8.216,73136,28582,44554,3.651,9.341,128347,38313,90034,4.893,16.393,-55211,-7.052,18.682,665,684,19439
2002,3262,1835,2371,177819,185858,143,5.95,208,8.654,11104,3908,7196,2.103,5.974,27201,6744,20457,3.629,14.635,-16097,-8.661,11.949,119,119,2194
2002,3271,1301,1519,61620,66126,111,7.118,192,12.312,4175,867,3308,1.311,6.314,13054,3161,9893,4.78,19.741,-8879,-13.427,12.627,131,135,1394
2002,3272,1800,2111,115122,121798,174,8.165,214,10.042,6528,1969,4559,1.617,5.36,20155,3931,16224,3.227,16.548,-13627,-11.188,10.719,150,151,1774
2002,3273,5148,9152,206994,215384,627,6.838,663,7.23,25303,8064,17239,3.744,11.748,42474,11047,31427,5.129,19.72,-17171,-7.972,23.496,326,337,6172
2002,3274,235,360,17087,17901,24,6.522,40,10.87,905,239,666,1.335,5.056,2538,774,1764,4.324,14.178,-1633,-9.122,10.111,19,24,342
2002,3279,2399,2817,74996,76049,273,9.831,193,6.95,9165,3443,5722,4.527,12.051,11342,2854,8488,3.753,14.914,-2177,-2.863,24.103,113,116,1035
2002,3311,318,425,124271,133374,42,9.023,123,26.423,4670,1560,3110,1.17,3.501,22349,7994,14355,5.994,16.757,-17679,-13.255,7.003,94,94,1754
2002,3312,489,646,51293,54032,56,8.402,97,14.554,4216,1615,2601,2.989,7.803,9443,3966,5477,7.34,17.477,-5227,-9.674,15.606,65,68,1504
2002,3313,423,579,71426,76256,44,7.42,72,12.142,4745,1900,2845,2.492,6.222,14311,4726,9585,6.198,18.767,-9566,-12.545,12.445,35,35,1113
2002,3314,772,984,67745,72167,79,8.057,72,7.343,3257,1318,1939,1.826,4.513,12088,1640,10448,2.273,16.75,-8831,-12.237,9.026,46,47,646
2002,3315,2122,2420,181650,193866,103,4.16,215,8.683,9981,4030,5951,2.079,5.148,34611,9024,25587,4.655,17.853,-24630,-12.705,10.297,144,151,3586
2002,3321,2549,2806,127613,137954,132,4.654,193,6.804,8500,3798,4702,2.753,6.161,29261,6907,22354,5.007,21.211,-20761,-15.049,12.323,123,125,4232
2002,3322,1338,1475,61508,65390,81,5.429,115,7.708,4000,1391,2609,2.127,6.117,11623,2887,8736,4.415,17.775,-7623,-11.658,12.234,73,73,1085
2002,3323,12113,13045,384001,402586,922,7.074,901,6.912,41806,13357,28449,3.318,10.384,78713,21544,57169,5.351,19.552,-36907,-9.167,20.769,607,614,12176
2002,3324,1275,1576,92638,97387,63,3.902,140,8.671,6514,1380,5134,1.417,6.689,15900,5029,10871,5.164,16.327,-9386,-9.638,13.378,73,76,1744
2002,3325,772,861,60670,62397,53,6.088,72,8.271,7391,4750,2641,7.613,11.845,10894,3779,7115,6.056,17.459,-3503,-5.614,23.69,42,43,1420
2002,3326,1747,1928,60663,64075,133,6.884,141,7.298,4934,1757,3177,2.742,7.7,11649,3145,8504,4.908,18.18,-6715,-10.48,15.401,90,91,1321
2002,3327,24432,24903,374329,399625,1549,6.123,2341,9.253,34722,11696,23026,2.927,8.689,85153,20423,64730,5.111,21.308,-50431,-12.62,17.377,1684,1688,12600
2002,3328,5551,6120,140109,149582,340,5.484,500,8.065,13540,5191,8349,3.47,9.052,32494,7299,25195,4.88,21.723,-18954,-12.671,18.104,325,327,3865
2002,3329,5903,6469,283356,297959,467,7.149,594,9.093,23020,8946,14074,3.002,7.726,52181,15332,36849,5.146,17.513,-29161,-9.787,15.452,416,422,6696
2002,3331,2537,2858,181081,188142,180,6.222,250,8.642,14258,4722,9536,2.51,7.578,28346,6959,21387,3.699,15.066,-14088,-7.488,15.157,153,154,3005
2002,3332,3926,4171,154076,169984,243,5.684,451,10.55,13877,5844,8033,3.438,8.164,45843,11695,34148,6.88,26.969,-31966,-18.805,16.327,324,325,5408
2002,3333,2111,2288,111337,116919,149,6.429,208,8.975,9415,2806,6609,2.4,8.053,20496,6002,14494,5.133,17.53,-11081,-9.478,16.105,135,135,1904
2002,3334,1474,1803,162619,174768,125,6.904,140,7.733,10532,4291,6241,2.455,6.026,35219,6869,28350,3.93,20.152,-24687,-14.126,12.053,85,85,3069
2002,3335,8418,8801,192416,209684,393,4.35,860,9.519,14388,5730,8658,2.733,6.862,49071,10750,38321,5.127,23.402,-34683,-16.541,13.724,629,630,6291
2002,3336,731,901,99509,103032,48,5.313,53,5.866,6727,1638,5089,1.59,6.529,13817,2127,11690,2.064,13.41,-7090,-6.881,13.058,32,33,550
2002,3339,5663,6397,299884,320983,367,5.658,546,8.417,21700,7396,14304,2.304,6.76,63775,12557,51218,3.912,19.869,-42075,-13.108,13.521,365,367,5089
2002,3341,1351,1441,152421,171933,116,7.674,257,17.003,20736,3449,17287,2.006,12.061,59476,20417,39059,11.875,34.593,-38740,-22.532,24.121,165,166,3209
2002,3342,1706,1954,198755,231594,183,9.184,260,13.049,22487,8164,14323,3.525,9.71,89471,21456,68015,9.264,38.633,-66984,-28.923,19.419,161,163,6366
2002,3343,504,529,25326,26619,50,9.242,74,13.678,2219,890,1329,3.344,8.336,4873,1242,3631,4.666,18.307,-2654,-9.971,16.673,55,55,828
2002,3344,4551,5221,442215,519369,372,6.941,649,12.109,31791,12113,19678,2.332,6.121,186627,46065,140562,8.869,35.933,-154836,-29.812,12.242,403,406,14014
2002,3345,4416,5086,426962,447276,346,6.734,450,8.758,44255,19038,25217,4.256,9.894,85197,18114,67083,4.05,19.048,-40942,-9.154,19.789,274,276,6703
2002,3346,803,861,36816,38705,79,8.832,146,16.322,4356,1296,3060,3.348,11.255,8075,3317,4758,8.57,20.863,-3719,-9.609,22.509,97,106,1306
2002,3351,1083,1193,66681,70424,78,6.446,112,9.256,3854,2333,1521,3.313,5.473,11255,2299,8956,3.265,15.982,-7401,-10.509,10.945,90,91,1362
2002,3352,250,318,95260,96423,33,10.51,25,7.962,6965,1509,5456,1.565,7.223,9183,663,8520,0.688,9.524,-2218,-2.3,14.447,14,14,348
2002,3353,2101,2487,163014,175768,163,6.434,256,10.105,10963,5284,5679,3.006,6.237,36188,9885,26303,5.624,20.589,-25225,-14.351,12.474,139,141,5478
2002,3359,1897,2268,176030,194282,167,7.264,229,9.961,9591,3942,5649,2.029,4.937,46053,9053,37000,4.66,23.704,-36462,-18.768,9.873,122,124,2444
2002,3361,282,348,208545,210005,37,10.771,28,8.151,12706,1543,11163,0.735,6.05,14853,632,14221,0.301,7.073,-2147,-1.022,12.101,20,20,604
2002,3362,1827,2062,123262,129918,155,7.49,170,8.215,11378,3341,8037,2.572,8.758,24590,7725,16865,5.946,18.927,-13212,-10.17,17.516,122,124,3334
2002,3363,4369,5534,681168,724248,367,6.56,488,8.723,55341,22596,32745,3.12,7.641,140124,28748,111376,3.969,19.348,-84783,-11.706,15.282,303,319,10973
2002,3364,1185,1511,369063,391565,108,7.059,146,9.542,23118,7331,15787,1.872,5.904,68855,10065,58790,2.57,17.585,-45737,-11.681,11.808,94,94,4762
2002,3365,141,202,28520,31933,12,5.742,26,12.44,2085,484,1601,1.516,6.529,8700,1997,6703,6.254,27.245,-6615,-20.716,13.059,10,11,813
2002,3366,1516,1632,134132,136257,150,9.05,201,12.127,11375,2256,9119,1.656,8.348,15767,4002,11765,2.937,11.572,-4392,-3.223,16.696,143,147,2582
2002,3369,706,738,38761,39927,73,9.792,88,11.804,3660,1215,2445,3.043,9.167,5984,1336,4648,3.346,14.988,-2324,-5.821,18.334,73,73,1139
2002,3371,15138,15717,388767,399480,1502,9.571,1456,9.277,42976,14368,28608,3.597,10.758,64533,20978,43555,5.251,16.154,-21557,-5.396,21.516,1025,1027,11124
2002,3372,3953,4172,164399,175269,232,5.48,355,8.385,13847,4955,8892,2.827,7.9,35560,7319,28241,4.176,20.289,-21713,-12.388,15.801,254,255,4234
2002,3379,947,1074,46879,47776,73,6.775,80,7.425,4586,1472,3114,3.081,9.599,6476,2411,4065,5.047,13.555,-1890,-3.956,19.198,56,61,888
2002,3391,10572,11290,304805,306795,827,7.311,870,7.691,36400,11129,25271,3.628,11.865,40515,11773,28742,3.837,13.206,-4115,-1.341,23.729,611,612,5570
2002,3399,18227,18756,413285,431564,1595,8.439,1882,9.958,43479,13762,29717,3.189,10.075,80403,19350,61053,4.484,18.631,-36924,-8.556,20.15,1370,1386,11635
2002,4231,18038,24581,358187,361333,2470,10.056,2435,9.913,54036,20177,33859,5.584,14.955,60100,19445,40655,5.381,16.633,-6064,-1.678,29.909,1469,1574,11035
2002,4232,11172,12751,160996,165740,1422,11.222,1264,9.975,23773,9782,13991,5.902,14.344,33110,10346,22764,6.242,19.977,-9337,-5.634,28.687,839,859,7389
2002,4233,11350,16509,225273,226301,1677,10.218,1483,9.036,35655,14193,21462,6.272,15.756,37758,13411,24347,5.926,16.685,-2103,-0.929,31.511,795,832,6963
2002,4234,26588,33886,696565,719077,3765,10.878,5214,15.065,122675,46306,76369,6.44,17.06,166835,63027,103808,8.765,23.201,-44160,-6.141,34.12,2869,2974,28833
2002,4235,7512,10227,146803,153087,728,7.049,929,8.995,16451,6137,10314,4.009,10.746,28990,8205,20785,5.36,18.937,-12539,-8.191,21.492,467,486,3657
2002,4236,20538,30936,499080,521812,2920,9.265,4081,12.949,95214,29171,66043,5.59,18.247,139034,51586,87448,9.886,26.644,-43820,-8.398,36.494,1779,1847,17043
2002,4237,11324,18027,208349,214502,1242,6.842,1493,8.225,28166,10056,18110,4.688,13.131,40215,16336,23879,7.616,18.748,-12049,-5.617,26.262,749,789,7290
2002,4238,44656,60422,699208,721083,4537,7.394,6416,10.456,94056,35512,58544,4.925,13.044,137415,49236,88179,6.828,19.057,-43359,-6.013,26.087,3469,3655,24585
2002,4239,28616,31578,320151,327779,3786,11.934,4081,12.863,50505,18520,31985,5.65,15.408,65913,22838,43075,6.968,20.109,-15408,-4.701,30.817,2864,2933,14115
2002,4241,9930,12481,207837,214556,936,7.318,1556,12.165,24828,10619,14209,4.949,11.572,37919,14455,23464,6.737,17.673,-13091,-6.101,23.144,691,740,5701
2002,4242,5504,7007,226511,230383,852,12.203,802,11.487,46088,15503,30585,6.729,20.005,55003,23616,31387,10.251,23.875,-8915,-3.87,40.01,428,432,5933
2002,4243,14305,15542,199068,204610,2039,13.089,2110,13.545,36750,12551,24199,6.134,17.961,47991,15450,32541,7.551,23.455,-11241,-5.494,35.922,1459,1479,9444
2002,4244,26568,32229,745109,764125,3284,10.128,3676,11.337,98368,33521,64847,4.387,12.873,136658,48691,87967,6.372,17.884,-38290,-5.011,25.747,2271,2392,24500
2002,4245,4454,7098,65344,66972,487,6.745,732,10.138,10685,3308,7377,4.939,15.955,13946,4857,9089,7.252,20.824,-3261,-4.869,31.909,372,412,2963
2002,4246,8853,13644,146078,149754,1020,7.38,1376,9.955,22493,7563,14930,5.05,15.02,29969,13334,16635,8.904,20.012,-7476,-4.992,30.04,616,642,4257
2002,4247,5419,7682,104790,108012,704,8.881,1194,15.062,19749,8009,11740,7.415,18.284,25972,9950,16022,9.212,24.046,-6223,-5.761,36.568,540,561,5375
2002,4248,3227,4040,160879,160209,354,8.645,464,11.331,22520,9411,13109,5.874,14.057,21110,10745,10365,6.707,13.177,1410,0.88,26.353,263,281,7034
2002,4249,23758,29606,385054,394243,3562,12.024,3600,12.152,65378,26904,38474,6.824,16.583,83710,33898,49812,8.598,21.233,-18332,-4.65,33.166,2373,2421,18760
2002,4251,29065,30924,251990,250133,2949,9.419,3717,11.872,54133,17297,36836,6.915,21.642,50970,26907,24063,10.757,20.377,3163,1.265,40.754,2177,2204,13830
2002,4411,43455,47458,1260791,1242712,5260,11.122,4933,10.43,189489,79425,110064,6.391,15.248,153331,67079,86252,5.398,12.338,36158,2.91,24.677,3576,3616,46893
2002,4412,12897,14100,138086,136503,1532,10.917,1399,9.969,24969,9486,15483,6.949,18.292,21935,8589,13346,6.292,16.069,3034,2.223,32.139,985,998,6322
2002,4413,32294,55446,476299,475887,4224,7.573,4881,8.751,78699,25332,53367,5.323,16.537,77105,28160,48945,5.917,16.202,1594,0.335,32.405,2805,2981,16067
2002,4421,18585,25857,251593,258504,3098,11.867,3597,13.778,44814,21224,23590,8.21,17.336,57911,25271,32640,9.776,22.402,-13097,-5.066,34.672,1826,2168,15617
2002,4422,25257,33688,287583,290957,3962,11.736,4106,12.162,61329,29621,31708,10.181,21.078,67737,36829,30908,12.658,23.281,-6408,-2.202,42.157,2252,2954,29037
2002,4431,29638,48425,447607,455169,6090,12.536,6399,13.172,74492,35885,38607,7.884,16.366,89130,38391,50739,8.434,19.582,-14638,-3.216,32.732,4013,4276,21737
2002,4441,44497,63592,1019481,1003755,5121,8.006,5874,9.183,169998,88803,81195,8.847,16.936,141619,53679,87940,5.348,14.109,28379,2.827,28.218,3593,3998,38160
2002,4442,15706,18943,168329,171308,1710,8.9,2252,11.721,30104,11798,18306,6.887,17.573,36211,14896,21315,8.695,21.138,-6107,-3.565,35.146,1310,1347,8260
2002,4451,58511,85301,2552620,2588613,9485,11.121,9461,11.093,286024,136452,149572,5.271,11.049,361100,103847,257253,4.012,13.95,-75076,-2.9,22.099,6114,6233,46787
2002,4452,15704,20528,130884,133073,3335,16.256,3310,16.134,28511,13816,14695,10.382,21.425,32979,14837,18142,11.15,24.783,-4468,-3.358,42.85,2177,2279,10002
2002,4453,22898,26013,133284,133024,2631,10.14,2496,9.62,24841,9492,15349,7.136,18.674,24380,8615,15765,6.476,18.328,461,0.347,36.655,1719,1739,5939
2002,4461,38295,77099,939013,933420,7595,9.906,6734,8.783,182237,83555,98682,8.951,19.524,169403,48234,121169,5.167,18.149,12834,1.375,36.297,3269,3816,21521
2002,4471,60510,114048,926871,943694,9962,8.689,11155,9.73,171479,68690,102789,7.279,18.171,206744,66006,140738,6.994,21.908,-35265,-3.737,36.342,5778,6512,36248
2002,4481,34576,83971,1015649,1016048,10592,12.71,9328,11.193,221684,116804,104880,11.496,21.818,220372,65599,154773,6.456,21.689,1312,0.129,43.378,4191,4978,29023
2002,4482,6249,27228,209237,202200,2470,9.047,2615,9.579,51485,16803,34682,8.31,25.462,37912,12976,24936,6.417,18.75,13573,6.713,37.5,656,900,3911
2002,4483,18204,28036,159091,164061,2396,8.411,3295,11.567,24749,9723,15026,5.926,15.085,34437,13198,21239,8.045,20.99,-9688,-5.905,30.17,1570,1620,5820
2002,4511,27642,38395,393747,400365,4126,10.681,4595,11.895,76534,30851,45683,7.706,19.116,88505,23985,64520,5.991,22.106,-11971,-2.99,38.232,2961,3182,14573
2002,4512,6400,11876,141729,141489,1058,8.781,1403,11.645,24766,8279,16487,5.851,17.504,24853,10256,14597,7.249,17.565,-87,-0.061,35.008,712,833,4758
2002,4522,71,5517,831399,843543,110,1.99,133,2.406,44798,12463,32335,1.477,5.311,69146,14161,54985,1.679,8.197,-24348,-2.886,10.621,3,3,131
2002,4523,8138,32454,1750882,1724007,3283,10.22,2622,8.162,184838,72061,112777,4.18,10.721,135735,31882,103853,1.849,7.873,49103,2.848,15.746,1114,1389,7220
2002,4531,20058,20911,115893,118834,2128,10.063,2601,12.299,23181,11001,12180,9.257,19.507,28789,13597,15192,11.442,24.226,-5608,-4.719,39.014,1917,1937,7557
2002,4532,28238,39770,320513,331374,4519,11.215,5567,13.816,54842,23082,31760,6.966,16.55,76302,29301,47001,8.842,23.026,-21460,-6.476,33.1,3339,3668,15977
2002,4533,12477,16510,119403,119649,1816,10.962,1928,11.638,20200,9232,10968,7.716,16.883,20738,6950,13788,5.809,17.332,-538,-0.45,33.765,1386,1407,4406
2002,4539,30237,38831,238884,240863,6055,15.672,5663,14.658,51342,24512,26830,10.177,21.316,55393,23229,32164,9.644,22.998,-4051,-1.682,42.632,3536,3865,15996
2002,4541,13024,13951,263418,271704,2395,17.477,1900,13.865,56456,25536,30920,9.398,20.778,73533,32988,40545,12.141,27.064,-17077,-6.285,41.557,1329,1344,15024
2002,4542,4651,5338,62734,63146,665,12.33,776,14.388,15401,9528,5873,15.089,24.39,16014,7880,8134,12.479,25.36,-613,-0.971,48.779,529,529,3684
2002,4543,23473,29698,240949,246584,3347,11.387,2738,9.315,40421,15264,25157,6.19,16.392,51642,22348,29294,9.063,20.943,-11221,-4.551,32.785,1627,1670,11622
2002,4811,580,3047,496083,520385,313,10.133,397,12.852,31686,6927,24759,1.331,6.089,79268,6589,72679,1.266,15.233,-47582,-9.144,12.178,80,108,1538
2002,4812,1782,1920,34287,35319,302,15.895,262,13.789,6971,3112,3859,8.811,19.737,9350,2520,6830,7.135,26.473,-2379,-6.736,39.475,190,190,1872
2002,4831,804,1221,48309,50793,102,8.249,133,10.756,9090,3662,5428,7.21,17.896,13931,3984,9947,7.844,27.427,-4841,-9.531,35.792,64,64,2215
2002,4832,430,478,19156,19248,53,11.019,59,12.266,2658,849,1809,4.411,13.809,2873,900,1973,4.676,14.926,-215,-1.117,27.618,39,39,298
2002,4841,40753,50300,989881,996351,7967,15.784,8317,16.477,160564,51979,108585,5.217,16.115,173761,54998,118763,5.52,17.44,-13197,-1.325,32.23,5921,6066,35042
2002,4842,42946,46254,444202,458739,5991,12.767,7337,15.635,77020,28560,48460,6.226,16.79,105315,40784,64531,8.89,22.958,-28295,-6.168,33.579,5055,5165,26423
2002,4851,616,907,46805,45616,135,15.28,88,9.96,7463,3958,3505,8.677,16.36,5204,2689,2515,5.895,11.408,2259,4.952,22.817,36,42,965
2002,4852,207,454,13257,15262,79,18.351,32,7.433,2119,1356,763,8.885,13.885,6300,353,5947,2.313,41.28,-4181,-27.396,27.769,18,18,250
2002,4853,5905,6024,63553,66491,928,15.254,1047,17.21,10517,5381,5136,8.093,15.817,16391,6098,10293,9.171,24.652,-5874,-8.834,31.635,821,822,4379
2002,4854,3105,4306,174830,172431,305,7.072,318,7.374,26959,10988,15971,6.372,15.635,22128,9994,12134,5.796,12.833,4831,2.802,25.666,201,205,5845
2002,4855,1057,1176,28371,28887,122,10.248,151,12.684,4824,2445,2379,8.464,16.7,5841,2209,3632,7.647,20.221,-1017,-3.521,33.4,111,112,1236
2002,4859,2412,2640,53560,53900,480,18.724,327,12.756,13552,6884,6668,12.772,25.143,14248,6485,7763,12.032,26.434,-696,-1.291,50.286,241,243,3987
2002,4861,50,261,6440,6406,50,19.802,33,13.069,2792,2217,575,34.608,43.584,2706,1412,1294,22.042,42.242,86,1.342,84.483,(D),(D),(D)
2002,4862,117,1877,27159,27321,132,6.904,202,10.565,3798,2046,1752,7.489,13.901,4104,3320,784,12.152,15.021,-306,-1.12,27.803,11,11,64
2002,4869,54,459,6303,6207,26,5.4,71,14.746,1300,176,1124,2.836,20.944,1108,680,428,10.955,17.851,192,3.093,35.702,4,4,35
2002,4871,438,484,8368,9100,63,12.702,87,17.54,1174,483,691,5.308,12.901,2669,893,1776,9.813,29.33,-1495,-16.429,25.802,58,58,709
2002,4872,1157,1191,10789,12261,177,14.309,269,21.746,1696,719,977,5.864,13.833,4582,1698,2884,13.849,37.372,-2886,-23.539,27.666,156,156,1064
2002,4879,138,141,1536,1680,24,17.021,24,17.021,219,83,136,4.94,13.036,487,110,377,6.548,28.988,-268,-15.952,26.071,11,11,53
2002,4881,3295,4528,132187,131285,787,17.899,525,11.94,30705,14259,16446,10.861,23.388,28661,11127,17534,8.475,21.831,2044,1.557,43.662,267,274,2660
2002,4882,423,793,21917,22475,86,10.79,94,11.794,2907,1084,1823,4.823,12.935,4003,1250,2753,5.562,17.811,-1096,-4.877,25.869,47,50,531
2002,4883,1616,2100,64895,65886,213,10.05,252,11.89,12132,5369,6763,8.149,18.414,14059,4115,9944,6.246,21.339,-1927,-2.925,36.828,127,129,1392
2002,4884,6651,6952,54500,55287,999,14.498,876,12.713,11928,5107,6821,9.237,21.575,13358,5330,8028,9.641,24.161,-1430,-2.587,43.15,635,638,2838
2002,4885,11127,15312,165463,169736,1733,11.349,1649,10.799,27019,11832,15187,6.971,15.918,35760,11531,24229,6.793,21.068,-8741,-5.15,31.836,989,1053,6515
2002,4889,1025,1144,26456,27165,170,14.712,193,16.703,3284,1308,1976,4.815,12.089,4652,1570,3082,5.779,17.125,-1368,-5.036,24.178,144,144,1030
2002,4921,2764,6947,508876,517807,923,13.427,777,11.303,32068,8662,23406,1.673,6.193,49183,12277,36906,2.371,9.498,-17115,-3.305,12.386,362,364,3266
2002,4922,4079,4484,46309,50061,724,16.03,789,17.469,8556,4102,4454,8.194,17.091,15990,5771,10219,11.528,31.941,-7434,-14.85,34.183,618,626,4563
2002,4931,6696,11953,544729,551128,1314,10.741,1875,15.327,100846,47604,53242,8.638,18.298,113243,38566,74677,6.998,20.548,-12397,-2.249,36.596,405,450,5926
2002,5111,15008,20603,714027,731546,2412,11.814,2038,9.982,86324,40516,45808,5.538,11.8,122401,31126,91275,4.255,16.732,-36077,-4.932,23.6,1283,1303,14999
2002,5112,6533,9056,361393,381257,1128,12.109,1647,17.68,57676,24807,32869,6.507,15.128,96872,32234,64638,8.455,25.409,-39196,-10.281,30.256,897,909,14588
2002,5121,11677,15263,256707,264894,2082,13.454,2505,16.188,50914,17840,33074,6.735,19.221,67349,17610,49739,6.648,25.425,-16435,-6.204,38.441,1382,1432,8410
2002,5122,2558,2854,30544,30819,453,15.925,434,15.258,5566,3123,2443,10.134,18.061,6222,2000,4222,6.49,20.189,-656,-2.129,36.121,297,297,1075
2002,5151,4626,8363,246319,251789,748,8.922,789,9.411,28688,14227,14461,5.65,11.394,39464,14518,24946,5.766,15.673,-10776,-4.28,22.787,496,510,7333
2002,5152,303,623,37499,37759,136,22.838,81,13.602,7351,1216,6135,3.22,19.468,7738,2500,5238,6.621,20.493,-387,-1.025,38.936,40,40,989
2002,5173,6892,44129,1444254,1472261,10266,23.288,10173,23.077,402343,261492,140851,17.761,27.328,454442,173957,280485,11.816,30.867,-52099,-3.539,54.656,1331,1380,29552
2002,5174,413,577,14474,16884,124,20.345,189,31.009,3788,2118,1670,12.544,22.435,8427,4333,4094,25.663,49.911,-4639,-27.476,44.871,63,71,850
2002,5179,4689,5514,82332,102089,1369,21.701,2958,46.889,22724,13747,8977,13.466,22.259,63072,36705,26367,35.954,61.782,-40348,-39.523,44.518,1924,1960,24620
2002,5182,7277,12796,433062,438971,2438,19.75,1534,12.427,100699,53878,46821,12.274,22.94,112261,32578,79683,7.421,25.574,-11562,-2.634,45.88,499,519,6376
2002,5191,4442,5423,102972,106773,658,12.444,387,7.319,16891,6759,10132,6.33,15.82,24372,4521,19851,4.234,22.826,-7481,-7.006,31.639,236,241,3167
2002,5211,12,47,22869,22950,(D),(D),(D),(D),440,(D),377,(D),1.917,594,(D),569,(D),2.588,-154,-0.671,3.835,(D),(D),(D)
2002,5221,17293,111868,2108879,2088631,9955,9.059,5997,5.457,367126,129236,237890,6.188,17.577,326075,106911,219164,5.119,15.612,41051,1.965,31.224,662,800,13307
2002,5222,16864,46036,668272,660421,7320,16.182,5720,12.645,154573,65200,89373,9.872,23.405,138243,51510,86733,7.8,20.933,16330,2.473,41.865,1798,1964,12456
2002,5223,18848,28528,279857,264266,6693,25.32,2504,9.473,82959,37305,45654,14.116,31.392,51557,18423,33134,6.971,19.51,31402,11.883,39.019,1357,1487,10869
2002,5231,12166,39350,600387,576855,7067,18.332,5467,14.182,194678,94039,100639,16.302,33.748,144562,67835,76727,11.759,25.06,50116,8.688,50.121,1203,1279,10035
2002,5232,22,30,6735,6521,5,15.152,11,33.333,837,530,307,8.128,12.835,426,169,257,2.592,6.533,411,6.303,13.065,8,8,42
2002,5239,27697,31561,368886,367650,5718,18.489,4450,14.389,77736,45452,32284,12.363,21.144,75126,28674,46452,7.799,20.434,2610,0.71,40.868,2911,2941,16384
2002,5241,5117,30437,1552719,1560161,4001,11.779,11061,32.564,211257,83855,127402,5.375,13.541,222451,78419,144032,5.026,14.258,-11194,-0.717,27.081,428,485,10158
2002,5242,113553,126062,826006,816511,13288,10.596,11973,9.548,175943,74537,101406,9.129,21.548,157315,70045,87270,8.579,19.267,18628,2.281,38.533,7700,7870,36448
2002,5259,797,855,5809,6335,201,24.527,130,15.863,1323,613,710,9.677,20.886,2301,992,1309,15.66,36.325,-978,-15.439,41.771,93,93,525
2002,5311,86317,103785,531759,534089,10972,10.635,9739,9.44,96001,44075,51926,8.252,17.975,100911,37557,63354,7.032,18.894,-4910,-0.919,35.949,7105,7168,24537
2002,5312,53936,61357,272502,273094,9880,16.419,7513,12.486,64415,32537,31878,11.914,23.587,65257,26516,38741,9.709,23.895,-842,-0.308,47.174,4507,4564,16164
2002,5313,50957,56092,530003,527649,8304,15.081,6243,11.338,101420,45700,55720,8.661,19.221,97318,39418,57900,7.471,18.444,4102,0.777,36.887,3580,3609,22094
2002,5321,4266,10988,176393,180434,1117,10.207,1029,9.402,24697,8682,16015,4.812,13.688,32426,9549,22877,5.292,17.971,-7729,-4.284,27.375,516,549,3441
2002,5322,13140,31065,254139,255015,3793,12.262,3528,11.405,52744,26934,25810,10.562,20.683,54814,20268,34546,7.948,21.494,-2070,-0.812,41.365,1695,2027,9126
2002,5323,3424,5081,32281,32131,579,11.544,448,8.932,6850,3022,3828,9.405,21.319,6343,2112,4231,6.573,19.741,507,1.578,39.483,249,255,1191
2002,5324,7208,12009,155742,157440,1332,11.093,1329,11.068,29678,9802,19876,6.226,18.85,33494,12099,21395,7.685,21.274,-3816,-2.424,37.701,676,717,5079
2002,5331,1920,2046,26126,26183,283,13.924,256,12.595,6594,2806,3788,10.717,25.184,6572,3024,3548,11.549,25.1,22,0.084,50.201,169,169,2076
2002,5411,154610,162795,1141895,1128621,15592,9.619,14199,8.759,172527,63827,108700,5.655,15.287,145934,57780,88154,5.12,12.93,26593,2.356,25.861,9559,9663,40654
2002,5412,88016,99714,1242546,1241651,15154,15.623,9724,10.025,331899,176906,154993,14.248,26.73,332798,172713,160085,13.91,26.803,-899,-0.072,53.461,5506,5542,32776
2002,5413,83273,94733,1255450,1268602,10814,11.436,10475,11.077,230617,79321,151296,6.253,18.179,257175,101947,155228,8.036,20.272,-26558,-2.093,36.358,6212,6284,39251
2002,5414,25196,25434,117462,123984,3800,14.959,3738,14.715,21573,10545,11028,8.505,17.4,34686,14018,20668,11.306,27.976,-13113,-10.576,34.8,2650,2660,10003
2002,5415,75876,85932,1098005,1192646,16794,19.199,19875,22.721,246002,118851,127151,9.965,20.627,433974,168527,265447,14.131,36.388,-187972,-15.761,41.253,12879,13070,87212
2002,5416,76809,82034,684711,693179,16443,20.303,14352,17.721,156251,68341,87910,9.859,22.541,174298,77860,96438,11.232,25.145,-18047,-2.604,45.082,9594,9624,45077
2002,5417,10332,13324,603200,607904,1889,14.266,1723,13.013,98528,29825,68703,4.906,16.208,108674,44109,64565,7.256,17.877,-10146,-1.669,32.416,889,905,10194
2002,5418,30309,33548,406210,429596,3899,11.462,4837,14.219,67505,28640,38865,6.667,15.714,114080,41563,72517,9.675,26.555,-46575,-10.842,31.427,3261,3276,20688
2002,5419,48091,55995,506639,506110,6687,12.027,5900,10.611,99279,36096,63183,7.132,19.616,98062,31929,66133,6.309,19.376,1217,0.24,38.751,3674,3704,19084
2002,5511,26621,47239,2833655,2913080,5404,11.201,7414,15.368,519989,184621,335368,6.338,17.85,677890,240227,437663,8.246,23.271,-157901,-5.42,35.7,1501,1592,31550
2002,5611,16227,18246,386169,391527,3287,18,3317,18.164,99136,46733,52403,11.936,25.32,110545,55496,55049,14.174,28.234,-11409,-2.914,50.641,2305,2324,26159
2002,5612,1689,3358,142294,140995,698,20.823,686,20.465,40224,21532,18692,15.271,28.529,37543,11928,25615,8.46,26.627,2681,1.901,53.254,110,118,3737
2002,5613,26055,44400,3924462,4174308,6722,14.754,9042,19.846,1075279,324500,750779,7.774,25.759,1592343,564013,1028330,13.512,38.146,-517064,-12.387,51.519,3908,4090,219779
2002,5614,25786,30941,745218,749790,4150,13.35,4442,14.289,172887,63798,109089,8.509,23.058,182123,68989,113134,9.201,24.29,-9236,-1.232,46.116,2812,2885,30520
2002,5615,18816,26333,265127,284896,2075,7.532,4505,16.353,41206,17810,23396,6.251,14.464,81236,33549,47687,11.776,28.514,-40030,-14.051,28.927,2876,2964,14835
2002,5616,16562,20747,743584,735733,3167,15.291,3096,14.948,200851,87821,113030,11.937,27.299,187142,94244,92898,12.81,25.436,13709,1.863,50.872,1510,1605,20392
2002,5617,117012,123740,1521807,1528811,19682,15.861,20382,16.425,302845,112470,190375,7.357,19.809,315572,108810,206762,7.117,20.642,-12727,-0.832,39.618,13000,13025,63669
2002,5619,16662,18814,339041,391736,2355,12.411,2677,14.108,59702,21770,37932,5.557,15.24,161364,27558,133806,7.035,41.192,-101662,-25.952,30.481,1865,1898,17357
2002,5621,6204,8037,171531,170203,956,12.081,708,8.947,33460,15007,18453,8.817,19.659,31115,8191,22924,4.813,18.281,2345,1.378,36.562,505,513,3975
2002,5622,1446,2332,48551,49692,240,10.202,281,11.945,6914,2641,4273,5.315,13.914,9339,4747,4592,9.553,18.794,-2425,-4.88,27.827,145,147,2074
2002,5629,6102,6776,100949,100678,897,13.504,630,9.484,20888,7085,13803,7.037,20.747,20567,5689,14878,5.651,20.429,321,0.319,40.857,394,394,3093
2002,6111,17604,19837,790681,776040,1224,6.269,602,3.083,84729,22454,62275,2.893,10.918,55241,10030,45211,1.292,7.118,29488,3.8,14.237,353,357,6504
2002,6112,577,883,93138,90349,62,7.106,41,4.699,11718,3057,8661,3.384,12.97,5904,1106,4798,1.224,6.535,5814,6.435,13.069,24,27,690
2002,6113,2414,3166,1412829,1390952,213,6.837,112,3.595,122958,16773,106185,1.206,8.84,80247,13915,66332,1,5.769,42711,3.071,11.538,51,51,11477
2002,6114,6243,6867,66935,68374,1090,15.982,996,14.604,15894,7287,8607,10.658,23.246,18546,6697,11849,9.795,27.124,-2652,-3.879,46.491,652,687,3819
2002,6115,5513,6554,92572,91514,743,11.376,698,10.687,18874,6108,12766,6.674,20.624,16450,4852,11598,5.302,17.975,2424,2.649,35.951,453,459,3063
2002,6116,22816,24772,215386,211874,3736,15.427,2626,10.844,50678,18972,31706,8.954,23.919,43682,16961,26721,8.005,20.617,6996,3.302,41.234,1655,1679,9445
2002,6117,3574,3959,46619,44579,788,20.553,538,14.032,12383,6571,5812,14.74,27.778,8055,3005,5050,6.741,18.069,4328,9.709,36.138,372,376,2289
2002,6211,162719,185438,1868758,1840253,20000,10.929,15118,8.261,353343,147811,205532,8.032,19.201,297450,112916,184534,6.136,16.164,55893,3.037,32.327,9353,9643,66313
2002,6212,107485,111990,749649,739591,6720,6.034,5463,4.906,117081,35746,81335,4.833,15.831,97058,30924,66134,4.181,13.123,20023,2.707,26.246,3862,3929,21297
2002,6213,85464,93124,483549,469799,12445,13.71,7742,8.529,111697,47528,64169,10.117,23.776,83591,31803,51788,6.769,17.793,28106,5.983,35.586,4886,4994,18188
2002,6214,11737,24171,578814,575171,3125,13.236,2002,8.48,98495,39848,58647,6.928,17.124,92191,35483,56708,6.169,16.028,6304,1.096,32.057,617,648,10789
2002,6215,6160,10130,195212,189124,1705,16.505,2105,20.378,51402,26021,25381,13.759,27.179,39216,21215,18001,11.218,20.736,12186,6.443,41.471,477,503,5979
2002,6216,10981,15880,757944,751238,2976,19.238,2154,13.925,178836,66836,112000,8.897,23.806,164383,69610,94773,9.266,21.882,14453,1.924,43.763,868,939,25101
2002,6219,5186,8184,213214,206198,1200,15.087,740,9.303,49709,16587,33122,8.044,24.107,36218,18428,17790,8.937,17.565,13491,6.543,35.129,355,360,4428
2002,6221,3217,5210,4697231,4650545,204,3.905,232,4.441,374601,93739,280862,2.016,8.055,282299,88412,193887,1.901,6.07,92302,1.985,12.14,107,123,45238
2002,6222,487,613,219112,221695,35,5.622,54,8.675,21241,8482,12759,3.826,9.581,26220,8119,18101,3.662,11.827,-4979,-2.246,19.162,18,18,2116
2002,6223,322,605,185864,179470,59,9.85,47,7.846,23726,7283,16443,4.058,13.22,11645,4646,6999,2.589,6.489,12081,6.732,12.977,27,27,1388
2002,6231,8181,15778,1588524,1574674,1269,7.984,1501,9.444,202713,86078,116635,5.466,12.873,175339,92108,83231,5.849,11.135,27374,1.738,22.27,485,544,35286
2002,6232,7889,27560,489557,477696,3557,13.357,1696,6.369,96658,37314,59344,7.811,20.234,72818,21909,50909,4.586,15.244,23840,4.991,30.487,348,465,7579
2002,6233,12637,16697,561547,551905,2019,12.199,1727,10.434,86111,37780,48331,6.845,15.603,66871,27092,39779,4.909,12.116,19240,3.486,24.233,1103,1128,14803
2002,6239,3351,6064,158585,155854,688,11.594,428,7.213,25659,8582,17077,5.506,16.464,20154,5865,14289,3.763,12.931,5505,3.532,25.863,189,201,2631
2002,6241,33363,46553,891297,868417,5472,12.073,3014,6.65,169051,58612,110439,6.749,19.467,124064,32445,91619,3.736,14.286,44987,5.18,28.572,1534,1586,20035
2002,6242,9098,12113,146392,144435,1104,9.381,415,3.526,23712,7474,16238,5.175,16.417,20076,4452,15624,3.082,13.9,3636,2.517,27.799,214,215,3095
2002,6243,5103,8165,320345,319233,923,11.517,622,7.761,55934,16829,39105,5.272,17.521,54029,11565,42464,3.623,16.925,1905,0.597,33.849,226,237,5212
2002,6244,49781,63298,747068,746579,8022,12.862,6165,9.885,132632,55676,76956,7.457,17.765,132506,43122,89384,5.776,17.748,126,0.017,35.497,4244,4308,28611
2002,7111,7466,7587,130262,127888,1051,13.903,996,13.175,33566,9520,24046,7.444,26.247,28527,9702,18825,7.586,22.306,5039,3.94,44.613,627,629,6121
2002,7112,3114,3265,101093,103405,462,13.868,595,17.86,16957,4740,12217,4.584,16.399,21279,6407,14872,6.196,20.578,-4322,-4.18,32.797,419,420,4774
2002,7113,4065,4301,94369,91636,656,15.582,474,11.259,22960,7736,15224,8.442,25.056,17585,5258,12327,5.738,19.19,5375,5.866,38.38,305,306,3002
2002,7114,2565,2628,15260,15708,468,18.007,410,15.775,3519,2215,1304,14.101,22.403,4401,2120,2281,13.496,28.018,-882,-5.615,44.805,290,291,1212
2002,7115,10455,10473,40564,42876,1987,19.076,1873,17.982,12224,5334,6890,12.441,28.51,17143,5340,11803,12.455,39.983,-4919,-11.473,57.02,998,1000,2585
2002,7121,5551,5988,117801,117350,497,8.441,297,5.044,12077,3050,9027,2.599,10.291,11191,2030,9161,1.73,9.536,886,0.755,19.073,160,160,1550
2002,7131,1718,2463,121778,122167,350,14.104,387,15.595,17241,3461,13780,2.833,14.113,18865,2834,16031,2.32,15.442,-1624,-1.329,28.225,216,219,1478
2002,7132,1551,1926,163657,161021,235,12.208,233,12.104,24265,9556,14709,5.935,15.07,19090,11125,7965,6.909,11.856,5175,3.214,23.711,161,163,8830
2002,7139,44321,49239,993008,984611,6055,12.336,5748,11.71,173163,66526,106637,6.757,17.587,156442,51675,104767,5.248,15.889,16721,1.698,31.777,3719,3817,33132
2002,7211,35280,45282,1690600,1738696,4798,10.594,4814,10.629,227072,113909,113163,6.551,13.06,320312,101578,218734,5.842,18.423,-93240,-5.363,26.12,2858,2913,46856
2002,7212,5065,5529,36970,36988,606,10.906,661,11.896,7368,2279,5089,6.161,19.92,7370,2603,4767,7.037,19.925,-2,-0.005,39.84,354,355,1510
2002,7213,2389,2461,12761,13101,206,8.3,248,9.992,1691,625,1066,4.771,12.908,2371,975,1396,7.442,18.099,-680,-5.191,25.816,181,181,670
2002,7223,10344,27700,553433,542546,7377,27.795,5058,19.058,165896,103145,62751,19.011,30.577,138560,58531,80029,10.788,25.539,27336,5.038,51.078,1374,1422,9826
2002,7224,43027,43503,335768,332267,5406,12.384,5704,13.067,78501,38930,39571,11.716,23.626,71101,29373,41728,8.84,21.399,7400,2.227,42.798,4410,4420,22858
2002,7225,272675,376733,7448468,7417069,50312,13.491,42681,11.445,1409847,731716,678131,9.865,19.008,1345720,494094,851626,6.662,18.144,64127,0.865,36.287,27461,28653,291329
2002,8111,138882,152168,872256,875116,16098,10.616,15029,9.911,158663,67862,90801,7.755,18.131,163906,58041,105865,6.632,18.73,-5243,-0.599,36.261,10782,10922,41321
2002,8112,11550,13183,132362,132935,1778,13.382,1986,14.947,29746,15487,14259,11.65,22.376,30771,12414,18357,9.338,23.147,-1025,-0.771,44.753,1239,1272,6233
2002,8113,21056,22279,170569,175212,2250,10.077,2349,10.52,29685,11551,18134,6.593,16.942,39039,14961,24078,8.539,22.281,-9354,-5.339,33.885,1523,1538,7263
2002,8114,20717,21865,113272,114575,2618,11.821,3182,14.368,18599,8242,10357,7.194,16.233,21365,9410,11955,8.213,18.647,-2766,-2.414,32.466,2305,2315,6509
2002,8121,75071,87698,526903,519500,11913,13.715,10235,11.783,110464,52624,57840,10.13,21.264,95816,38805,57011,7.47,18.444,14648,2.82,36.888,7458,7551,25649
2002,8122,14657,21165,145408,155658,1843,8.733,1723,8.164,26697,10510,16187,6.752,17.151,48007,9444,38563,6.067,30.841,-21310,-13.69,34.302,638,649,2734
2002,8123,32173,38413,373215,379257,3954,10.242,4340,11.242,54601,22117,32484,5.832,14.397,66673,23556,43117,6.211,17.58,-12072,-3.183,28.794,2973,3067,15966
2002,8129,20550,31203,229210,237609,5603,18.088,5151,16.628,56157,29283,26874,12.324,23.634,72708,29063,43645,12.231,30.6,-16551,-6.966,47.269,2365,2478,11816
2002,8131,164229,164393,1636102,1612620,9139,5.636,4654,2.87,185948,30210,155738,1.873,11.531,138886,16580,122306,1.028,8.612,47062,2.918,17.225,2398,2398,8720
2002,8132,11754,13818,143019,140354,1406,10.427,739,5.48,23326,7018,16308,5,16.619,18069,6070,11999,4.325,12.874,5257,3.746,25.748,402,402,3199
2002,8133,9524,11593,104732,103124,1406,12.483,747,6.632,18491,5611,12880,5.441,17.931,15333,4395,10938,4.262,14.869,3158,3.062,29.737,396,398,2546
2002,8134,27801,29821,316720,312999,1583,5.322,1432,4.814,44108,9860,34248,3.15,14.092,36431,5921,30510,1.892,11.639,7677,2.453,23.279,931,932,3953
2002,8139,60377,62429,508468,503638,3645,5.845,3508,5.625,76728,18601,58127,3.693,15.235,66681,16561,50120,3.288,13.24,10047,1.995,26.48,2234,2239,11170
2003,1131,467,521,5398,4946,68,13.14,61,11.787,2248,253,1995,5.115,45.451,1303,837,466,16.923,26.345,945,19.106,52.689,31,31,159
2003,1132,205,264,2280,2389,38,14.206,45,16.822,402,143,259,5.986,16.827,616,131,485,5.483,25.785,-214,-8.958,33.654,19,19,61
2003,1133,9656,9737,68538,68343,1030,10.499,1176,11.988,13143,4009,9134,5.866,19.231,12707,4473,8234,6.545,18.593,436,0.638,37.186,908,908,3031
2003,1141,1267,1281,6376,6477,228,18.024,196,15.494,1444,526,918,8.121,22.294,1609,604,1005,9.325,24.842,-165,-2.547,44.589,120,120,337
2003,1142,320,320,2415,2466,51,16.532,28,9.076,383,123,260,4.988,15.531,494,86,408,3.487,20.032,-111,-4.501,31.062,17,17,51
2003,1151,4060,4434,61426,60249,534,12.086,503,11.384,13507,3957,9550,6.568,22.419,11067,3442,7625,5.713,18.369,2440,4.05,36.738,351,351,2427
2003,1152,3701,3764,21744,21753,515,13.768,468,12.512,4044,1452,2592,6.675,18.591,4028,1468,2560,6.748,18.517,16,0.074,37.034,372,372,1143
2003,1153,1346,1398,15249,14729,211,15.295,174,12.613,3737,1218,2519,8.27,25.373,2716,861,1855,5.846,18.44,1021,6.932,36.881,115,115,546
2003,2111,5604,6772,82852,85457,635,9.292,759,11.106,16604,6237,10367,7.298,19.43,21803,10975,10828,12.843,25.513,-5199,-6.084,38.859,372,381,2364
2003,2121,659,1073,70089,73326,124,11.247,183,16.599,9681,3755,5926,5.121,13.203,15997,6198,9799,8.453,21.816,-6316,-8.614,26.406,92,92,1574
2003,2122,194,264,24702,25201,26,9.369,53,19.099,2017,460,1557,1.825,8.004,2903,1165,1738,4.623,11.519,-886,-3.516,16.007,29,32,171
2003,2123,3210,5201,92141,92591,311,5.953,358,6.852,10995,2300,8695,2.484,11.875,11952,2591,9361,2.798,12.908,-957,-1.034,23.75,217,223,1309
2003,2131,6811,8293,187382,188546,830,9.987,865,10.409,33425,7565,25860,4.012,17.728,35069,9138,25931,4.847,18.6,-1644,-0.872,35.456,527,541,4881
2003,2211,1543,9750,535291,533515,758,7.872,517,5.369,57417,15771,41646,2.956,10.762,53724,10544,43180,1.976,10.07,3693,0.692,20.14,65,66,886
2003,2212,530,2663,89854,89729,324,12.385,230,8.792,14635,9393,5242,10.468,16.31,13900,5314,8586,5.922,15.491,735,0.819,30.982,28,32,386
2003,2213,4488,5332,42897,42308,408,7.773,242,4.61,5251,2009,3242,4.749,12.411,4030,1615,2415,3.817,9.525,1221,2.886,19.051,150,156,794
2003,2361,142865,143781,802425,780706,24348,17.266,18825,13.349,208316,82140,126176,10.521,26.683,165648,62913,102735,8.058,21.218,42668,5.465,42.435,13521,13521,46884
2003,2362,38495,39471,711120,715364,4381,11.146,4051,10.306,138355,37423,100932,5.231,19.341,146362,27723,118639,3.875,20.46,-8007,-1.119,38.681,3077,3078,21010
2003,2371,18681,19368,457437,481708,1633,8.396,1795,9.229,70097,12061,58036,2.504,14.552,117396,17630,99766,3.66,24.371,-47299,-9.819,29.104,1305,1305,9597
2003,2372,10225,10322,65240,62635,1842,18.113,1537,15.114,18675,7887,10788,12.592,29.816,13473,6605,6868,10.545,21.51,5202,8.305,43.021,1188,1217,4813
2003,2373,10351,11063,306984,311772,1129,10.3,925,8.439,51346,7953,43393,2.551,16.469,60958,10580,50378,3.394,19.552,-9612,-3.083,32.938,650,652,5176
2003,2379,4357,4512,83541,84182,673,15.085,572,12.821,17232,5230,12002,6.213,20.47,18341,4584,13757,5.445,21.787,-1109,-1.317,40.94,438,441,3096
2003,2381,92912,93403,985045,971741,13155,14.295,10397,11.298,232163,65339,166824,6.724,23.891,205447,54910,150537,5.651,21.142,26716,2.749,42.284,7600,7601,42564
2003,2382,145454,148684,1745201,1745016,16528,11.263,12642,8.615,304409,79370,225039,4.548,17.444,303984,74335,229649,4.26,17.42,425,0.024,34.84,9586,9593,52946
2003,2383,98313,99210,817227,808211,16463,16.889,12995,13.331,193323,62328,130995,7.712,23.92,175634,50426,125208,6.239,21.731,17689,2.189,43.462,9866,9867,38395
2003,2389,49153,49553,431521,429221,8562,17.758,5887,12.21,98708,35005,63703,8.155,22.997,94174,27672,66502,6.447,21.941,4534,1.056,43.881,4457,4458,20521
2003,3111,1166,1731,45788,46392,93,5.346,110,6.324,4927,793,4134,1.709,10.62,6106,1564,4542,3.371,13.162,-1179,-2.541,21.241,55,55,639
2003,3112,466,791,56827,56555,44,5.542,50,6.297,5238,1029,4209,1.819,9.262,4773,1737,3036,3.071,8.44,465,0.822,16.879,26,26,283
2003,3113,1519,1680,79310,80516,140,8.306,151,8.959,7615,2013,5602,2.5,9.458,10070,3770,6300,4.682,12.507,-2455,-3.049,18.916,98,104,1379
2003,3114,1269,1658,162573,163934,121,7.269,134,8.05,15907,2942,12965,1.795,9.703,18736,6723,12013,4.101,11.429,-2829,-1.726,19.407,75,75,2607
2003,3115,1061,1572,132667,132559,101,6.403,112,7.1,10664,1712,8952,1.292,8.045,10458,3349,7109,2.526,7.889,206,0.155,15.779,76,77,1032
2003,3116,3086,3703,494257,495164,218,5.87,240,6.462,33243,3382,29861,0.683,6.714,35587,11164,24423,2.255,7.187,-2344,-0.473,13.427,159,160,2385
2003,3117,585,681,38518,39043,67,9.897,59,8.715,4902,672,4230,1.721,12.555,5945,1427,4518,3.655,15.227,-1043,-2.671,25.111,41,43,623
2003,3118,9554,10483,316758,311638,985,9.367,1050,9.985,49003,10693,38310,3.431,15.724,38607,15225,23382,4.885,12.388,10396,3.336,24.777,828,833,6649
2003,3119,2698,3113,166120,161574,507,17.016,240,8.055,24381,8339,16042,5.161,15.09,15337,5423,9914,3.356,9.492,9044,5.597,18.985,166,168,2493
2003,3121,2283,2789,131644,133517,342,12.62,184,6.79,14462,3554,10908,2.662,10.832,17993,3819,14174,2.86,13.476,-3531,-2.645,21.663,128,128,918
2003,3122,88,113,23322,23385,14,12.844,6,5.505,1191,106,1085,0.453,5.093,1335,300,1035,1.283,5.709,-144,-0.616,10.186,4,4,15
2003,3131,352,535,60143,63041,37,6.808,54,9.936,3762,1613,2149,2.559,5.968,9359,3783,5576,6.001,14.846,-5597,-8.878,11.935,30,30,852
2003,3132,1326,1568,135332,138243,84,5.221,166,10.317,10011,2569,7442,1.858,7.242,15527,5438,10089,3.934,11.232,-5516,-3.99,14.483,124,126,1919
2003,3133,1377,1477,59953,61553,107,7.145,148,9.883,5190,1016,4174,1.651,8.432,8529,2038,6491,3.311,13.856,-3339,-5.425,16.864,121,121,1519
2003,3141,2515,2711,100875,102433,172,6.257,248,9.021,8708,2404,6304,2.347,8.501,11662,3127,8535,3.053,11.385,-2954,-2.884,17.002,195,197,1380
2003,3149,4552,4697,88642,89574,396,8.341,497,10.469,12607,3654,8953,4.079,14.074,14564,5722,8842,6.388,16.259,-1957,-2.185,28.149,408,410,4214
2003,3151,648,706,44017,47499,35,4.67,122,16.278,4012,992,3020,2.088,8.446,11143,4063,7080,8.554,23.459,-7131,-15.013,16.893,98,100,1663
2003,3152,8285,8527,223408,233757,1629,18.989,1732,20.19,44188,19585,24603,8.378,18.903,64538,35211,29327,15.063,27.609,-20350,-8.706,37.807,1481,1490,20818
2003,3159,1113,1150,26432,27500,100,8.4,181,15.204,3511,910,2601,3.309,12.768,5686,2433,3253,8.847,20.677,-2175,-7.909,25.535,151,151,1335
2003,3161,213,222,8226,8728,18,7.809,35,15.184,713,89,624,1.02,8.17,1692,746,946,8.548,19.387,-979,-11.217,16.339,25,25,223
2003,3162,277,307,17081,18181,24,7.692,34,10.897,1044,190,854,1.045,5.742,3221,1902,1319,10.462,17.717,-2177,-11.974,11.485,21,21,844
2003,3169,784,800,17191,17143,72,8.856,98,12.054,2495,613,1882,3.576,14.554,2432,874,1558,5.098,14.187,63,0.367,28.373,83,83,588
2003,3211,3544,3986,112388,113118,279,6.936,352,8.751,10887,2567,8320,2.269,9.625,12430,3558,8872,3.145,10.989,-1543,-1.364,19.249,262,262,1790
2003,3212,1457,1854,111290,112372,98,5.256,119,6.382,10272,2229,8043,1.984,9.141,12309,3918,8391,3.487,10.954,-2037,-1.813,18.282,81,83,1825
2003,3219,9444,10276,309209,311048,907,8.805,957,9.29,38835,11236,27599,3.612,12.485,42934,14010,28924,4.504,13.803,-4099,-1.318,24.97,728,731,6468
2003,3221,280,599,155307,159825,65,10.998,49,8.291,7538,3144,4394,1.967,4.716,16959,7221,9738,4.518,10.611,-9421,-5.895,9.433,20,21,1464
2003,3222,3142,4754,332086,335222,212,4.417,304,6.333,25660,7678,17982,2.29,7.655,31652,11933,19719,3.56,9.442,-5992,-1.787,15.309,173,185,4297
2003,3231,32625,34335,699753,710041,2081,5.967,3164,9.072,69480,19612,49868,2.762,9.785,90020,31444,58576,4.428,12.678,-20540,-2.893,19.571,2563,2602,19591
2003,3241,1054,2255,99320,98553,136,6.065,111,4.95,8599,3651,4948,3.705,8.725,6958,1878,5080,1.906,7.06,1641,1.665,14.12,57,57,558
2003,3251,1167,2309,177202,180109,122,5.268,136,5.872,9009,1623,7386,0.901,5.002,14888,2596,12292,1.441,8.266,-5879,-3.264,10.004,51,53,492
2003,3252,652,974,100466,101632,57,5.861,54,5.553,6790,2134,4656,2.1,6.681,9104,1936,7168,1.905,8.958,-2314,-2.277,13.362,26,28,558
2003,3253,619,870,30510,30673,56,6.382,71,8.091,3462,1600,1862,5.216,11.287,3825,1118,2707,3.645,12.47,-363,-1.183,22.574,47,49,689
2003,3254,1369,1763,252516,248374,139,7.932,118,6.733,25669,3119,22550,1.256,10.335,17661,3294,14367,1.326,7.111,8008,3.224,14.221,71,71,952
2003,3255,1486,1900,68122,69100,91,4.745,127,6.621,6049,1076,4973,1.557,8.754,7806,2418,5388,3.499,11.297,-1757,-2.543,17.508,84,87,965
2003,3256,1966,2210,108755,109545,126,5.633,180,8.046,10258,2263,7995,2.066,9.364,11873,3303,8570,3.015,10.839,-1615,-1.474,18.728,136,136,1548
2003,3259,2129,2776,114518,113734,211,7.605,208,7.497,11721,4373,7348,3.845,10.306,10293,3444,6849,3.028,9.05,1428,1.256,18.1,128,132,1423
2003,3261,9720,12298,749152,751776,609,4.899,875,7.039,78895,18179,60716,2.418,10.494,83918,28202,55716,3.751,11.163,-5023,-0.668,20.989,570,589,10126
2003,3262,1783,2299,174180,175957,120,5.174,161,6.941,13851,2404,11447,1.366,7.872,17732,4835,12897,2.748,10.077,-3881,-2.206,15.744,98,101,1460
2003,3271,1276,1484,60877,61474,120,8.005,150,10.007,5312,929,4383,1.511,8.641,6653,1566,5087,2.547,10.822,-1341,-2.181,17.282,111,111,495
2003,3272,1729,2048,111628,113339,152,7.359,187,9.053,9556,3060,6496,2.7,8.431,12884,3667,9217,3.235,11.368,-3328,-2.936,16.863,141,144,1256
2003,3273,5060,9147,207349,207006,465,5.088,450,4.924,27374,5570,21804,2.691,13.224,26517,5654,20863,2.731,12.81,857,0.414,25.62,225,245,3217
2003,3274,226,341,16459,16684,22,6.322,36,10.345,2009,152,1857,0.911,12.041,2485,869,1616,5.209,14.895,-476,-2.853,24.083,16,16,143
2003,3279,2379,2788,72380,73443,215,7.721,208,7.47,8042,1643,6399,2.237,10.95,10137,3539,6598,4.819,13.803,-2095,-2.853,21.9,132,134,1190
2003,3311,447,563,118907,121002,90,16.854,32,5.993,8672,6010,2662,4.967,7.167,12592,1982,10610,1.638,10.406,-3920,-3.24,14.334,16,16,870
2003,3312,534,683,50523,51818,57,8.321,61,8.905,4861,1880,2981,3.628,9.381,7353,3921,3432,7.567,14.19,-2492,-4.809,18.762,30,31,988
2003,3313,410,554,67436,69441,29,5.101,58,10.202,3239,360,2879,0.518,4.664,7275,2263,5012,3.259,10.477,-4036,-5.812,9.329,28,28,708
2003,3314,757,966,62506,65135,67,6.911,74,7.633,3947,1603,2344,2.461,6.06,9190,2735,6455,4.199,14.109,-5243,-8.049,12.12,40,44,588
2003,3315,2057,2338,171734,176394,103,4.335,179,7.534,12515,2306,10209,1.307,7.095,22020,7182,14838,4.072,12.483,-9505,-5.389,14.19,130,134,4618
2003,3321,2468,2711,123763,125341,96,3.485,183,6.644,11143,2354,8789,1.878,8.89,14385,4284,10101,3.418,11.477,-3242,-2.587,17.78,114,114,1136
2003,3322,1324,1465,61364,61507,78,5.288,98,6.644,5756,1484,4272,2.413,9.358,6154,1190,4964,1.935,10.005,-398,-0.647,18.717,63,63,314
2003,3323,11894,12811,366076,374879,747,5.779,978,7.566,40180,9026,31154,2.408,10.718,57740,16858,40882,4.497,15.402,-17560,-4.684,21.436,690,693,6674
2003,3324,1248,1539,89118,90526,63,4.044,101,6.483,7886,1357,6529,1.499,8.711,10514,2869,7645,3.169,11.614,-2628,-2.903,17.423,61,61,767
2003,3325,729,813,56938,58329,32,3.867,61,7.372,4004,1076,2928,1.845,6.865,6850,1210,5640,2.074,11.744,-2846,-4.879,13.729,43,43,350
2003,3326,1667,1853,60290,60804,127,6.81,151,8.097,6071,1957,4114,3.219,9.985,7173,1666,5507,2.74,11.797,-1102,-1.812,19.969,108,108,792
2003,3327,23592,24049,358773,366045,1313,5.371,2111,8.635,38515,7953,30562,2.173,10.522,52985,13949,39036,3.811,14.475,-14470,-3.953,21.044,1616,1623,8822
2003,3328,5453,5996,136041,137743,317,5.236,434,7.168,14535,3333,11202,2.42,10.552,18024,5620,12404,4.08,13.085,-3489,-2.533,21.105,309,309,2520
2003,3329,5722,6280,274678,279140,448,7.072,558,8.808,26058,8677,17381,3.108,9.335,34843,11661,23182,4.177,12.482,-8785,-3.147,18.67,420,421,4699
2003,3331,2467,2750,171603,175427,148,5.304,229,8.206,14195,2563,11632,1.461,8.092,22012,6009,16003,3.425,12.548,-7817,-4.456,16.183,147,148,1826
2003,3332,3758,3986,145570,149035,217,5.334,381,9.366,17089,3395,13694,2.278,11.466,24112,8128,15984,5.454,16.179,-7023,-4.712,22.933,266,267,2655
2003,3333,2092,2266,106563,108971,140,6.112,189,8.251,9602,3093,6509,2.838,8.812,14435,4909,9526,4.505,13.247,-4833,-4.435,17.623,137,137,2510
2003,3334,1456,1754,154419,157837,96,5.396,146,8.207,13370,2451,10919,1.553,8.471,19907,7525,12382,4.768,12.612,-6537,-4.142,16.942,77,79,1906
2003,3335,8098,8438,184211,188502,375,4.35,741,8.595,18578,4768,13810,2.529,9.856,27188,9554,17634,5.068,14.423,-8610,-4.568,19.711,562,565,5430
2003,3336,736,891,93383,96445,41,4.535,67,7.412,5800,1289,4511,1.337,6.014,12003,1901,10102,1.971,12.445,-6203,-6.432,12.028,30,31,447
2003,3339,5562,6254,288597,294634,336,5.332,432,6.855,23944,5813,18131,1.973,8.127,36043,9428,26615,3.2,12.233,-12099,-4.106,16.253,281,285,3055
2003,3341,1325,1420,130787,139198,159,11.142,173,12.123,14038,3212,10826,2.308,10.085,31792,9080,22712,6.523,22.839,-17754,-12.755,20.17,127,127,2064
2003,3342,1598,1833,150406,172472,129,6.906,199,10.653,12009,4392,7617,2.547,6.963,56414,12349,44065,7.16,32.709,-44405,-25.746,13.926,125,127,2685
2003,3343,491,513,23966,24631,59,11.512,58,11.317,1852,469,1383,1.904,7.519,3196,1187,2009,4.819,12.976,-1344,-5.457,15.038,44,45,410
2003,3344,4387,5003,386025,411845,331,6.48,541,10.591,33572,10325,23247,2.507,8.152,84602,28338,56264,6.881,20.542,-51030,-12.391,16.303,362,365,6793
2003,3345,4309,4978,410998,420761,315,6.255,431,8.558,41538,10566,30972,2.511,9.872,61220,11803,49417,2.805,14.55,-19682,-4.678,19.744,268,268,4442
2003,3346,776,826,36864,36112,97,11.548,125,14.881,6715,1681,5034,4.655,18.595,5164,1817,3347,5.032,14.3,1551,4.295,28.6,98,98,663
2003,3351,1064,1169,62531,64382,60,5.074,87,7.357,4447,1218,3229,1.892,6.907,8141,3152,4989,4.896,12.645,-3694,-5.738,13.815,60,61,689
2003,3352,259,318,91231,92458,31,9.795,28,8.847,6180,2754,3426,2.979,6.684,8371,886,7485,0.958,9.054,-2191,-2.37,13.368,21,21,149
2003,3353,2046,2418,147659,154931,126,5.141,192,7.834,8194,1864,6330,1.203,5.289,22765,4762,18003,3.074,14.694,-14571,-9.405,10.578,132,137,1390
2003,3359,1843,2184,158387,165669,137,6.184,200,9.027,11218,2513,8705,1.517,6.771,25764,6663,19101,4.022,15.551,-14546,-8.78,13.543,117,119,1861
2003,3361,272,340,206794,207611,27,7.826,37,10.725,10612,1506,9106,0.725,5.111,12651,1162,11489,0.56,6.094,-2039,-0.982,10.223,27,27,450
2003,3362,1797,2026,133954,128587,135,6.636,152,7.471,22765,4389,18376,3.413,17.704,11938,4413,7525,3.432,9.284,10827,8.42,18.568,108,109,1566
2003,3363,4307,5465,687742,684539,344,6.264,398,7.247,76471,15201,61270,2.221,11.171,71133,18983,52150,2.773,10.391,5338,0.78,20.783,252,254,5233
2003,3364,1150,1498,375394,385477,90,5.988,100,6.653,21578,10051,11527,2.607,5.598,42420,7080,35340,1.837,11.005,-20842,-5.407,11.195,75,76,1141
2003,3365,146,201,25625,27122,16,8.04,12,6.03,2901,254,2647,0.937,10.696,6043,1825,4218,6.729,22.281,-3142,-11.585,21.393,3,3,8
2003,3366,1527,1652,136637,135548,159,9.666,145,8.815,13451,2413,11038,1.78,9.923,11026,2673,8353,1.972,8.134,2425,1.789,16.269,103,103,1177
2003,3369,714,746,40383,39614,84,11.321,76,10.243,5085,891,4194,2.249,12.837,3488,1282,2206,3.236,8.805,1597,4.031,17.61,59,60,585
2003,3371,14785,15323,369709,378823,1219,7.875,1530,9.885,36987,8233,28754,2.173,9.764,54800,17135,37665,4.523,14.466,-17813,-4.702,19.527,1148,1152,9487
2003,3372,3940,4139,156860,160477,260,6.245,308,7.399,15188,3334,11854,2.078,9.464,22463,5887,16576,3.668,13.998,-7275,-4.533,18.929,230,231,2661
2003,3379,923,1053,45904,46370,53,4.991,71,6.685,4236,1117,3119,2.409,9.135,5303,1493,3810,3.22,11.436,-1067,-2.301,18.27,52,52,508
2003,3391,10588,11293,303331,303407,778,6.897,754,6.684,33751,8484,25267,2.796,11.124,34081,11554,22527,3.808,11.233,-330,-0.109,22.248,585,585,4531
2003,3399,17742,18254,405602,408131,1470,7.981,1801,9.778,47704,9746,37958,2.388,11.688,52871,17345,35526,4.25,12.954,-5167,-1.266,23.377,1439,1442,10866
2003,4231,17961,24275,356592,355593,2110,8.697,2081,8.578,46950,12640,34310,3.555,13.203,44806,16384,28422,4.608,12.6,2144,0.603,25.201,1358,1398,8290
2003,4232,11121,12663,161506,160339,1345,10.657,1261,9.991,25628,7641,17987,4.766,15.984,23234,7522,15712,4.691,14.491,2394,1.493,28.981,901,925,5170
2003,4233,11509,16717,231047,226860,1525,9.208,1213,7.324,35213,9877,25336,4.354,15.522,26968,8478,18490,3.737,11.888,8245,3.634,23.775,729,756,4316
2003,4234,26425,33926,697133,696058,3935,11.603,3911,11.532,121023,55001,66022,7.902,17.387,118530,40292,78238,5.789,17.029,2493,0.358,34.058,2551,2620,16558
2003,4235,7500,10180,146584,146312,771,7.567,790,7.753,18769,6617,12152,4.523,12.828,18238,5876,12362,4.016,12.465,531,0.363,24.93,485,505,3083
2003,4236,20173,29625,465598,480488,2565,8.517,3551,11.79,70652,27439,43213,5.711,14.704,100650,35472,65178,7.382,20.947,-29998,-6.243,29.408,1807,1896,11953
2003,4237,11316,18056,210511,210379,1353,7.519,1232,6.846,26981,8759,18222,4.163,12.825,27190,9026,18164,4.29,12.924,-209,-0.099,25.65,675,742,5326
2003,4238,44268,59230,689815,693573,4137,6.925,5149,8.62,93343,33830,59513,4.878,13.458,100977,33966,67011,4.897,14.559,-7634,-1.101,26.917,3006,3148,16289
2003,4239,29275,32147,325356,321008,4112,12.927,3436,10.802,55019,17047,37972,5.31,17.139,46323,16793,29530,5.231,14.431,8696,2.709,28.861,2651,2687,10881
2003,4241,9739,12241,215461,210654,985,8.01,1096,8.913,32572,16536,16036,7.85,15.462,23229,8828,14401,4.191,11.027,9343,4.435,22.054,684,738,4026
2003,4242,5556,7019,250682,237715,837,11.966,789,11.279,53241,12938,40303,5.443,22.397,26306,10849,15457,4.564,11.066,26935,11.331,22.132,513,524,4943
2003,4243,14124,15290,194664,195083,1894,12.356,1972,12.865,37021,11246,25775,5.765,18.977,37784,14859,22925,7.617,19.368,-763,-0.391,37.954,1546,1591,8396
2003,4244,26630,32292,764791,753595,3171,9.855,2940,9.137,108638,25052,83586,3.324,14.416,86438,30092,56346,3.993,11.47,22200,2.946,22.94,2123,2152,13794
2003,4245,4390,6956,65108,65419,425,6.059,541,7.713,9689,2367,7322,3.618,14.811,10293,2585,7708,3.951,15.734,-604,-0.923,29.621,300,316,1494
2003,4246,8874,12450,146575,145859,972,7.469,2101,16.144,24961,5272,19689,3.614,17.113,23395,11249,12146,7.712,16.039,1566,1.074,32.079,588,600,2540
2003,4247,5389,7537,105208,104840,494,6.456,724,9.462,20666,5635,15031,5.375,19.712,20080,6621,13459,6.315,19.153,586,0.559,38.306,341,368,1926
2003,4248,3207,4008,166575,163541,286,7.132,290,7.232,19388,4046,15342,2.474,11.855,13219,5385,7834,3.293,8.083,6169,3.772,16.166,214,219,3140
2003,4249,24127,29750,379671,381830,3479,11.749,3201,10.81,59377,16869,42508,4.418,15.551,63611,22100,41511,5.788,16.66,-4234,-1.109,31.101,2211,2236,11038
2003,4251,30389,32238,264300,259659,3076,9.635,2448,7.668,41135,11788,29347,4.54,15.842,31859,8241,23618,3.174,12.27,9276,3.572,24.539,1738,1747,4926
2003,4411,43905,48079,1287521,1272916,4848,10.165,4076,8.546,156086,51178,104908,4.021,12.262,127005,41364,85641,3.25,9.977,29081,2.285,19.955,3243,3267,29993
2003,4412,13323,14679,148098,143327,1640,11.38,1105,7.667,27439,9999,17440,6.976,19.144,17857,5569,12288,3.886,12.459,9582,6.685,24.918,859,885,4260
2003,4413,32415,55776,485057,482794,3975,7.123,4033,7.227,69798,22029,47769,4.563,14.457,65098,19776,45322,4.096,13.484,4700,0.974,26.967,2363,2578,11348
2003,4421,18905,26260,266022,259753,2837,10.867,2529,9.687,50595,18603,31992,7.162,19.478,38253,14526,23727,5.592,14.727,12342,4.751,29.453,1553,1713,9371
2003,4422,25582,34423,299610,293483,3747,11.02,2904,8.541,59854,26137,33717,8.906,20.394,47811,12382,35429,4.219,16.291,12043,4.103,32.582,1955,2028,6725
2003,4431,30324,49970,471125,462728,6499,13.156,5355,10.841,83916,37027,46889,8.002,18.135,67766,24520,43246,5.299,14.645,16150,3.49,29.29,3656,3936,15914
2003,4441,44915,64509,1040479,1032036,4619,7.193,4033,6.28,112597,40084,72513,3.884,10.91,95206,26503,68703,2.568,9.225,17391,1.685,18.45,2665,2804,14541
2003,4442,15859,19076,172731,170687,1525,8.003,1486,7.798,30185,7449,22736,4.364,17.684,25865,7262,18603,4.255,15.154,4320,2.531,30.307,1044,1075,4797
2003,4451,59974,87049,2573547,2560317,10864,12.624,8887,10.326,309914,141274,168640,5.518,12.105,284904,102761,182143,4.014,11.128,25010,0.977,22.255,6273,6362,38689
2003,4452,17229,22119,150946,143257,3686,17.078,2614,12.111,42620,20461,22159,14.283,29.751,26927,11156,15771,7.787,18.796,15693,10.954,37.593,1973,2021,8649
2003,4453,23283,26585,139795,136463,2917,11.104,2285,8.698,27664,10603,17061,7.77,20.272,21121,7773,13348,5.696,15.477,6543,4.795,30.955,1782,1795,6111
2003,4461,39270,78436,956971,949489,6088,7.81,5118,6.566,114711,40113,74598,4.225,12.081,101591,36477,65114,3.842,10.7,13120,1.382,21.399,2758,2961,15562
2003,4471,60943,112753,932719,928836,10149,8.95,11428,10.078,172815,62496,110319,6.728,18.606,165231,67045,98186,7.218,17.789,7584,0.817,35.578,5517,6008,32160
2003,4481,35178,84769,1101686,1061182,8779,10.402,8042,9.528,214710,59644,155066,5.621,20.233,132221,50210,82011,4.732,12.46,82489,7.773,24.92,3854,4036,17596
2003,4482,6155,26584,190754,199952,1903,7.076,2521,9.374,30303,10714,19589,5.358,15.155,47730,12699,35031,6.351,23.871,-17427,-8.716,30.31,762,1022,3697
2003,4483,18514,28262,163307,161358,2536,9.011,2301,8.176,27918,8421,19497,5.219,17.302,23772,8925,14847,5.531,14.733,4146,2.569,29.465,1344,1464,4317
2003,4511,27999,38437,404313,400320,3974,10.318,4127,10.716,76135,21617,54518,5.4,19.019,68630,24387,44243,6.092,17.144,7505,1.875,34.288,2604,2785,11082
2003,4512,6422,12062,141933,142251,1167,9.703,1098,9.129,20000,7123,12877,5.007,14.06,20797,5786,15011,4.067,14.62,-797,-0.56,28.119,653,671,2694
2003,4522,166,5592,776707,813449,269,4.818,251,4.496,45309,22607,22702,2.779,5.57,116353,22615,93738,2.78,14.304,-71044,-8.734,11.14,3,3,503
2003,4523,8348,34159,1830198,1790498,3718,11.158,2041,6.125,199746,91598,108148,5.116,11.156,120704,29303,91401,1.637,6.741,79042,4.415,13.483,988,1026,4919
2003,4531,19556,20408,113350,114343,1789,8.679,2199,10.668,19828,6243,13585,5.46,17.341,21805,7232,14573,6.325,19.07,-1977,-1.729,34.682,1792,1816,5807
2003,4532,27976,39285,325729,323471,4096,10.387,4393,11.14,54430,17486,36944,5.406,16.827,50207,18918,31289,5.848,15.521,4223,1.306,31.043,3177,3267,11226
2003,4533,12322,16442,127339,123367,1697,10.303,1755,10.655,24226,7266,16960,5.89,19.637,15987,6185,9802,5.013,12.959,8239,6.678,25.918,1354,1365,4022
2003,4539,31263,40016,253450,247890,5249,13.222,4614,11.623,55213,21719,33494,8.762,22.273,43580,17354,26226,7.001,17.58,11633,4.693,35.161,3160,3282,11878
2003,4541,13289,14233,273670,270414,2261,16.182,1740,12.453,48803,17082,31721,6.317,18.048,41847,15106,26741,5.586,15.475,6956,2.572,30.95,1322,1344,6829
2003,4542,4554,5156,61716,61944,528,10.124,647,12.405,7607,2528,5079,4.081,12.281,8019,3765,4254,6.078,12.946,-412,-0.665,24.561,463,465,2475
2003,4543,23056,29190,242885,241617,2934,10.066,2848,9.771,36623,12075,24548,4.998,15.157,34138,12081,22057,5,14.129,2485,1.028,28.258,1999,2048,7953
2003,4811,583,3053,482012,489088,280,9.183,272,8.921,28651,10378,18273,2.122,5.858,41628,3951,37677,0.808,8.511,-12977,-2.653,11.716,67,96,1826
2003,4812,1838,1995,35280,34948,298,15.173,236,12.016,6117,2078,4039,5.946,17.503,5594,1246,4348,3.565,16.007,523,1.497,32.013,179,180,757
2003,4831,809,1186,49251,49103,129,10.688,171,14.167,8105,2691,5414,5.48,16.506,7650,3201,4449,6.519,15.58,455,0.927,31.159,73,75,911
2003,4832,475,532,19337,19044,84,16.232,55,10.628,6647,5454,1193,28.64,34.904,5880,1982,3898,10.408,30.877,767,4.028,61.753,34,34,180
2003,4841,42168,51353,973512,984985,8560,16.778,7891,15.467,148358,43784,104574,4.445,15.062,171436,83770,87666,8.505,17.405,-23078,-2.343,30.124,5767,5850,30607
2003,4842,42092,45292,441637,442274,5610,12.302,6229,13.66,79690,24707,54983,5.586,18.018,80498,30445,50053,6.884,18.201,-808,-0.183,36.036,4722,4754,20492
2003,4851,625,896,47334,46467,103,11.438,112,12.438,6884,3370,3514,7.253,14.815,5419,2801,2618,6.028,11.662,1465,3.153,23.324,63,67,1052
2003,4852,215,492,17719,15514,113,24.068,68,14.483,6614,2348,4266,15.135,42.632,2053,1351,702,8.708,13.233,4561,29.399,26.466,19,21,273
2003,4853,5889,6006,64498,63856,898,14.97,883,14.72,11714,4388,7326,6.872,18.345,10517,4293,6224,6.723,16.47,1197,1.875,32.94,734,734,3792
2003,4854,3028,4240,181266,177959,309,7.254,348,8.17,25387,8580,16807,4.821,14.266,18692,5524,13168,3.104,10.504,6695,3.762,21.007,242,242,2717
2003,4855,1066,1180,29096,28590,112,9.451,122,10.295,4689,893,3796,3.124,16.401,3720,1208,2512,4.225,13.012,969,3.389,26.024,93,95,812
2003,4859,2534,2769,56607,55269,407,14.876,341,12.463,12277,4990,7287,9.029,22.213,9714,4238,5476,7.668,17.576,2563,4.637,35.152,258,259,2394
2003,4861,56,287,6178,6270,55,20.221,25,9.191,1559,459,1100,7.321,24.864,1771,849,922,13.541,28.246,-212,-3.381,49.729,0,0,0
2003,4862,127,1895,26707,28082,136,7.201,123,6.513,2893,1254,1639,4.466,10.302,5602,925,4677,3.294,19.949,-2709,-9.647,20.604,5,5,28
2003,4869,57,507,6008,6162,92,19.048,44,9.11,1828,1044,784,16.943,29.666,2033,270,1763,4.382,32.993,-205,-3.327,59.331,(D),(D),(D)
2003,4871,438,489,9320,8958,65,13.444,54,11.169,1664,403,1261,4.499,18.577,925,216,709,2.411,10.327,739,8.25,20.653,40,40,188
2003,4872,1172,1201,11359,11037,189,15.842,173,14.501,2545,701,1844,6.352,23.06,1881,481,1400,4.358,17.043,664,6.016,34.087,122,122,379
2003,4879,131,134,1708,1609,18,13.333,20,14.815,319,47,272,2.921,19.826,126,36,90,2.237,7.831,193,11.995,15.662,13,13,24
2003,4881,3312,4690,132492,134761,630,13.673,465,10.092,23317,10089,13228,7.487,17.303,27080,6012,21068,4.461,20.095,-3763,-2.792,34.605,292,305,2651
2003,4882,440,875,25424,23971,147,17.563,71,8.483,5468,2200,3268,9.178,22.811,2564,786,1778,3.279,10.696,2904,12.115,21.393,28,29,238
2003,4883,1648,2138,79686,77628,245,11.598,194,9.183,16899,4649,12250,5.989,21.769,12885,3992,8893,5.143,16.598,4014,5.171,33.197,118,120,1632
2003,4884,6954,7323,60387,57741,1171,16.359,841,11.749,15251,7738,7513,13.401,26.413,10115,4108,6007,7.115,17.518,5136,8.895,35.036,639,643,2872
2003,4885,11198,15536,172350,167901,1848,12.036,1484,9.665,37505,14554,22951,8.668,22.338,28349,11076,17273,6.597,16.884,9156,5.453,33.769,914,938,5346
2003,4889,1031,1151,21437,20977,181,15.583,202,17.391,3896,1823,2073,8.691,18.573,3067,1035,2032,4.934,14.621,829,3.952,29.242,163,163,680
2003,4921,2857,8595,447082,476695,2669,34.352,1018,13.103,187125,184578,2547,38.72,39.255,246728,19874,226854,4.169,51.758,-59603,-12.503,78.509,372,374,2571
2003,4922,4187,4583,43821,44901,784,17.316,673,14.865,8178,3299,4879,7.347,18.214,10395,3785,6610,8.43,23.151,-2217,-4.938,36.427,563,572,3014
2003,4931,6714,12057,546593,545715,1183,9.817,1171,9.717,88879,25379,63500,4.651,16.287,87384,25751,61633,4.719,16.013,1495,0.274,32.026,380,397,3738
2003,5111,15174,20609,702170,707306,1993,9.681,1948,9.463,69406,22254,47152,3.146,9.813,80276,20493,59783,2.897,11.35,-10870,-1.537,19.625,1207,1234,7296
2003,5112,6325,8691,339129,346605,981,11.138,1215,13.794,47665,19494,28171,5.624,13.752,62781,24453,38328,7.055,18.113,-15116,-4.361,27.504,680,711,8720
2003,5121,11945,15539,269689,262825,2298,14.908,2049,13.293,76153,40357,35796,15.355,28.975,60423,17178,43245,6.536,22.99,15730,5.985,45.98,1263,1278,6894
2003,5122,2554,2828,27086,28380,396,13.909,434,15.244,2870,1185,1685,4.175,10.113,5468,2795,2673,9.848,19.267,-2598,-9.154,20.226,318,322,1068
2003,5151,4676,9226,253208,250397,1678,19.069,825,9.376,39788,17871,21917,7.137,15.89,34442,11627,22815,4.643,13.755,5346,2.135,27.51,347,359,3207
2003,5152,315,878,44432,47352,92,10.279,126,14.078,4760,1256,3504,2.652,10.052,10682,2289,8393,4.834,22.559,-5922,-12.506,20.105,40,42,1292
2003,5173,6967,43796,1396037,1413527,5913,13.507,5878,13.427,228495,84205,144290,5.957,16.165,268888,158617,110271,11.221,19.022,-40393,-2.858,32.33,1111,1179,14341
2003,5174,420,558,13812,14703,88,15.479,109,19.173,1802,610,1192,4.149,12.256,3600,1610,1990,10.951,24.486,-1798,-12.229,24.513,65,67,882
2003,5179,5213,6038,74785,83048,1408,23.537,1296,21.665,15389,7399,7990,8.909,18.53,32113,15791,16322,19.014,38.668,-16724,-20.138,37.061,960,984,8540
2003,5182,6971,12809,409068,413813,2395,19.015,1967,15.617,69268,29931,39337,7.233,16.739,78949,29106,49843,7.034,19.078,-9681,-2.339,33.478,769,787,9280
2003,5191,4332,5240,92833,94814,582,11.07,617,11.736,13235,4609,8626,4.861,13.959,17218,7542,9676,7.955,18.16,-3983,-4.201,27.918,422,434,3405
2003,5211,18,53,22256,22686,(D),(D),0,0,375,(D),371,(D),1.653,1219,0,1219,0,5.373,-844,-3.72,3.306,0,0,0
2003,5221,16900,113483,2088078,2097197,9500,8.451,7357,6.545,296930,110092,186838,5.249,14.158,317403,85046,232357,4.055,15.135,-20473,-0.976,28.317,497,646,7402
2003,5222,18322,48438,720446,695685,7045,14.839,5123,10.79,176255,70076,106179,10.073,25.335,125733,55922,69811,8.038,18.073,50522,7.262,36.147,1556,1677,8818
2003,5223,20493,30963,308808,290559,5487,18.542,2747,9.283,87626,32514,55112,11.19,30.158,51719,19763,31956,6.802,17.8,35907,12.358,35.6,1605,1686,8905
2003,5231,11938,43040,519328,559394,10097,24.568,6215,15.122,91187,44390,46797,7.935,16.301,178613,68886,109727,12.314,31.93,-87426,-15.629,32.602,1189,1387,6802
2003,5232,50,59,7027,6815,18,33.962,6,11.321,885,554,331,8.129,12.986,467,22,445,0.323,6.853,418,6.134,13.705,(D),(D),(D)
2003,5239,29201,32870,359680,363394,5891,18.291,4564,14.171,72194,39095,33099,10.758,19.867,78416,29110,49306,8.011,21.579,-6222,-1.712,39.733,2969,2993,11994
2003,5241,5455,29706,1511520,1527596,3634,12.074,4417,14.676,191592,61809,129783,4.046,12.542,223720,74071,149649,4.849,14.645,-32128,-2.103,25.084,351,387,6757
2003,5242,115235,128162,872640,847049,12946,10.198,10504,8.275,173423,56861,116562,6.713,20.474,122135,48837,73298,5.766,14.419,51288,6.055,28.838,7303,7419,24007
2003,5259,909,954,7194,6916,213,23.064,152,16.459,2248,915,1333,13.23,32.504,1708,800,908,11.567,24.696,540,7.808,49.393,102,102,501
2003,5311,87439,104522,545493,538065,11161,10.742,9927,9.554,108717,45471,63246,8.451,20.205,93083,36151,56932,6.719,17.3,15634,2.906,34.599,7094,7230,23967
2003,5312,58634,66179,299784,285996,11127,17.395,6703,10.479,74481,32236,42245,11.271,26.043,46543,19407,27136,6.786,16.274,27938,9.769,32.548,4454,4558,12779
2003,5313,54142,60243,571265,553438,9443,16.229,5330,9.16,115910,44443,71467,8.03,20.944,80469,29629,50840,5.354,14.54,35441,6.404,29.08,3780,3825,18966
2003,5321,4228,10407,168040,172391,1062,9.924,1650,15.419,22250,7847,14403,4.552,12.907,30720,13448,17272,7.801,17.82,-8470,-4.913,25.813,546,593,3129
2003,5322,12627,31382,271093,262405,2985,9.583,2517,8.081,50307,14261,36046,5.435,19.172,34021,12997,21024,4.953,12.965,16286,6.206,25.93,1441,1591,7139
2003,5323,3315,4901,32906,32686,350,7.068,452,9.128,5654,1794,3860,5.489,17.298,5205,1789,3416,5.473,15.924,449,1.374,31.849,246,277,1068
2003,5324,7274,11889,149662,152489,1196,10.034,1257,10.546,23298,7244,16054,4.751,15.278,29145,9589,19556,6.288,19.113,-5847,-3.834,30.557,633,643,3578
2003,5331,1959,2080,28979,27792,285,13.838,244,11.848,6235,3213,3022,11.561,22.435,3869,1675,2194,6.027,13.922,2366,8.513,27.843,168,169,785
2003,5411,157698,166058,1192812,1168525,15429,9.386,12080,7.349,175779,49278,126501,4.217,15.043,127201,41609,85592,3.561,10.886,48578,4.157,21.771,9118,9226,27970
2003,5412,90188,102645,1253015,1242967,11333,11.201,8408,8.31,256695,80158,176537,6.449,20.652,241144,77460,163684,6.232,19.401,15551,1.251,38.801,5491,5565,35305
2003,5413,83623,95553,1250031,1259593,10649,11.25,8853,9.353,196178,59598,136580,4.732,15.575,217291,55378,161913,4.396,17.251,-21113,-1.676,31.149,5827,5917,26438
2003,5414,25496,25772,117838,118107,3710,14.454,3502,13.643,23500,9703,13797,8.215,19.897,24009,9131,14878,7.731,20.328,-509,-0.431,39.795,2666,2668,7158
2003,5415,74458,84237,1081451,1093769,15516,18.263,16955,19.957,226902,96675,130227,8.839,20.745,249875,105639,144236,9.658,22.845,-22973,-2.1,41.49,11858,11957,56338
2003,5416,81594,87224,730533,711241,18331,21.584,13741,16.179,183959,76852,107107,10.805,25.865,145840,68225,77615,9.592,20.505,38119,5.36,41.01,9977,10050,35405
2003,5417,10428,13402,605098,603055,1691,12.662,1597,11.958,88357,34133,54224,5.66,14.652,84159,25959,58200,4.305,13.955,4198,0.696,27.911,967,973,8759
2003,5418,30225,33395,405081,405743,3766,11.264,3846,11.503,68297,18861,49436,4.649,16.833,69115,26467,42648,6.523,17.034,-818,-0.202,33.665,2899,2934,16204
2003,5419,52459,60259,541042,530443,8085,13.783,4883,8.325,108158,37340,70818,7.039,20.39,88447,26803,61644,5.053,16.674,19711,3.716,33.348,3504,3522,17980
2003,5511,26550,46841,2819717,2839327,4823,10.241,5331,11.32,485134,146284,338850,5.152,17.086,521026,166487,354539,5.864,18.35,-35892,-1.264,34.172,1141,1210,16800
2003,5611,17948,19979,418158,404760,4261,22.034,2979,15.405,107965,49603,58362,12.255,26.674,80783,33022,47761,8.158,19.958,27182,6.716,39.916,1837,1857,20803
2003,5612,1711,3200,139212,140491,474,14.686,529,16.39,26265,10438,15827,7.43,18.695,29204,13299,15905,9.466,20.787,-2939,-2.092,37.39,131,135,2158
2003,5613,26337,43558,3723146,3803038,6021,13.7,6801,15.475,937203,207978,729225,5.469,24.644,1090724,378294,712430,9.947,28.68,-153521,-4.037,49.287,3365,3496,162404
2003,5614,26209,31347,758282,752364,4172,13.385,3817,12.246,156833,54584,102249,7.255,20.845,144284,53997,90287,7.177,19.177,12549,1.668,38.355,2701,2839,25152
2003,5615,17527,23858,278700,282763,2607,10.397,5040,20.1,51536,19268,32268,6.814,18.226,60124,23962,36162,8.474,21.263,-8588,-3.037,36.452,2322,2374,8854
2003,5616,16698,21063,742330,742812,2599,12.454,2211,10.595,166950,49941,117009,6.723,22.475,165056,41839,123217,5.633,22.22,1894,0.255,44.441,1524,1540,20038
2003,5617,121992,128253,1561224,1541827,20447,16.234,15843,12.579,312020,97468,214552,6.322,20.237,272088,89428,182660,5.8,17.647,39932,2.59,35.294,11410,11443,57223
2003,5619,16611,18696,350164,345245,2194,11.707,2285,12.192,74694,18106,56588,5.244,21.635,63774,22663,41111,6.564,18.472,10920,3.163,36.944,1593,1626,10299
2003,5621,6243,7975,176440,173283,716,8.97,730,9.146,24444,6922,17522,3.995,14.106,18374,7596,10778,4.384,10.603,6070,3.503,21.207,491,493,3511
2003,5622,1440,2429,54500,52948,281,11.677,236,9.807,9855,4076,5779,7.698,18.613,6887,2695,4192,5.09,13.007,2968,5.605,26.014,133,133,1216
2003,5629,6221,6884,101919,101141,755,11.055,646,9.459,22817,7020,15797,6.941,22.56,21067,5680,15387,5.616,20.829,1750,1.73,41.659,462,470,3730
2003,6111,17794,19860,803346,794974,1011,5.114,826,4.179,79266,14801,64465,1.862,9.971,62740,12355,50385,1.554,7.892,16526,2.079,15.784,505,515,6704
2003,6112,548,857,92735,92108,41,4.748,54,6.254,11156,521,10635,0.566,12.112,10022,894,9128,0.971,10.881,1134,1.231,21.761,28,35,544
2003,6113,2431,3242,1443663,1426557,208,6.504,120,3.752,107232,4565,102667,0.32,7.517,73655,5519,68136,0.387,5.163,33577,2.354,10.326,81,81,2027
2003,6114,6015,6548,64343,65322,871,13.051,1123,16.826,12336,3910,8426,5.986,18.885,14245,6026,8219,9.225,21.807,-1909,-2.922,37.77,770,805,4229
2003,6115,5738,6786,95421,93809,772,11.536,584,8.727,19028,5673,13355,6.047,20.284,15736,5853,9883,6.239,16.775,3292,3.509,33.549,402,420,4010
2003,6116,24578,26548,236051,226303,4208,16.404,2418,9.426,57252,20003,37249,8.839,25.299,38127,12578,25549,5.558,16.848,19125,8.451,33.696,1781,1812,9492
2003,6117,3931,4367,49179,48232,901,21.519,541,12.921,11587,4253,7334,8.818,24.023,9742,3569,6173,7.4,20.198,1845,3.825,40.396,383,385,1405
2003,6211,167834,190977,1967437,1922306,17638,9.361,12536,6.653,329131,103936,225195,5.407,17.122,238149,75196,162953,3.912,12.389,90982,4.733,24.777,8789,9000,42160
2003,6212,108919,113553,772382,760327,6160,5.467,4396,3.902,112614,32676,79938,4.298,14.811,88114,23847,64267,3.136,11.589,24500,3.222,23.178,3516,3550,19686
2003,6213,89240,97100,518486,501070,11555,12.18,7088,7.472,110751,40182,70569,8.019,22.103,75849,26040,49809,5.197,15.137,34902,6.966,30.275,5073,5175,16486
2003,6214,12189,24463,623774,601043,2340,9.629,2019,8.308,117518,30394,87124,5.057,19.552,72231,30471,41760,5.07,12.018,45287,7.535,24.035,683,734,7927
2003,6215,6375,9782,205385,199594,1335,13.409,1683,16.904,44825,20706,24119,10.374,22.458,32626,16236,16390,8.135,16.346,12199,6.112,32.692,506,1138,11124
2003,6216,11360,16469,805071,779309,2459,15.334,1594,9.94,154894,40970,113924,5.257,19.876,103644,30086,73558,3.861,13.299,51250,6.576,26.599,974,1040,15354
2003,6219,5324,8289,223723,218006,836,10.173,693,8.433,39338,12783,26555,5.864,18.044,28117,9742,18375,4.469,12.897,11221,5.147,25.795,382,389,4196
2003,6221,3237,5309,4782357,4743291,162,3.069,102,1.932,268304,46382,221922,0.978,5.656,190736,48483,142253,1.022,4.021,77568,1.635,8.042,37,37,10567
2003,6222,492,630,215576,216244,37,5.925,26,4.163,12779,5619,7160,2.598,5.91,13412,8797,4615,4.068,6.202,-633,-0.293,11.819,8,8,4175
2003,6223,379,667,187716,186137,86,13.272,48,7.407,16011,4251,11760,2.284,8.602,12893,8678,4215,4.662,6.927,3118,1.675,13.853,14,14,2846
2003,6231,8278,15829,1608914,1597169,1065,6.75,963,6.103,175750,62063,113687,3.886,11.004,151526,61298,90228,3.838,9.487,24224,1.517,18.974,485,553,31581
2003,6232,7953,27889,515466,500209,1920,6.953,1367,4.951,91326,20315,71011,4.061,18.258,60438,16123,44315,3.223,12.083,30888,6.175,24.165,366,429,5926
2003,6233,12833,16979,595708,579182,1803,10.674,1627,9.632,88713,30590,58123,5.282,15.317,55593,24531,31062,4.235,9.599,33120,5.718,19.197,1206,1224,16189
2003,6239,3419,5961,159181,156999,452,7.576,463,7.76,24470,5796,18674,3.692,15.586,20065,5792,14273,3.689,12.78,4405,2.806,25.561,175,192,2229
2003,6241,34486,48002,933723,915269,4367,9.221,3082,6.508,152056,35522,116534,3.881,16.613,114974,22994,91980,2.512,12.562,37082,4.051,25.124,1738,1807,11268
2003,6242,9133,12277,152490,150316,723,5.917,608,4.976,21341,3979,17362,2.647,14.197,16873,3801,13072,2.529,11.225,4468,2.972,22.45,299,303,1921
2003,6243,5023,8075,327136,323998,534,6.608,547,6.769,49698,6891,42807,2.127,15.339,43288,7396,35892,2.283,13.361,6410,1.978,26.721,191,208,1843
2003,6244,51278,64872,774062,760537,7281,11.336,5994,9.332,134439,48330,86109,6.355,17.677,108140,36328,71812,4.777,14.219,26299,3.458,28.438,4340,4392,24047
2003,7111,7531,7695,131822,130850,971,12.698,875,11.442,28472,6790,21682,5.189,21.759,26664,6565,20099,5.017,20.378,1808,1.382,40.755,638,638,4606
2003,7112,3200,3365,111639,108072,558,16.722,502,15.043,23757,8080,15677,7.476,21.983,16950,5260,11690,4.867,15.684,6807,6.299,31.368,416,419,3835
2003,7113,4265,4532,98680,95832,687,15.575,445,10.088,24890,7427,17463,7.75,25.973,18893,7420,11473,7.743,19.715,5997,6.258,39.43,296,297,5418
2003,7114,2615,2678,15985,15593,434,16.356,385,14.509,3659,1686,1973,10.813,23.466,2782,1212,1570,7.773,17.841,877,5.624,35.683,282,282,907
2003,7115,11322,11343,43563,42336,2500,22.839,1706,15.586,16003,7673,8330,18.124,37.8,13531,5004,8527,11.82,31.961,2472,5.839,63.923,1077,1077,3104
2003,7121,5758,6191,120313,124030,485,7.957,293,4.807,12909,1723,11186,1.389,10.408,20867,1186,19681,0.956,16.824,-7958,-6.416,20.816,185,185,794
2003,7131,1764,2433,134531,128291,312,12.686,365,14.84,28635,3504,25131,2.731,22.32,15438,5368,10070,4.184,12.034,13197,10.287,24.067,225,225,2592
2003,7132,1586,2001,162165,159578,223,11.308,165,8.367,19717,6780,12937,4.249,12.356,14848,4460,10388,2.795,9.305,4869,3.051,18.609,119,125,4184
2003,7139,46608,51589,1022425,1006553,6973,13.835,4595,9.117,178543,59870,118673,5.948,17.738,146150,42456,103694,4.218,14.52,32393,3.218,29.04,3454,3499,27929
2003,7211,36106,46131,1750753,1720628,4708,10.291,3945,8.623,245022,88982,156040,5.171,14.24,186567,62174,124393,3.613,10.843,58455,3.397,21.686,2686,2762,36297
2003,7212,5181,5633,37906,37286,594,10.66,472,8.471,7496,1912,5584,5.128,20.104,6197,1722,4475,4.618,16.62,1299,3.484,33.241,299,300,1076
2003,7213,2346,2424,13312,13069,152,6.191,214,8.717,2179,530,1649,4.055,16.673,1722,542,1180,4.147,13.176,457,3.497,26.352,153,153,351
2003,7223,10753,27680,558428,554947,4632,16.683,4801,17.292,132331,68408,63923,12.327,23.846,125094,73214,51880,13.193,22.542,7237,1.304,45.083,1333,1369,8142
2003,7224,43137,43634,352640,345387,5397,12.366,5416,12.41,83112,39877,43235,11.546,24.063,68624,28398,40226,8.222,19.869,14488,4.195,39.738,4488,4500,23987
2003,7225,281771,388123,7743403,7593915,51333,13.425,39818,10.414,1469231,697839,771392,9.189,19.347,1170934,440323,730611,5.798,15.419,298297,3.928,30.839,29081,29947,280636
2003,8111,139706,152471,894447,884004,15332,10.072,14850,9.755,166521,61296,105225,6.934,18.837,145768,56527,89241,6.394,16.49,20753,2.348,32.979,10847,11048,40107
2003,8112,11375,12893,131841,132066,1359,10.424,1647,12.633,24067,6181,17886,4.68,18.223,24859,8777,16082,6.646,18.823,-792,-0.6,36.447,1196,1202,4771
2003,8113,20825,21996,175388,174768,2044,9.249,2250,10.181,30594,8997,21597,5.148,17.506,29036,10564,18472,6.045,16.614,1558,0.891,33.228,1681,1704,6582
2003,8114,21091,22320,110604,112623,2880,13.015,2497,11.284,21859,6974,14885,6.192,19.409,25403,7539,17864,6.694,22.556,-3544,-3.147,38.818,1930,1942,4887
2003,8121,77247,90581,552529,540191,12895,14.468,9993,11.212,112326,52916,59410,9.796,20.794,88007,38674,49333,7.159,16.292,24319,4.502,32.584,7648,8045,29789
2003,8122,14814,21010,145487,145413,954,4.526,1088,5.162,16375,3300,13075,2.269,11.261,16404,4127,12277,2.838,11.281,-29,-0.02,22.522,468,482,1662
2003,8123,32250,38214,367383,369348,3784,9.873,4009,10.46,53836,17225,36611,4.664,14.576,57110,22104,35006,5.985,15.462,-3274,-0.886,29.152,2956,3044,14880
2003,8129,22260,33280,239354,234357,6141,19.039,4092,12.686,56045,23890,32155,10.194,23.914,46346,20022,26324,8.543,19.776,9699,4.139,39.552,2406,2429,11252
2003,8131,166874,167106,1658421,1646408,9098,5.492,6220,3.755,180717,27380,153337,1.663,10.976,157016,23667,133349,1.437,9.537,23701,1.44,19.074,4121,4121,11280
2003,8132,12150,14097,144019,143338,1176,8.436,861,6.177,18377,4134,14243,2.884,12.821,17218,2921,14297,2.038,12.012,1159,0.809,24.024,579,580,1600
2003,8133,9944,12050,110139,107565,1181,9.961,793,6.689,19306,3938,15368,3.661,17.948,13760,3020,10740,2.808,12.792,5546,5.156,25.585,475,492,1855
2003,8134,27976,30002,322102,318657,1642,5.495,1396,4.672,44067,6941,37126,2.178,13.829,37162,6020,31142,1.889,11.662,6905,2.167,23.324,966,971,3539
2003,8139,59911,61940,522265,514496,3209,5.167,3529,5.683,76422,15696,60726,3.051,14.854,61091,12174,48917,2.366,11.874,15331,2.98,23.748,2520,2523,8690
2004,1131,390,437,4665,4801,61,13.927,63,14.384,530,207,323,4.312,11.039,801,504,297,10.498,16.684,-271,-5.645,22.079,38,38,155
2004,1132,162,211,2174,1996,26,11.818,44,20,690,502,188,25.157,34.578,327,176,151,8.82,16.387,363,18.191,32.774,28,28,142
2004,1133,9520,9603,69303,68814,1082,11.199,1200,12.42,13128,3555,9573,5.166,19.078,12232,4426,7806,6.432,17.775,896,1.302,35.551,890,891,3502
2004,1141,1249,1263,6151,6192,199,15.694,209,16.483,1248,431,817,6.961,20.157,1368,556,812,8.98,22.095,-120,-1.938,40.313,129,129,412
2004,1142,303,303,2354,2371,39,12.787,43,14.098,283,69,214,2.91,11.936,318,156,162,6.58,13.412,-35,-1.476,23.872,29,29,111
2004,1151,3956,4280,61308,61387,443,10.182,585,13.445,10800,3356,7444,5.467,17.593,10887,4538,6349,7.392,17.735,-87,-0.142,35.187,362,362,1980
2004,1152,3692,3760,21293,21295,535,14.351,471,12.634,3781,1521,2260,7.143,17.755,3858,1613,2245,7.575,18.117,-77,-0.362,35.511,357,357,1274
2004,1153,1293,1335,15090,15101,186,13.798,212,15.727,2890,916,1974,6.066,19.138,2920,894,2026,5.92,19.336,-30,-0.199,38.276,148,148,568
2004,2111,5581,6669,80550,81285,595,8.879,660,9.849,13482,6262,7220,7.704,16.586,14636,6745,7891,8.298,18.006,-1154,-1.42,33.172,330,335,2502
2004,2121,621,1019,69801,69758,109,10.416,164,15.671,11521,3669,7852,5.26,16.516,11516,5444,6072,7.804,16.509,5,0.007,33.017,84,90,1693
2004,2122,192,261,25583,25177,39,14.943,39,14.943,3148,1260,1888,5.005,12.504,2328,347,1981,1.378,9.247,820,3.257,18.493,27,27,109
2004,2123,3203,5222,94844,93491,392,7.511,386,7.396,12448,3600,8848,3.851,13.315,9786,3055,6731,3.268,10.467,2662,2.847,20.935,206,212,1099
2004,2131,7114,8596,197984,192845,970,11.431,749,8.827,33599,8546,25053,4.432,17.423,23165,7248,15917,3.758,12.012,10434,5.411,24.024,468,481,4273
2004,2211,1579,9620,506629,521006,782,8.075,910,9.397,42366,15964,26402,3.064,8.132,71058,20161,50897,3.87,13.639,-28692,-5.507,16.263,61,64,501
2004,2212,499,2498,86055,88013,99,3.848,249,9.677,8834,1946,6888,2.211,10.037,12773,3465,9308,3.937,14.513,-3939,-4.476,20.074,33,33,200
2004,2213,4329,5162,42104,41952,348,6.748,338,6.554,6116,2575,3541,6.138,14.579,5885,2553,3332,6.086,14.028,231,0.551,28.056,201,201,744
2004,2361,148800,149740,858002,830426,26873,18.275,21490,14.614,223854,82447,141407,9.928,26.957,168318,70886,97432,8.536,20.269,55536,6.688,40.538,14221,14223,49915
2004,2362,37871,38844,709020,708850,4118,10.576,4301,11.046,132398,27180,105218,3.834,18.678,132555,34588,97967,4.879,18.7,-157,-0.022,37.356,3116,3122,25098
2004,2371,18229,18923,454185,455958,1463,7.636,1936,10.105,91808,14342,77466,3.145,20.135,95094,16730,78364,3.669,20.856,-3286,-0.721,40.27,1373,1375,11506
2004,2372,9724,9814,66581,64997,1332,13.373,1625,16.314,18105,6636,11469,10.21,27.855,14924,8026,6898,12.348,22.961,3181,4.894,45.922,1230,1230,5912
2004,2373,9956,10685,311856,308923,831,7.686,1084,10.026,52924,8376,44548,2.711,17.132,47360,13363,33997,4.326,15.331,5564,1.801,30.661,700,701,7170
2004,2379,4223,4415,81943,82893,575,12.879,674,15.097,16436,4512,11924,5.443,19.828,17945,7363,10582,8.883,21.649,-1509,-1.82,39.656,465,465,2532
2004,2381,93024,93502,1044534,1014498,13261,14.198,13052,13.975,258224,62684,195540,6.179,25.453,198230,65429,132801,6.449,19.54,59994,5.914,39.079,8824,8830,48601
2004,2382,148721,151753,1781538,1763309,17172,11.428,14187,9.442,334328,78898,255430,4.474,18.96,298264,92986,205278,5.273,16.915,36064,2.045,33.83,10110,10156,60013
2004,2383,100718,101643,857266,835721,17591,17.518,15136,15.073,210461,59781,150680,7.153,25.183,167862,60422,107440,7.23,20.086,42599,5.097,40.172,10655,10663,43954
2004,2389,51673,52072,468387,448853,9607,18.952,6844,13.502,116105,37524,78581,8.36,25.867,77595,28123,49472,6.266,17.287,38510,8.58,34.575,4488,4491,19093
2004,3111,1156,1713,46492,46087,104,6.041,121,7.029,5675,2004,3671,4.348,12.314,4873,1747,3126,3.791,10.573,802,1.74,21.147,57,59,833
2004,3112,463,786,54916,55831,47,5.972,49,6.226,2997,715,2282,1.281,5.368,4906,926,3980,1.659,8.787,-1909,-3.419,10.736,24,24,278
2004,3113,1534,1704,79003,79132,148,8.739,127,7.499,8380,2117,6263,2.675,10.59,8717,1909,6808,2.412,11.016,-337,-0.426,21.18,90,91,895
2004,3114,1261,1657,164272,163975,127,7.662,128,7.722,15869,4282,11587,2.611,9.678,15555,5296,10259,3.23,9.486,314,0.191,18.972,83,83,702
2004,3115,1043,1550,134180,133538,90,5.79,99,6.369,10976,2204,8772,1.65,8.219,9479,1712,7767,1.282,7.098,1497,1.121,14.197,65,65,500
2004,3116,3069,3721,494624,495201,259,6.962,257,6.909,35965,11067,24898,2.235,7.263,38168,12900,25268,2.605,7.708,-2203,-0.445,14.525,174,176,2307
2004,3117,560,654,38052,38255,44,6.617,66,9.925,3787,674,3113,1.762,9.899,4224,933,3291,2.439,11.042,-437,-1.142,19.799,50,50,575
2004,3118,9361,10238,307210,311692,855,8.283,1023,9.911,35404,8632,26772,2.769,11.359,44245,13131,31114,4.213,14.195,-8841,-2.836,22.717,804,808,6461
2004,3119,2811,3245,163872,166037,270,8.399,209,6.502,17703,4965,12738,2.99,10.662,21717,6118,15599,3.685,13.08,-4014,-2.418,21.324,130,130,1835
2004,3121,2329,2864,132329,132253,326,11.55,243,8.609,12136,3108,9028,2.35,9.176,11960,2701,9259,2.042,9.043,176,0.133,18.087,151,151,1273
2004,3122,104,128,21761,22568,15,12.245,4,3.265,813,189,624,0.837,3.603,2487,22,2465,0.097,11.02,-1674,-7.418,7.205,3,3,21
2004,3131,336,513,55096,57407,29,5.55,48,9.187,3335,872,2463,1.519,5.809,8001,2590,5411,4.512,13.937,-4666,-8.128,11.619,28,28,463
2004,3132,1234,1460,114602,125022,70,4.636,170,11.258,5777,747,5030,0.597,4.621,27049,11306,15743,9.043,21.635,-21272,-17.015,9.242,117,119,2175
2004,3133,1315,1401,53764,56879,104,7.227,180,12.509,5257,2115,3142,3.718,9.243,11435,4308,7127,7.574,20.104,-6178,-10.862,18.485,131,134,1842
2004,3141,2432,2617,95299,97791,178,6.693,263,9.889,10362,5012,5350,5.125,10.596,15554,6764,8790,6.917,15.905,-5192,-5.309,21.192,193,194,1740
2004,3149,4479,4615,85102,86813,404,8.666,498,10.682,11850,3380,8470,3.893,13.65,15342,5477,9865,6.309,17.672,-3492,-4.022,27.3,393,394,4048
2004,3151,571,625,38420,41190,47,7.084,124,18.689,2617,784,1833,1.903,6.353,8130,2974,5156,7.22,19.738,-5513,-13.384,12.707,106,106,1690
2004,3152,7999,8188,205930,212457,1503,18.017,1811,21.709,41336,17395,23941,8.188,19.456,54858,28705,26153,13.511,25.821,-13522,-6.365,38.912,1583,1590,20786
2004,3159,1032,1065,23705,24986,86,7.825,154,14.013,2309,557,1752,2.229,9.241,4804,2132,2672,8.533,19.227,-2495,-9.986,18.482,116,116,1586
2004,3161,213,222,7699,8031,21,9.396,24,10.738,771,276,495,3.437,9.601,1395,199,1196,2.478,17.371,-624,-7.77,19.202,18,18,114
2004,3162,278,309,16156,16424,30,9.662,33,10.628,1571,550,1021,3.349,9.565,2135,251,1884,1.528,12.999,-564,-3.434,19.131,27,27,224
2004,3169,790,804,17265,17185,89,11.042,93,11.538,2577,1204,1373,7.006,14.996,2345,841,1504,4.894,13.646,232,1.35,27.292,78,80,731
2004,3211,3553,3971,112148,112282,293,7.349,325,8.151,11909,2704,9205,2.408,10.606,12129,4879,7250,4.345,10.802,-220,-0.196,21.213,229,230,2535
2004,3212,1467,1848,113046,112072,103,5.554,116,6.255,12284,2039,10245,1.819,10.961,10285,4334,5951,3.867,9.177,1999,1.784,18.354,68,68,1210
2004,3219,9324,10186,315086,311930,866,8.451,988,9.642,40985,10054,30931,3.223,13.139,34627,12976,21651,4.16,11.101,6358,2.038,22.202,742,743,6694
2004,3221,296,611,150535,153005,39,6.425,31,5.107,8127,1543,6584,1.008,5.312,12778,3061,9717,2.001,8.351,-4651,-3.04,10.623,8,8,1128
2004,3222,3114,4680,316782,323589,193,4.086,279,5.907,20244,5314,14930,1.642,6.256,33656,10936,22720,3.38,10.401,-13412,-4.145,12.512,157,159,2696
2004,3231,31691,33367,674829,686961,1930,5.696,2964,8.747,60335,13943,46392,2.03,8.783,84542,26354,58188,3.836,12.307,-24207,-3.524,17.566,2379,2398,17231
2004,3241,1045,2351,102019,100707,274,11.869,189,8.187,11487,5175,6312,5.139,11.406,8793,2603,6190,2.585,8.731,2694,2.675,17.463,52,52,541
2004,3251,1161,2328,170273,173202,126,5.412,126,5.412,10911,4010,6901,2.315,6.3,16602,2824,13778,1.63,9.585,-5691,-3.286,12.599,51,51,653
2004,3252,662,997,95339,97667,82,8.291,66,6.673,7766,4541,3225,4.649,7.952,12522,1902,10620,1.947,12.821,-4756,-4.87,15.903,36,37,584
2004,3253,621,874,31028,30796,74,8.457,76,8.686,3743,1432,2311,4.65,12.154,3240,774,2466,2.513,10.521,503,1.633,21.042,39,40,216
2004,3254,1361,1756,246595,248861,124,7.059,125,7.116,21412,5878,15534,2.362,8.604,26596,5846,20750,2.349,10.687,-5184,-2.083,17.208,73,74,1319
2004,3255,1488,1900,66450,67218,109,5.74,107,5.635,6151,1550,4601,2.306,9.151,7685,2001,5684,2.977,11.433,-1534,-2.282,18.302,75,75,1277
2004,3256,1955,2198,106751,109031,144,6.516,168,7.602,9251,2291,6960,2.101,8.485,13931,3816,10115,3.5,12.777,-4680,-4.292,16.97,113,114,1435
2004,3259,2123,2763,114150,114766,159,5.718,194,6.977,10131,1965,8166,1.712,8.828,11336,3564,7772,3.105,9.878,-1205,-1.05,17.655,111,111,901
2004,3261,9573,12103,731894,739725,568,4.654,773,6.333,67511,13241,54270,1.79,9.126,83452,24720,58732,3.342,11.281,-15941,-2.155,18.253,471,474,8214
2004,3262,1743,2248,164974,168907,99,4.362,142,6.257,10094,1514,8580,0.896,5.976,17911,3860,14051,2.285,10.604,-7817,-4.628,11.952,91,92,1117
2004,3271,1244,1447,56117,58380,101,6.861,151,10.258,4013,817,3196,1.399,6.874,8460,3138,5322,5.375,14.491,-4447,-7.617,13.748,107,111,1020
2004,3272,1735,2049,108587,109986,146,7.086,169,8.202,8316,1847,6469,1.679,7.561,10945,3791,7154,3.447,9.951,-2629,-2.39,15.122,114,114,792
2004,3273,4969,9133,211786,209748,447,4.88,499,5.448,27563,6047,21516,2.883,13.141,23355,6211,17144,2.961,11.135,4208,2.006,22.27,261,268,3104
2004,3274,222,340,18503,17489,23,6.735,26,7.613,3406,170,3236,0.972,19.476,1179,277,902,1.584,6.742,2227,12.734,13.483,19,19,121
2004,3279,2469,2878,73186,72815,282,9.926,208,7.321,9824,2991,6833,4.108,13.492,8947,2394,6553,3.288,12.287,877,1.204,24.575,134,134,940
2004,3311,489,605,108677,114028,124,20.946,98,16.554,12162,7875,4287,6.906,10.666,22356,12543,9813,11,19.606,-10194,-8.94,21.332,72,72,3730
2004,3312,506,647,46072,48241,50,7.502,89,13.353,3533,782,2751,1.621,7.324,7742,3543,4199,7.344,16.049,-4209,-8.725,14.647,50,52,1263
2004,3313,411,556,64488,65915,38,6.835,38,6.835,2474,477,1997,0.724,3.753,5322,1117,4205,1.695,8.074,-2848,-4.321,7.507,29,29,246
2004,3314,742,939,61333,62123,48,5.034,77,8.076,5608,2480,3128,3.992,9.027,7229,2646,4583,4.259,11.637,-1621,-2.609,18.055,40,41,878
2004,3315,1996,2257,164268,167750,105,4.563,193,8.388,11653,2178,9475,1.298,6.947,18603,6688,11915,3.987,11.09,-6950,-4.143,13.893,137,145,3232
2004,3321,2408,2656,120909,122130,93,3.462,153,5.696,10803,2231,8572,1.827,8.846,13200,3947,9253,3.232,10.808,-2397,-1.963,17.691,106,106,1313
2004,3322,1313,1441,56479,58878,82,5.624,116,7.956,3870,883,2987,1.5,6.573,8739,2387,6352,4.054,14.843,-4869,-8.27,13.146,73,73,484
2004,3323,11629,12545,370630,369137,704,5.541,1025,8.067,46685,9618,37067,2.606,12.647,43608,12868,30740,3.486,11.814,3077,0.834,23.627,764,768,7428
2004,3324,1257,1555,89628,89451,71,4.578,63,4.062,8378,1930,6448,2.158,9.366,8056,1681,6375,1.879,9.006,322,0.36,18.012,42,42,607
2004,3325,717,800,52806,54584,48,5.981,53,6.604,3620,899,2721,1.647,6.632,7054,1593,5461,2.918,12.923,-3434,-6.291,13.264,38,38,316
2004,3326,1638,1831,60261,60612,74,4.009,104,5.634,5493,1119,4374,1.846,9.063,6218,1811,4407,2.988,10.259,-725,-1.196,18.125,72,72,815
2004,3327,23133,23578,363566,361886,1280,5.369,1805,7.571,43960,8463,35497,2.339,12.147,40541,11750,28791,3.247,11.203,3419,0.945,22.405,1341,1345,7157
2004,3328,5379,5919,132508,134038,345,5.78,445,7.455,14903,3891,11012,2.903,11.119,17926,6127,11799,4.571,13.374,-3023,-2.255,22.237,302,316,3055
2004,3329,5681,6222,268141,271220,450,7.216,479,7.681,24811,4782,20029,1.763,9.148,31480,11502,19978,4.241,11.607,-6669,-2.459,18.296,338,339,4708
2004,3331,2478,2776,171982,172127,181,6.533,170,6.136,15429,3358,12071,1.951,8.964,16019,4930,11089,2.864,9.307,-590,-0.343,17.927,105,105,1287
2004,3332,3697,3912,138132,141595,256,6.483,330,8.357,13784,4221,9563,2.981,9.735,20643,7206,13437,5.089,14.579,-6859,-4.844,19.47,231,232,2108
2004,3333,2072,2230,105210,106015,147,6.519,197,8.736,9561,2063,7498,1.946,9.019,11163,2385,8778,2.25,10.53,-1602,-1.511,18.037,139,140,1491
2004,3334,1439,1732,147863,150669,101,5.791,125,7.167,11549,2462,9087,1.634,7.665,17646,4733,12913,3.141,11.712,-6097,-4.047,15.33,83,85,919
2004,3335,7864,8170,176563,180313,368,4.424,665,7.994,16747,3965,12782,2.199,9.288,24360,8825,15535,4.894,13.51,-7613,-4.222,18.576,483,487,4178
2004,3336,733,881,88671,90560,45,5.099,48,5.439,5150,261,4889,0.288,5.687,8881,1857,7024,2.051,9.807,-3731,-4.12,11.374,29,29,300
2004,3339,5483,6170,281025,284458,349,5.62,428,6.893,23447,7181,16266,2.524,8.243,30383,10768,19615,3.785,10.681,-6936,-2.438,16.485,284,289,4923
2004,3341,1303,1387,110955,118547,156,11.151,180,12.866,9110,2266,6844,1.911,7.685,24419,8790,15629,7.415,20.599,-15309,-12.914,15.369,136,138,2415
2004,3342,1577,1787,143164,149532,136,7.493,192,10.579,19308,4570,14738,3.056,12.912,32925,16601,16324,11.102,22.019,-13617,-9.106,25.825,110,110,3273
2004,3343,471,487,23144,23583,42,8.502,56,11.336,1998,387,1611,1.641,8.472,2871,694,2177,2.943,12.174,-873,-3.702,16.944,42,42,331
2004,3344,4199,4763,366754,375922,260,5.333,484,9.928,33222,7074,26148,1.882,8.837,51262,16899,34363,4.495,13.636,-18040,-4.799,17.675,318,324,6488
2004,3345,4297,4955,408256,404837,325,6.534,363,7.298,42429,10060,32369,2.485,10.481,34551,10965,23586,2.708,8.535,7878,1.946,17.069,235,239,2970
2004,3346,742,793,33395,34929,76,9.377,111,13.695,3350,1037,2313,2.969,9.591,6368,2875,3493,8.231,18.231,-3018,-8.64,19.182,85,85,707
2004,3351,1057,1155,60699,61669,76,6.529,94,8.076,4777,1373,3404,2.226,7.746,6758,1981,4777,3.212,10.959,-1981,-3.212,15.493,71,71,705
2004,3352,264,322,87960,89392,29,9.077,24,7.512,4531,112,4419,0.125,5.069,7158,618,6540,0.691,8.007,-2627,-2.939,10.137,17,17,153
2004,3353,2011,2351,137351,142071,127,5.322,198,8.297,10775,3787,6988,2.666,7.584,20139,6991,13148,4.921,14.175,-9364,-6.591,15.169,117,122,1465
2004,3359,1842,2168,152603,155424,151,6.935,170,7.807,14315,3115,11200,2.004,9.21,19970,7774,12196,5.002,12.849,-5655,-3.638,18.421,92,93,1150
2004,3361,284,357,214900,210955,41,11.731,26,7.439,26998,12085,14913,5.729,12.798,18718,6136,12582,2.909,8.873,8280,3.925,17.746,20,20,299
2004,3362,1812,2055,142669,138265,175,8.543,162,7.908,20901,4802,16099,3.473,15.117,12252,4366,7886,3.158,8.861,8649,6.255,17.723,125,126,2200
2004,3363,4336,5455,682666,685575,330,6.025,374,6.829,57672,12760,44912,1.861,8.412,62670,14018,48652,2.045,9.141,-4998,-0.729,16.824,235,250,4329
2004,3364,1161,1516,362385,368922,112,7.407,104,6.878,20221,6036,14185,1.636,5.481,33531,4584,28947,1.243,9.089,-13310,-3.608,10.962,68,70,1214
2004,3365,142,194,24852,25305,11,5.57,18,9.114,2737,532,2205,2.102,10.816,3636,1239,2397,4.896,14.369,-899,-3.553,21.632,11,11,656
2004,3366,1533,1656,140999,138371,159,9.593,162,9.774,14751,3017,11734,2.18,10.66,9378,3453,5925,2.495,6.777,5373,3.883,13.555,107,107,1640
2004,3369,738,769,39421,39192,109,14.333,92,12.097,4950,1392,3558,3.552,12.63,4555,1065,3490,2.717,11.622,395,1.008,23.245,69,69,521
2004,3371,14543,15048,363817,366434,1221,8.024,1560,10.251,41377,10055,31322,2.744,11.292,46014,16941,29073,4.623,12.557,-4637,-1.265,22.584,1175,1183,8290
2004,3372,3836,4033,150148,153081,246,6.019,354,8.662,14974,3602,11372,2.353,9.782,20723,5321,15402,3.476,13.537,-5749,-3.756,19.563,286,288,3256
2004,3379,909,1044,46936,46428,70,6.66,84,7.992,6149,1673,4476,3.603,13.244,5089,1611,3478,3.47,10.961,1060,2.283,21.922,66,66,628
2004,3391,10726,11447,298152,299232,800,7.01,730,6.397,32647,5748,26899,1.921,10.91,35019,10542,24477,3.523,11.703,-2372,-0.793,21.821,539,540,3796
2004,3399,17703,18185,393468,399176,1536,8.418,1660,9.097,43417,11637,31780,2.915,10.877,54594,14980,39614,3.753,13.677,-11177,-2.8,21.753,1309,1312,9440
2004,4231,17903,24211,362762,360587,1897,7.834,1905,7.867,42710,12820,29890,3.555,11.845,38169,11995,26174,3.327,10.585,4541,1.259,21.171,1207,1291,6494
2004,4232,11244,12792,161105,161722,1282,10.095,1097,8.638,21703,7248,14455,4.482,13.42,22937,6120,16817,3.784,14.183,-1234,-0.763,26.84,803,825,3537
2004,4233,11717,17076,244787,238563,1388,8.197,1103,6.514,36602,9251,27351,3.878,15.343,24133,8593,15540,3.602,10.116,12469,5.227,20.232,722,739,4360
2004,4234,25857,34630,702940,702144,4472,13.045,3777,11.017,117546,52755,64791,7.513,16.741,116994,40995,75999,5.839,16.662,552,0.079,33.325,2345,2437,16720
2004,4235,7356,9995,147125,147034,597,5.918,782,7.752,16767,3957,12810,2.691,11.403,16726,5273,11453,3.586,11.376,41,0.028,22.751,459,467,2700
2004,4236,20010,29202,474303,470245,2506,8.531,2855,9.719,84374,38683,45691,8.226,17.943,77543,30244,47299,6.432,16.49,6831,1.453,32.98,1463,1514,7776
2004,4237,11180,17994,216355,213377,1196,6.633,1269,7.038,28731,7216,21515,3.382,13.465,22749,8566,14183,4.015,10.661,5982,2.803,21.323,604,620,3301
2004,4238,43347,58055,688804,688974,3491,5.963,4476,7.645,82224,21708,60516,3.151,11.934,82354,31772,50582,4.611,11.953,-130,-0.019,23.869,2726,2903,18139
2004,4239,28611,31494,331466,327166,3567,11.359,3386,10.782,52906,16008,36898,4.893,16.171,44524,18192,26332,5.56,13.609,8382,2.562,27.218,2594,2641,12858
2004,4241,9576,12232,204582,210537,938,7.68,900,7.369,25231,10438,14793,4.958,11.984,36098,21743,14355,10.327,17.146,-10867,-5.162,23.968,593,604,3399
2004,4242,5683,7327,270842,261687,863,11.979,618,8.578,44416,12955,31461,4.951,16.973,26477,7913,18564,3.024,10.118,17939,6.855,20.236,451,456,3287
2004,4243,14075,15199,195350,196428,1788,11.761,1796,11.813,30031,9458,20573,4.815,15.289,32352,10772,21580,5.484,16.47,-2321,-1.182,30.577,1368,1385,6673
2004,4244,26310,32326,773051,767405,3044,9.442,2871,8.905,114074,31318,82756,4.081,14.865,102790,45915,56875,5.983,13.395,11284,1.47,26.789,2119,2140,15455
2004,4245,4254,6786,64539,64765,336,4.899,481,7.013,8193,2418,5775,3.733,12.65,8746,2489,6257,3.843,13.504,-553,-0.854,25.301,279,289,1255
2004,4246,8672,12179,143870,145329,739,6.008,981,7.976,18857,6116,12741,4.208,12.975,21757,6921,14836,4.762,14.971,-2900,-1.995,25.951,556,568,2747
2004,4247,5196,7267,107224,106782,450,6.078,723,9.766,16806,6457,10349,6.047,15.739,15890,6420,9470,6.012,14.881,916,0.858,29.762,369,389,2514
2004,4248,3242,4042,170641,168498,287,7.14,242,6.021,16808,4975,11833,2.953,9.975,12694,4103,8591,2.435,7.534,4114,2.442,15.067,184,195,2766
2004,4249,23411,29182,384463,381792,2973,10.177,3033,10.383,58761,19225,39536,5.035,15.391,54087,19165,34922,5.02,14.167,4674,1.224,28.333,2234,2274,11374
2004,4251,32162,34079,271999,270974,3955,11.717,3306,9.794,43599,14465,29134,5.338,16.09,41046,16435,24611,6.065,15.148,2553,0.942,30.295,2304,2324,7829
2004,4411,44022,48330,1298780,1293384,4648,9.652,4296,8.921,137328,48576,88752,3.756,10.618,126401,45310,81091,3.503,9.773,10927,0.845,19.546,3403,3454,33511
2004,4412,13392,14844,160289,154099,1590,10.798,1352,9.182,30065,9521,20544,6.179,19.51,17568,7449,10119,4.834,11.401,12497,8.11,22.801,1067,1096,5954
2004,4413,32276,55994,492350,488736,3889,6.955,3735,6.68,67371,21151,46220,4.328,13.785,60623,19875,40748,4.067,12.404,6748,1.381,24.808,2481,2638,12193
2004,4421,19115,26590,271347,269053,2637,9.959,2416,9.124,43710,17344,26366,6.446,16.246,38906,15427,23479,5.734,14.46,4804,1.786,28.921,1668,1876,11984
2004,4422,25455,34361,305962,302083,3341,9.736,3250,9.471,56089,19820,36269,6.561,18.567,47586,16857,30729,5.58,15.753,8503,2.815,31.505,2216,2300,8708
2004,4431,30526,49590,500110,486205,5827,11.691,6327,12.695,97141,29652,67489,6.099,19.979,69878,33473,36405,6.885,14.372,27263,5.607,28.744,3869,4130,16566
2004,4441,44709,64255,1078830,1059928,4122,6.408,4273,6.642,114396,36762,77634,3.468,10.793,76663,25814,50849,2.435,7.233,37733,3.56,14.466,2943,3187,16874
2004,4442,15618,18883,173730,173218,1370,7.214,1587,8.356,26015,6495,19520,3.75,15.019,25203,7274,17929,4.199,14.55,812,0.469,29.1,1115,1149,4967
2004,4451,61207,88141,2652534,2612629,10345,11.831,8942,10.226,357564,132021,225543,5.053,13.686,274716,88585,186131,3.391,10.515,82848,3.171,21.03,6577,6717,39116
2004,4452,17385,22007,150689,149759,3709,16.933,3504,15.997,36033,18287,17746,12.211,24.061,34405,16193,18212,10.813,22.974,1628,1.087,45.947,2542,2587,11877
2004,4453,23695,27023,143793,141823,2807,10.485,2306,8.613,25678,9935,15743,7.005,18.106,21867,7922,13945,5.586,15.419,3811,2.687,30.837,1843,1857,6434
2004,4461,40070,79791,1033456,995761,6941,8.766,5713,7.215,189293,62855,126438,6.312,19.01,116446,44307,72139,4.45,11.694,72847,7.316,23.388,3075,3157,15474
2004,4471,61806,111375,932033,933943,8791,7.832,10527,9.379,156423,52344,104079,5.605,16.749,160505,66525,93980,7.123,17.186,-4082,-0.437,33.497,5665,6682,40725
2004,4481,35117,85877,1184723,1143906,9329,10.934,8216,9.63,224214,71396,152818,6.241,19.601,141359,50665,90694,4.429,12.358,82855,7.243,24.715,4177,4791,20505
2004,4482,6154,26463,196796,193780,1679,6.327,1823,6.87,35832,9159,26673,4.726,18.491,29733,7948,21785,4.102,15.344,6099,3.147,30.687,588,693,2770
2004,4483,18544,28331,165308,164255,2373,8.392,2267,8.017,25689,8597,17092,5.234,15.64,23395,8037,15358,4.893,14.243,2294,1.397,28.486,1429,1479,4327
2004,4511,28106,38259,410708,407743,3859,10.054,4103,10.69,59022,24076,34946,5.905,14.475,53542,19008,34534,4.662,13.131,5480,1.344,26.263,2810,2888,10751
2004,4512,6299,11827,146544,144571,968,8.106,1198,10.032,23291,10399,12892,7.193,16.11,18863,5954,12909,4.118,13.048,4428,3.063,26.095,748,754,3109
2004,4522,128,5197,740196,757134,173,3.209,561,10.406,44995,15822,29173,2.09,5.943,76294,27429,48865,3.623,10.077,-31299,-4.134,11.886,55,69,1374
2004,4523,8740,35892,1996687,1913860,3986,11.361,2372,6.761,266564,62158,204406,3.248,13.928,104204,34378,69826,1.796,5.445,162360,8.483,10.889,1123,1157,5159
2004,4531,18969,19840,109714,111589,1715,8.528,2255,11.213,17731,6007,11724,5.383,15.89,21516,7088,14428,6.352,19.281,-3785,-3.392,31.779,1835,1849,5759
2004,4532,27490,38621,324882,326138,4203,10.781,4929,12.644,51190,19841,31349,6.084,15.696,53868,23331,30537,7.154,16.517,-2678,-0.821,31.392,3571,3783,14587
2004,4533,12213,16376,127429,127500,1566,9.525,1696,10.316,17613,6759,10854,5.301,13.814,17926,5636,12290,4.42,14.06,-313,-0.245,27.628,1336,1361,4045
2004,4539,31597,40013,255454,255435,4884,12.163,5165,12.863,47863,20545,27318,8.043,18.738,47886,18234,29652,7.138,18.747,-23,-0.009,37.476,3436,3996,12980
2004,4541,13784,14689,269135,270467,2143,14.854,1620,11.229,51106,19708,31398,7.287,18.896,52930,22578,30352,8.348,19.57,-1824,-0.674,37.791,1145,1155,8305
2004,4542,4408,5009,54969,58502,515,10.17,625,12.342,6837,2584,4253,4.417,11.687,14197,3290,10907,5.624,24.268,-7360,-12.581,23.374,455,456,2019
2004,4543,22874,28729,234163,237661,2411,8.371,2555,8.871,29245,8300,20945,3.492,12.305,36385,14916,21469,6.276,15.31,-7140,-3.004,24.611,1671,1688,7914
2004,4811,589,3167,438159,460327,446,14.309,346,11.1,37176,18829,18347,4.09,8.076,81725,22233,59492,4.83,17.754,-44549,-9.678,16.152,63,66,738
2004,4812,1905,2076,37829,36794,324,15.914,244,11.984,6032,1696,4336,4.609,16.394,4037,1487,2550,4.041,10.972,1995,5.422,21.944,188,193,1242
2004,4831,783,1137,46676,47916,98,8.434,148,12.737,6242,1995,4247,4.164,13.027,8482,3275,5207,6.835,17.702,-2240,-4.675,26.054,77,88,527
2004,4832,451,509,19327,19491,49,9.441,69,13.295,2077,327,1750,1.678,10.656,2465,502,1963,2.576,12.647,-388,-1.991,21.313,53,53,431
2004,4841,42871,52243,1000411,985391,8953,17.295,7998,15.45,155933,62418,93515,6.334,15.824,124858,46796,78062,4.749,12.671,31075,3.154,25.342,5986,6065,30032
2004,4842,41585,44955,449081,446667,5639,12.472,6153,13.609,81420,27554,53866,6.169,18.228,76281,27475,48806,6.151,17.078,5139,1.151,34.156,4478,4536,19460
2004,4851,627,887,48662,48137,73,8.125,96,10.684,5832,788,5044,1.637,12.115,4987,2626,2361,5.455,10.36,845,1.755,20.72,56,56,627
2004,4852,203,493,18210,17999,63,12.818,60,12.208,2403,950,1453,5.278,13.351,1972,742,1230,4.123,10.956,431,2.395,21.913,31,33,485
2004,4853,5834,5966,64132,64351,860,14.385,885,14.803,11490,4486,7004,6.971,17.855,11897,5072,6825,7.882,18.488,-407,-0.632,35.711,728,728,4391
2004,4854,3004,4164,180699,180622,221,5.259,297,7.068,21046,6580,14466,3.643,11.652,21043,8900,12143,4.927,11.65,3,0.002,23.301,187,187,2722
2004,4855,1043,1155,29993,29678,110,9.41,138,11.805,5284,879,4405,2.962,17.805,4598,1942,2656,6.544,15.493,686,2.312,30.986,107,111,1199
2004,4859,2526,2763,57685,56981,415,15.009,419,15.154,10895,3558,7337,6.244,19.12,9314,4415,4899,7.748,16.346,1581,2.775,32.692,328,329,3402
2004,4861,58,331,6354,6264,58,18.77,14,4.531,715,363,352,5.795,11.414,555,82,473,1.309,8.86,160,2.554,17.72,(D),(D),(D)
2004,4862,132,1635,25279,26577,371,21.014,632,35.797,7849,4921,2928,18.516,29.533,10488,6955,3533,26.169,39.463,-2639,-9.93,59.066,7,14,234
2004,4869,56,536,6008,5975,76,14.587,46,8.829,1184,923,261,15.449,19.818,1111,733,378,12.269,18.596,73,1.222,37.191,3,3,170
2004,4871,441,492,8694,8937,68,13.821,68,13.821,1163,520,643,5.819,13.013,1628,760,868,8.504,18.216,-465,-5.203,26.027,43,44,293
2004,4872,1162,1195,11431,11440,187,15.544,203,16.874,2019,775,1244,6.774,17.649,2029,962,1067,8.409,17.736,-10,-0.087,35.297,139,139,717
2004,4879,123,126,2025,1863,10,7.722,17,13.127,503,192,311,10.309,27.007,165,38,127,2.04,8.859,338,18.148,17.718,8,8,17
2004,4881,3384,4813,145877,139228,549,11.543,435,9.146,30413,17769,12644,12.763,21.844,16422,5720,10702,4.108,11.795,13991,10.049,23.59,287,295,2647
2004,4882,438,876,26644,26207,73,8.314,77,8.77,3853,1264,2589,4.823,14.702,2863,1184,1679,4.518,10.925,990,3.778,21.85,39,47,756
2004,4883,1632,2141,83251,81679,160,7.431,184,8.546,12238,2543,9695,3.113,14.983,9202,2382,6820,2.916,11.266,3036,3.717,22.532,115,118,1429
2004,4884,7230,7658,64776,62038,1206,16.077,893,11.904,17237,9183,8054,14.802,27.785,11592,4819,6773,7.768,18.685,5645,9.099,37.371,693,697,3269
2004,4885,11559,16069,179262,176494,1824,11.518,1359,8.581,29159,11522,17637,6.528,16.521,23481,9944,13537,5.634,13.304,5678,3.217,26.608,890,930,4703
2004,4889,1149,1267,21814,21294,278,22.9,172,14.168,4141,1415,2726,6.645,19.447,3103,832,2271,3.907,14.572,1038,4.875,29.144,144,144,727
2004,4921,2833,8496,531820,500545,822,9.607,942,11.01,102275,25521,76754,5.099,20.433,42498,26751,15747,5.344,8.49,59777,11.942,16.981,399,408,1953
2004,4922,4072,4555,52604,51255,587,12.79,656,14.293,13413,2885,10528,5.629,26.169,10878,3477,7401,6.784,21.223,2535,4.946,42.447,537,539,2841
2004,4931,6797,12896,578696,564755,1711,13.657,975,7.783,100561,43177,57384,7.645,17.806,72865,22050,50815,3.904,12.902,27696,4.904,25.804,395,406,3629
2004,5111,15032,20715,704354,703642,2035,9.854,1909,9.244,74290,25244,49046,3.588,10.558,72307,22209,50098,3.156,10.276,1983,0.282,20.552,1223,1261,8475
2004,5112,6044,8479,328107,332103,937,10.919,1142,13.308,41027,13260,27767,3.993,12.354,49080,19629,29451,5.911,14.779,-8053,-2.425,24.707,599,638,8253
2004,5121,11940,15399,284235,281970,2113,13.648,2280,14.726,55620,19986,35634,7.088,19.726,50755,21085,29670,7.478,18,4865,1.725,36,1271,1292,5909
2004,5122,2589,2874,25396,25995,416,14.566,380,13.305,3325,1444,1881,5.555,12.791,4533,1505,3028,5.79,17.438,-1208,-4.647,25.582,280,281,839
2004,5151,4534,8967,244005,247976,783,8.628,999,11.008,28716,10242,18474,4.13,11.58,36734,11530,25204,4.65,14.814,-8018,-3.233,23.16,372,388,4001
2004,5152,335,859,43370,43629,384,44.214,403,46.402,16188,8508,7680,19.501,37.104,16318,15125,1193,34.668,37.402,-130,-0.298,74.208,36,36,859
2004,5173,6809,44162,1293120,1343757,6858,15.617,6361,14.485,233593,62752,170841,4.67,17.384,332182,100529,231653,7.481,24.72,-98589,-7.337,34.767,996,1160,12721
2004,5174,425,556,12934,13499,108,19.338,113,20.233,2216,1331,885,9.86,16.416,3336,1146,2190,8.49,24.713,-1120,-8.297,32.832,67,67,420
2004,5179,5024,5817,69503,73461,1397,23.526,1639,27.602,17770,7572,10198,10.308,24.19,25581,12964,12617,17.647,34.823,-7811,-10.633,48.379,1200,1207,6326
2004,5182,7058,13235,380742,394094,2706,20.868,2171,16.742,80481,40094,40387,10.174,20.422,106969,51490,55479,13.065,27.143,-26488,-6.721,40.844,534,546,4257
2004,5191,4591,5530,98001,96644,697,12.943,407,7.558,15066,3600,11466,3.725,15.589,12060,2856,9204,2.955,12.479,3006,3.11,24.958,255,266,1530
2004,5211,19,58,21533,21896,6,10.714,(D),(D),675,458,217,2.092,3.083,1428,(D),1423,(D),6.522,-753,-3.439,6.166,(D),(D),(D)
2004,5221,16551,114605,2090491,2092249,6401,5.604,5619,4.92,290803,79653,211150,3.807,13.899,297406,89005,208401,4.254,14.215,-6603,-0.316,27.798,509,658,6522
2004,5222,18838,49768,759113,742429,9352,19.114,7673,15.682,209064,115990,93074,15.623,28.159,176726,87663,89063,11.808,23.804,32338,4.356,47.608,1827,1911,9768
2004,5223,22691,35103,318388,313441,6854,20.652,3023,9.109,83055,37995,45060,12.122,26.498,72088,29560,42528,9.431,22.999,10967,3.499,45.998,1808,1876,9630
2004,5231,12109,38347,512707,518562,6914,17.034,11397,28.079,142968,52622,90346,10.148,27.57,153261,79396,73865,15.311,29.555,-10293,-1.985,55.14,1002,1031,4565
2004,5232,47,54,7042,7037,18,31.304,25,43.478,590,261,329,3.709,8.384,569,122,447,1.734,8.086,21,0.298,16.172,19,19,99
2004,5239,31235,35144,341474,351726,6191,18.083,4376,12.782,62595,29826,32769,8.48,17.797,84709,48006,36703,13.649,24.084,-22114,-6.287,35.593,3013,3031,15600
2004,5241,5906,31314,1499578,1506739,5051,16.521,3568,11.671,189002,76761,112241,5.095,12.544,204275,75668,128607,5.022,13.557,-15273,-1.014,25.088,371,397,6807
2004,5242,116460,129220,883338,876729,11792,9.168,10602,8.243,131261,48221,83040,5.5,14.972,118329,47905,70424,5.464,13.497,12932,1.475,26.993,7174,7367,25041
2004,5259,890,933,6570,6709,213,23.089,192,20.813,2022,651,1371,9.704,30.141,2230,1453,777,21.659,33.241,-208,-3.101,60.282,151,151,854
2004,5311,87374,104966,555105,548836,10352,9.903,9495,9.083,96405,40063,56342,7.3,17.565,83751,37863,45888,6.899,15.26,12654,2.306,30.52,7173,7381,28266
2004,5312,63726,71662,319471,309620,12485,18.035,7615,11,69974,33469,36505,10.81,22.6,50657,22709,27948,7.334,16.361,19317,6.239,32.722,4914,5045,14706
2004,5313,55619,62125,584189,575998,9824,16.202,6844,11.287,106481,48147,58334,8.359,18.486,89763,38323,51440,6.653,15.584,16718,2.902,31.168,4376,4587,23979
2004,5321,4150,10498,167291,168322,1254,11.989,1177,11.253,16756,7317,9439,4.347,9.955,18609,8121,10488,4.825,11.056,-1853,-1.101,19.909,505,563,3003
2004,5322,12402,31722,259539,265388,2917,9.25,2544,8.067,42723,16036,26687,6.042,16.098,52479,14598,37881,5.501,19.774,-9756,-3.676,32.197,1326,1726,7849
2004,5323,3269,5025,33044,32982,502,10.128,365,7.364,5836,1951,3885,5.915,17.695,5681,1624,4057,4.924,17.225,155,0.47,34.45,234,241,986
2004,5324,7334,12375,154545,151973,1719,14.138,1286,10.577,31229,10848,20381,7.138,20.549,26348,10834,15514,7.129,17.337,4881,3.212,34.675,644,661,3272
2004,5331,2052,2140,31420,29434,317,15.149,222,10.609,7722,3006,4716,10.213,26.235,3666,1346,2320,4.573,12.455,4056,13.78,24.91,152,153,997
2004,5411,160437,168979,1215235,1204183,15091,9.003,12393,7.393,160126,52045,108081,4.322,13.297,138034,49089,88945,4.077,11.463,22092,1.835,22.926,9015,9145,31306
2004,5412,91135,104195,1226400,1224784,11063,10.702,9414,9.107,238725,78164,160561,6.382,19.491,235772,92482,143290,7.551,19.25,2953,0.241,38.5,5814,5903,46065
2004,5413,84082,96478,1262341,1257171,10017,10.433,9080,9.457,194113,66407,127706,5.282,15.44,183169,73542,109627,5.85,14.57,10944,0.871,29.14,5690,5783,26267
2004,5414,25737,26014,118746,118725,3659,14.048,3724,14.298,22584,9100,13484,7.665,19.022,22549,9974,12575,8.401,18.993,35,0.029,37.985,2648,2657,7103
2004,5415,73731,84406,1104628,1098167,16499,19.579,16223,19.252,223405,94247,129158,8.582,20.343,211927,92107,119820,8.387,19.298,11478,1.045,38.597,10559,10648,46007
2004,5416,84675,90602,758595,749332,17736,19.865,15093,16.905,171443,76268,95175,10.178,22.879,154265,62720,91545,8.37,20.587,17178,2.292,41.174,10469,10531,39147
2004,5417,10733,14057,626231,616293,2044,14.858,1443,10.49,89982,22368,67614,3.629,14.601,70605,21106,49499,3.425,11.456,19377,3.144,22.913,874,893,7414
2004,5418,30121,33481,390171,397300,3773,11.258,3838,11.452,64260,19272,44988,4.851,16.174,79764,22861,56903,5.754,20.077,-15504,-3.902,32.348,2843,2860,14662
2004,5419,52634,60802,544413,541791,7264,12.049,6235,10.342,90159,30953,59206,5.713,16.641,84489,35181,49308,6.493,15.594,5670,1.047,31.189,4321,4366,25151
2004,5511,26182,46779,2786480,2821977,4197,8.96,4321,9.225,436035,150743,285292,5.342,15.451,504507,172077,332430,6.098,17.878,-68472,-2.426,30.903,1153,1215,21726
2004,5611,19923,21814,439450,427174,4687,22.348,3004,14.324,104236,48136,56100,11.268,24.401,79714,38073,41641,8.913,18.661,24522,5.741,37.322,1927,1947,24109
2004,5612,1640,3939,164835,154164,1118,31.462,347,9.765,44381,23031,21350,14.939,28.788,24039,11159,12880,7.238,15.593,20342,13.195,31.186,137,160,3386
2004,5613,26466,43370,3851177,3820978,6480,14.888,6789,15.598,981827,249063,732764,6.518,25.696,934314,290510,643804,7.603,24.452,47513,1.243,48.904,3261,3494,128637
2004,5614,26389,31917,776975,767286,4213,13.279,3832,12.078,152702,57437,95265,7.486,19.902,132869,54325,78544,7.08,17.317,19833,2.585,34.634,2775,2856,25625
2004,5615,16617,22533,263096,271429,1818,7.824,3224,13.875,32979,10876,22103,4.007,12.15,49919,16995,32924,6.261,18.391,-16940,-6.241,24.3,1916,1980,8372
2004,5616,16816,21269,740155,738705,2481,11.716,2296,10.842,125882,29849,96033,4.041,17.041,121651,37448,84203,5.069,16.468,4231,0.573,32.936,1553,1619,21519
2004,5617,124703,130732,1596464,1580238,20242,15.571,18770,14.439,309134,93515,215619,5.918,19.562,278266,110770,167496,7.01,17.609,30868,1.953,35.218,12564,12596,64805
2004,5619,16687,18786,344737,348193,2021,10.733,2108,11.195,56209,17057,39152,4.899,16.143,62163,19704,42459,5.659,17.853,-5954,-1.71,32.286,1439,1455,10475
2004,5621,6339,8164,179005,177437,777,9.596,643,7.941,20015,6563,13452,3.699,11.28,16807,5509,11298,3.105,9.472,3208,1.808,18.944,481,486,3505
2004,5622,1451,2454,55484,54884,221,9.05,197,8.067,7700,2716,4984,4.949,14.03,6566,2558,4008,4.661,11.964,1134,2.066,23.927,116,118,827
2004,5629,6377,7024,110375,107385,753,10.782,673,9.636,26171,7256,18915,6.757,24.371,20555,5161,15394,4.806,19.141,5616,5.23,38.283,454,461,3125
2004,6111,17953,20048,809317,803263,1023,5.135,768,3.855,65501,14065,51436,1.751,8.154,53228,12668,40560,1.577,6.626,12273,1.528,13.253,548,549,10126
2004,6112,548,879,92775,91351,71,8.237,37,4.292,11451,3124,8327,3.42,12.535,8627,2769,5858,3.031,9.444,2824,3.091,18.888,24,25,2245
2004,6113,2426,3309,1505140,1472255,219,6.7,138,4.222,113487,8908,104579,0.605,7.708,47485,6575,40910,0.447,3.225,66002,4.483,6.451,82,83,5696
2004,6114,5948,6486,62886,63579,854,13.05,970,14.823,11302,4286,7016,6.741,17.776,12710,4585,8125,7.212,19.991,-1408,-2.215,35.553,658,669,2846
2004,6115,5850,6936,99480,97286,805,11.716,675,9.824,19683,6869,12814,7.061,20.232,15271,5971,9300,6.138,15.697,4412,4.535,31.394,466,486,3970
2004,6116,26058,27977,253684,245011,4117,15.068,2808,10.277,56040,19463,36577,7.944,22.872,38635,12948,25687,5.285,15.769,17405,7.104,31.537,2035,2055,9242
2004,6117,4214,4678,56001,52863,800,17.567,552,12.121,13477,4877,8600,9.226,25.494,7124,2641,4483,4.996,13.476,6353,12.018,26.953,381,382,1482
2004,6211,170203,193824,2037552,2004912,15997,8.312,13268,6.894,290321,87376,202945,4.358,14.48,225412,70384,155028,3.511,11.243,64909,3.237,22.486,9453,9665,44169
2004,6212,110557,115366,802335,787508,6275,5.483,4452,3.89,112622,31036,81586,3.941,14.301,83198,20684,62514,2.627,10.565,29424,3.736,21.129,3586,3667,16698
2004,6213,92069,101132,546739,531099,11961,12.091,7549,7.631,109054,41684,67370,7.849,20.534,78209,28167,50042,5.304,14.726,30845,5.808,29.452,5496,5563,20038
2004,6214,12372,24835,640915,632474,1887,7.662,1476,5.993,79609,22692,56917,3.588,12.587,62455,22332,40123,3.531,9.875,17154,2.712,19.749,713,779,7439
2004,6215,6664,10188,212985,208956,1382,13.804,1029,10.278,32620,12856,19764,6.152,15.611,24562,9595,14967,4.592,11.755,8058,3.856,23.509,572,593,4439
2004,6216,12042,17290,862636,831897,2793,16.637,1788,10.651,153865,45455,108410,5.464,18.496,93209,30004,63205,3.607,11.204,60656,7.291,22.409,1204,1257,17253
2004,6219,5416,8277,232323,227373,779,9.405,791,9.55,37162,9904,27258,4.356,16.344,27150,11112,16038,4.887,11.941,10012,4.403,23.882,407,479,5171
2004,6221,3278,5360,4815870,4793916,178,3.331,146,2.732,219647,20996,198651,0.438,4.582,176026,53983,122043,1.126,3.672,43621,0.91,7.344,50,50,13605
2004,6222,511,653,214798,214706,52,8.068,35,5.431,9106,3788,5318,1.764,4.241,8977,4178,4799,1.946,4.181,129,0.06,8.362,21,22,2889
2004,6223,457,794,196867,191879,164,22.267,49,6.653,19344,8424,10920,4.39,10.081,9844,2604,7240,1.357,5.13,9500,4.951,10.261,26,26,795
2004,6231,8525,15916,1612502,1610717,1024,6.446,962,6.056,151896,63589,88307,3.948,9.43,148260,61985,86275,3.848,9.205,3636,0.226,18.409,457,491,30767
2004,6232,7940,28807,529741,522632,2061,7.271,1136,4.008,67659,22249,45410,4.257,12.946,53939,12673,41266,2.425,10.321,13720,2.625,20.641,388,480,5964
2004,6233,12754,17022,604698,600429,1764,10.376,1721,10.123,72196,28814,43382,4.799,12.024,63945,27360,36585,4.557,10.65,8251,1.374,21.3,1188,1218,16016
2004,6239,3498,6084,156669,157449,468,7.773,341,5.664,18069,6013,12056,3.819,11.476,19559,5399,14160,3.429,12.422,-1490,-0.946,22.952,175,184,2308
2004,6241,35594,49475,971417,954460,4330,8.855,3179,6.501,143585,46029,97556,4.823,15.044,108264,23686,84578,2.482,11.343,35321,3.701,22.686,1888,1979,13096
2004,6242,9169,12423,151858,152367,647,5.236,513,4.152,16118,3802,12316,2.495,10.578,17099,2976,14123,1.953,11.222,-981,-0.644,21.157,292,299,1520
2004,6243,4951,7919,322310,323934,427,5.348,558,6.989,43237,9421,33816,2.908,13.347,46537,8206,38331,2.533,14.366,-3300,-1.019,26.695,227,250,2260
2004,6244,52223,65478,779420,777449,6964,10.678,6447,9.885,114290,41398,72892,5.325,14.701,110435,38562,71873,4.96,14.205,3855,0.496,28.41,4695,4761,27585
2004,7111,7392,7552,126992,129476,803,10.511,978,12.802,21522,6639,14883,5.128,16.622,26919,7344,19575,5.672,20.791,-5397,-4.168,33.245,631,635,4732
2004,7112,3170,3330,111757,111676,520,15.541,552,16.497,18967,3898,15069,3.49,16.984,18776,6821,11955,6.108,16.813,191,0.171,33.626,405,405,3131
2004,7113,4333,4650,103687,101038,629,13.684,522,11.356,22908,7394,15514,7.318,22.673,17859,5880,11979,5.82,17.676,5049,4.997,35.351,359,359,2654
2004,7114,2612,2681,16170,16173,402,15.008,397,14.822,3101,1490,1611,9.213,19.175,3087,1540,1547,9.522,19.088,14,0.087,38.176,293,293,904
2004,7115,11563,11583,43827,44085,2398,20.951,2123,18.549,13894,6477,7417,14.692,31.516,14598,6292,8306,14.272,33.113,-704,-1.597,63.033,1280,1280,3232
2004,7121,5840,6271,118947,119557,416,6.669,350,5.611,9130,1156,7974,0.967,7.637,10332,2032,8300,1.7,8.642,-1202,-1.005,15.273,210,210,1544
2004,7131,1742,2321,138093,136197,319,13.432,427,17.979,20152,5175,14977,3.8,14.796,16873,4703,12170,3.453,12.389,3279,2.408,24.777,243,246,2534
2004,7132,1611,2080,171445,167695,258,12.625,185,9.053,22383,6259,16124,3.732,13.347,14975,5835,9140,3.48,8.93,7408,4.418,17.86,155,156,2794
2004,7139,48739,53922,1055527,1039694,7431,14.059,5295,10.018,163915,60074,103841,5.778,15.766,131944,41553,90391,3.997,12.691,31971,3.075,25.381,3869,3898,30094
2004,7211,36330,46311,1780072,1765871,4575,9.886,4509,9.743,221957,92389,129568,5.232,12.569,193972,75640,118332,4.283,10.984,27985,1.585,21.969,3012,3077,41963
2004,7212,4987,5436,37813,37858,451,8.148,649,11.725,6575,1696,4879,4.48,17.368,6759,2469,4290,6.522,17.854,-184,-0.486,34.736,384,413,1706
2004,7213,2225,2294,13581,13546,130,5.519,253,10.741,2230,435,1795,3.211,16.463,2115,1011,1104,7.464,15.614,115,0.849,31.228,185,185,852
2004,7223,11155,27925,525971,541334,4966,17.863,4716,16.964,118937,62134,56803,11.478,21.971,155515,59600,95915,11.01,28.728,-36578,-6.757,43.942,1325,1342,9470
2004,7224,42171,42722,358268,355771,4944,11.45,5856,13.562,78591,38262,40329,10.755,22.09,73775,32244,41531,9.063,20.737,4816,1.354,41.473,4824,4828,26781
2004,7225,291225,397889,8024408,7886736,51081,12.991,41713,10.608,1438049,685588,752461,8.693,18.234,1164553,448152,716401,5.682,14.766,273496,3.468,29.532,31440,32439,304619
2004,8111,139672,152431,899445,897403,14267,9.356,14375,9.427,149859,54279,95580,6.048,16.699,145772,54235,91537,6.044,16.244,4087,0.455,32.488,11142,11269,41988
2004,8112,11115,12597,130014,130706,1228,9.617,1571,12.304,21650,6631,15019,5.073,16.564,22883,8869,14014,6.785,17.507,-1233,-0.943,33.128,1150,1154,4028
2004,8113,20597,21907,178100,177179,2114,9.622,2242,10.204,32997,12233,20764,6.904,18.624,31685,12907,18778,7.285,17.883,1312,0.74,35.766,1664,1668,6590
2004,8114,20449,21612,108515,108820,2521,11.567,2886,13.242,16915,6258,10657,5.751,15.544,17537,8609,8928,7.911,16.116,-622,-0.572,31.088,2175,2181,5807
2004,8121,79316,92773,581041,567048,12476,13.605,10335,11.27,120449,53583,66866,9.449,21.241,92594,39823,52771,7.023,16.329,27855,4.912,32.658,8232,8383,29216
2004,8122,14739,20788,145378,145428,804,3.848,1020,4.881,13727,3599,10128,2.475,9.439,13864,4115,9749,2.83,9.533,-137,-0.094,18.878,522,584,1917
2004,8123,32033,38691,380242,379063,4258,11.036,4039,10.469,62791,28244,34547,7.451,16.565,61004,20263,40741,5.346,16.093,1787,0.471,32.187,3155,3233,13446
2004,8129,21200,32652,234967,233535,5593,17.38,4649,14.447,56864,26552,30312,11.37,24.349,54183,24263,29920,10.389,23.201,2681,1.148,46.403,3018,3071,13736
2004,8131,167972,168200,1656383,1656145,8037,4.795,6872,4.1,162671,24150,138521,1.458,9.822,160749,38098,122651,2.3,9.706,1922,0.116,19.412,4555,4558,13121
2004,8132,12261,14222,142817,143156,1098,7.769,922,6.523,16376,4977,11399,3.477,11.439,16943,4312,12631,3.012,11.835,-567,-0.396,22.879,638,649,2294
2004,8133,10144,12309,115203,113037,1126,9.241,878,7.206,17969,6212,11757,5.496,15.897,13751,3133,10618,2.772,12.165,4218,3.732,24.33,545,551,2055
2004,8134,27755,29800,318688,320016,1408,4.707,1630,5.45,33911,5574,28337,1.742,10.597,36477,6611,29866,2.066,11.399,-2566,-0.802,21.193,1144,1154,4068
2004,8139,59497,61415,528933,526162,2926,4.746,3410,5.531,67149,13826,53323,2.628,12.762,61099,13543,47556,2.574,11.612,6050,1.15,23.224,2261,2277,9258
2005,1131,337,387,4417,4424,49,12.827,39,10.209,491,140,351,3.165,11.1,492,109,383,2.464,11.122,-1,-0.023,22.2,25,25,51
2005,1132,133,186,1727,1720,27,14.754,21,11.475,404,174,230,10.116,23.488,397,130,267,7.558,23.081,7,0.407,46.163,17,17,27
2005,1133,9084,9164,63575,65112,1032,11.186,1155,12.52,10560,3306,7254,5.077,16.218,13707,4503,9204,6.916,21.051,-3147,-4.833,32.436,850,853,3527
2005,1141,1157,1170,5479,5684,181,15.255,214,18.036,935,411,524,7.231,16.45,1320,562,758,9.887,23.223,-385,-6.773,32.899,135,135,371
2005,1142,267,267,1665,1696,40,15.123,35,13.233,231,77,154,4.54,13.62,291,107,184,6.309,17.158,-60,-3.538,27.241,31,31,98
2005,1151,3441,3764,57360,57011,437,11.613,435,11.56,10938,3592,7346,6.301,19.186,10180,3009,7171,5.278,17.856,758,1.33,35.713,282,282,1863
2005,1152,3501,3567,18652,18527,578,16.505,448,12.793,3347,1553,1794,8.382,18.066,3122,1115,2007,6.018,16.851,225,1.214,33.702,345,345,833
2005,1153,1258,1305,14447,14375,205,16.047,150,11.742,2722,866,1856,6.025,18.936,2591,565,2026,3.931,18.025,131,0.911,36.05,95,95,407
2005,2111,5549,6624,83450,82842,625,9.493,545,8.278,15703,4254,11449,5.135,18.955,14604,5889,8715,7.109,17.629,1099,1.327,35.258,314,318,1398
2005,2121,617,1021,74078,72024,119,11.65,120,11.747,12503,5581,6922,7.749,17.359,8413,1996,6417,2.771,11.681,4090,5.679,23.362,60,62,990
2005,2122,191,260,26257,25073,40,15.534,35,13.592,3595,1899,1696,7.574,14.338,1286,746,540,2.975,5.129,2309,9.209,10.258,31,31,629
2005,2123,3209,5260,96199,95568,392,7.464,376,7.159,13334,3687,9647,3.858,13.952,12185,4772,7413,4.993,12.75,1149,1.202,25.5,193,193,1535
2005,2131,7449,8893,213259,204848,1066,12.204,750,8.586,42023,9428,32595,4.602,20.514,24766,6912,17854,3.374,12.09,17257,8.424,24.18,457,482,3339
2005,2211,1571,9379,513893,509639,583,6.149,788,8.311,50747,16684,34063,3.274,9.957,43011,17501,25510,3.434,8.44,7736,1.518,16.879,41,50,173
2005,2212,491,2422,79597,82153,134,5.49,172,7.046,6198,1299,4899,1.581,7.545,11157,5070,6087,6.171,13.581,-4959,-6.036,15.089,23,25,185
2005,2213,4166,4964,41323,41552,321,6.44,362,7.263,5603,1835,3768,4.416,13.484,6000,2399,3601,5.774,14.44,-397,-0.955,26.969,158,159,660
2005,2361,156538,157753,905124,882310,30221,19.608,22972,14.904,240213,104103,136110,11.799,27.225,195279,75438,119841,8.55,22.133,44934,5.093,44.265,15713,15715,52616
2005,2362,38733,39769,698723,704536,4550,11.528,3949,10.005,127009,27160,99849,3.855,18.027,137996,37833,100163,5.37,19.587,-10987,-1.559,36.055,2801,2803,23757
2005,2371,18188,19116,450574,452125,1786,9.34,1800,9.413,88365,17885,70480,3.956,19.544,92696,24163,68533,5.344,20.502,-4331,-0.958,39.089,1249,1254,9951
2005,2372,9841,9926,68512,66492,1579,16.101,1341,13.674,16794,5410,11384,8.136,25.257,12590,5815,6775,8.745,18.935,4204,6.323,37.87,1009,1009,4286
2005,2373,9799,10502,311194,312507,758,7.158,934,8.82,45716,6645,39071,2.126,14.629,48516,7348,41168,2.351,15.525,-2800,-0.896,29.258,567,570,4186
2005,2379,4233,4431,81507,81318,610,13.813,580,13.134,18304,5965,12339,7.335,22.509,17559,4640,12919,5.706,21.593,745,0.916,43.186,381,381,2718
2005,2381,94787,95347,1068927,1056184,14094,14.893,12666,13.384,257147,75043,182104,7.105,24.347,231578,66093,165485,6.258,21.926,25569,2.421,43.852,8716,8722,49911
2005,2382,153528,156803,1817159,1802959,19156,12.406,14360,9.3,333811,95035,238776,5.271,18.515,304939,78381,226558,4.347,16.913,28872,1.601,33.827,10472,10491,54883
2005,2383,106218,107285,897200,880435,18781,17.856,14566,13.849,216873,71319,145554,8.1,24.632,182852,56244,126608,6.388,20.768,34021,3.864,41.537,10408,10412,41430
2005,2389,54666,55134,493841,481216,9924,18.523,6808,12.707,115976,41096,74880,8.54,24.101,90326,27427,62899,5.7,18.77,25650,5.33,37.541,4556,4558,19843
2005,3111,1138,1699,47211,46927,116,6.834,113,6.657,5542,1820,3722,3.878,11.81,4889,1523,3366,3.246,10.418,653,1.392,20.837,61,63,442
2005,3112,462,785,54645,54430,42,5.347,43,5.474,3678,1016,2662,1.867,6.757,3208,537,2671,0.987,5.894,470,0.864,11.788,32,32,144
2005,3113,1530,1697,73648,75737,140,8.24,144,8.476,5716,1263,4453,1.668,7.547,9937,3333,6604,4.401,13.12,-4221,-5.573,15.094,112,112,945
2005,3114,1249,1623,163451,164578,100,6.105,130,7.937,14885,2394,12491,1.455,9.044,17132,5953,11179,3.617,10.41,-2247,-1.365,18.089,75,75,2316
2005,3115,1002,1500,133179,133613,80,5.288,106,7.006,10607,2398,8209,1.795,7.939,11655,4462,7193,3.34,8.723,-1048,-0.784,15.877,66,67,1158
2005,3116,3006,3638,496426,495575,211,5.742,284,7.729,33163,8917,24246,1.799,6.692,31467,8284,23183,1.672,6.35,1696,0.342,12.699,192,193,3096
2005,3117,543,641,37880,38013,47,7.27,58,8.971,4211,746,3465,1.962,11.078,4521,1038,3483,2.731,11.893,-310,-0.816,22.156,43,44,557
2005,3118,8990,9793,296438,299660,822,8.251,1161,11.654,32382,8449,23933,2.82,10.806,38657,11606,27051,3.873,12.9,-6275,-2.094,21.613,910,922,6727
2005,3119,2523,2950,161564,160905,289,9.81,281,9.538,17418,5224,12194,3.247,10.825,15983,5969,10014,3.71,9.933,1435,0.892,19.866,198,199,2203
2005,3121,2467,3010,133380,132849,368,12.489,241,8.179,13239,3681,9558,2.771,9.965,12178,3627,8551,2.73,9.167,1061,0.799,18.334,160,162,1372
2005,3122,92,131,21124,21433,18,13.9,15,11.583,1129,145,984,0.677,5.268,1820,208,1612,0.97,8.492,-691,-3.224,10.535,13,13,176
2005,3131,315,473,52141,53519,23,4.713,53,10.861,2974,381,2593,0.712,5.557,5694,2691,3003,5.028,10.639,-2720,-5.082,11.114,31,31,831
2005,3132,1201,1404,107050,110576,84,5.85,148,10.306,8517,1573,6944,1.423,7.702,15603,6142,9461,5.555,14.111,-7086,-6.408,15.405,109,112,1808
2005,3133,1270,1344,50979,52072,88,6.421,141,10.288,5371,1342,4029,2.577,10.315,7595,2903,4692,5.575,14.586,-2224,-4.271,20.629,105,105,1562
2005,3141,2396,2561,87626,89994,179,6.895,249,9.592,8169,1849,6320,2.055,9.077,12716,4506,8210,5.007,14.13,-4547,-5.053,18.155,185,187,1685
2005,3149,4323,4453,83243,84488,327,7.219,480,10.597,9876,1934,7942,2.289,11.689,12238,4391,7847,5.197,14.485,-2362,-2.796,23.379,376,378,3079
2005,3151,491,539,33491,35664,30,5.277,89,15.655,2681,309,2372,0.866,7.517,6989,1962,5027,5.501,19.597,-4308,-12.079,15.035,73,74,1209
2005,3152,7291,7462,180748,186014,1190,15.469,1652,21.474,37952,13268,24684,7.133,20.403,48013,23438,24575,12.6,25.811,-10061,-5.409,40.806,1462,1464,18886
2005,3159,888,917,18938,19755,73,7.729,128,13.552,2053,357,1696,1.807,10.392,3657,1691,1966,8.56,18.512,-1604,-8.119,20.785,100,100,657
2005,3161,212,220,6764,7136,18,8.219,16,7.306,445,96,349,1.345,6.236,1169,127,1042,1.78,16.383,-724,-10.146,12.473,13,13,56
2005,3162,255,286,16228,16529,23,7.877,35,11.986,831,117,714,0.708,5.028,1399,388,1011,2.347,8.464,-568,-3.436,10.055,27,27,198
2005,3169,763,777,15987,16037,75,9.554,91,11.592,2018,502,1516,3.13,12.584,2089,671,1418,4.184,13.027,-71,-0.443,25.168,75,75,512
2005,3211,3569,4006,115922,114984,304,7.572,322,8.02,12480,3424,9056,2.978,10.854,10504,3184,7320,2.769,9.135,1976,1.718,18.27,244,246,2015
2005,3212,1441,1837,118753,115590,143,7.808,132,7.207,15510,3744,11766,3.239,13.418,9327,3943,5384,3.411,8.069,6183,5.349,16.138,81,83,1549
2005,3219,9178,10056,330043,323530,822,8.135,918,9.086,46674,11878,34796,3.671,14.426,33418,10540,22878,3.258,10.329,13256,4.097,20.658,680,690,6451
2005,3221,287,590,146615,148618,26,4.359,39,6.538,6602,2296,4306,1.545,4.442,10511,3789,6722,2.549,7.072,-3909,-2.63,8.885,17,17,282
2005,3222,3019,4564,312070,315531,174,3.762,297,6.421,21626,3964,17662,1.256,6.854,28440,9894,18546,3.136,9.013,-6814,-2.16,13.708,161,162,2636
2005,3231,31110,32707,661531,669220,1969,5.945,2790,8.425,61460,14294,47166,2.136,9.184,76794,27500,49294,4.109,11.475,-15334,-2.291,18.368,2242,2258,15540
2005,3241,1028,2251,100587,100390,171,7.603,167,7.426,9459,2193,7266,2.184,9.422,8958,4154,4804,4.138,8.923,501,0.499,17.846,40,40,357
2005,3251,1181,2295,164042,166200,109,4.742,116,5.047,9929,2133,7796,1.283,5.974,14434,3309,11125,1.991,8.685,-4505,-2.711,11.948,47,49,586
2005,3252,736,1069,97023,97318,65,6.126,49,4.618,7266,1127,6139,1.158,7.466,7818,1448,6370,1.488,8.033,-552,-0.567,14.933,19,19,308
2005,3253,620,871,29990,30218,66,7.582,65,7.467,3081,1091,1990,3.61,10.196,3593,1425,2168,4.716,11.89,-512,-1.694,20.392,27,27,240
2005,3254,1354,1764,255899,251270,129,7.348,112,6.38,32418,4954,27464,1.972,12.902,22893,7415,15478,2.951,9.111,9525,3.791,18.222,70,71,979
2005,3255,1443,1837,63670,64390,77,4.145,118,6.353,4586,1041,3545,1.617,7.122,6028,1750,4278,2.718,9.362,-1442,-2.239,14.245,75,76,627
2005,3256,1942,2157,105309,105675,150,6.911,177,8.155,9419,1229,8190,1.163,8.913,10153,3459,6694,3.273,9.608,-734,-0.695,17.826,109,109,1364
2005,3259,2046,2653,109345,112022,172,6.423,222,8.29,8926,2112,6814,1.885,7.968,14165,3334,10831,2.976,12.645,-5239,-4.677,15.936,125,127,955
2005,3261,9469,12004,736105,735650,562,4.647,742,6.135,75002,14202,60800,1.931,10.195,74135,20023,54112,2.722,10.077,867,0.118,20.155,514,518,8994
2005,3262,1689,2178,160854,161759,94,4.269,142,6.449,11638,1852,9786,1.145,7.195,13395,4029,9366,2.491,8.281,-1757,-1.086,14.389,83,87,1629
2005,3271,1265,1468,54559,55255,129,8.758,139,9.437,5341,963,4378,1.743,9.666,6654,1597,5057,2.89,12.042,-1313,-2.376,19.332,106,106,689
2005,3272,1683,2008,102305,105106,149,7.354,185,9.131,7467,1841,5626,1.752,7.104,12915,4139,8776,3.938,12.288,-5448,-5.183,14.209,138,138,1361
2005,3273,4927,9279,216678,213176,558,6.068,393,4.273,31106,7920,23186,3.715,14.592,24156,4666,19490,2.189,11.332,6950,3.26,22.663,206,216,2281
2005,3274,214,336,17778,18176,19,5.663,18,5.365,1428,251,1177,1.381,7.857,2382,70,2312,0.385,13.105,-954,-5.249,15.713,16,16,61
2005,3279,2547,2964,76547,75180,298,10.211,207,7.093,10030,2401,7629,3.194,13.341,7302,1983,5319,2.638,9.713,2728,3.629,19.426,136,145,1270
2005,3311,482,603,109092,110458,78,13.065,66,11.055,4863,948,3915,0.858,4.403,7682,1598,6084,1.447,6.955,-2819,-2.552,8.805,47,48,931
2005,3312,489,623,44909,44707,41,6.565,44,7.046,4202,1645,2557,3.68,9.399,3809,1216,2593,2.72,8.52,393,0.879,17.04,24,24,140
2005,3313,411,573,66383,65208,49,8.703,29,5.151,6140,2312,3828,3.546,9.416,3872,744,3128,1.141,5.938,2268,3.478,11.876,19,19,244
2005,3314,714,908,61937,61446,44,4.798,62,6.761,5659,681,4978,1.108,9.21,4787,962,3825,1.566,7.791,872,1.419,15.581,47,47,589
2005,3315,1924,2183,166410,164733,84,3.798,141,6.376,16244,2508,13736,1.522,9.861,13074,3844,9230,2.333,7.936,3170,1.924,15.873,97,100,1965
2005,3321,2405,2665,127158,124921,112,4.185,134,5.007,13877,2763,11114,2.212,11.109,9485,2541,6944,2.034,7.593,4392,3.516,15.186,86,86,974
2005,3322,1310,1440,55495,57015,73,5.034,93,6.414,4363,1205,3158,2.113,7.652,7408,1894,5514,3.322,12.993,-3045,-5.341,15.305,61,61,931
2005,3323,11765,12676,374786,371874,867,6.83,904,7.121,48377,12595,35782,3.387,13.009,42634,12955,29679,3.484,11.465,5743,1.544,22.929,638,642,8761
2005,3324,1239,1517,87136,87751,69,4.5,102,6.651,8403,1029,7374,1.173,9.576,9740,2595,7145,2.957,11.1,-1337,-1.524,19.152,61,62,1052
2005,3325,694,770,49028,50153,33,4.215,59,7.535,4332,347,3985,0.692,8.638,6518,2113,4405,4.213,12.996,-2186,-4.359,17.275,40,41,715
2005,3326,1465,1654,56317,57057,52,3.07,132,7.792,5220,569,4651,0.997,9.149,6676,2099,4577,3.679,11.701,-1456,-2.552,18.297,98,98,1318
2005,3327,23004,23428,374680,367800,1412,6.01,1546,6.58,51286,9210,42076,2.504,13.944,37546,12131,25415,3.298,10.208,13740,3.736,20.417,1172,1175,7681
2005,3328,5400,5969,136094,135128,347,5.798,378,6.316,17497,4439,13058,3.285,12.948,15568,4747,10821,3.513,11.521,1929,1.428,23.042,298,299,3577
2005,3329,5486,6024,267918,268197,428,7.067,492,8.124,27386,5766,21620,2.15,10.211,27712,8944,18768,3.335,10.333,-326,-0.122,20.422,336,336,2922
2005,3331,2473,2776,182650,177238,180,6.519,150,5.433,22601,3533,19068,1.993,12.752,11525,3849,7676,2.172,6.503,11076,6.249,13.005,102,104,1864
2005,3332,3551,3767,136443,135574,208,5.47,279,7.337,15255,4296,10959,3.169,11.252,13565,5088,8477,3.753,10.006,1690,1.247,20.011,204,204,2337
2005,3333,2047,2204,98584,102383,146,6.587,171,7.715,8712,2070,6642,2.022,8.509,15674,3556,12118,3.473,15.309,-6962,-6.8,17.019,120,121,1205
2005,3334,1462,1769,150374,149688,124,7.029,114,6.463,14648,3545,11103,2.368,9.786,13128,4591,8537,3.067,8.77,1520,1.015,17.54,67,68,1208
2005,3335,7792,8095,177706,176598,379,4.638,533,6.522,19135,4291,14844,2.43,10.835,16911,5161,11750,2.922,9.576,2224,1.259,19.152,409,409,3079
2005,3336,732,885,97213,93652,49,5.54,48,5.427,10333,2151,8182,2.297,11.033,3360,737,2623,0.787,3.588,6973,7.446,7.176,31,31,295
2005,3339,5452,6115,282564,281685,325,5.289,385,6.265,27043,5679,21364,2.016,9.6,25056,7958,17098,2.825,8.895,1987,0.705,17.79,259,260,2690
2005,3341,1183,1254,104527,106649,102,7.969,154,12.031,9801,1241,8560,1.164,9.19,13542,3294,10248,3.089,12.698,-3741,-3.508,18.38,112,112,1578
2005,3342,1539,1733,124002,128581,127,7.226,176,10.014,12466,3497,8969,2.72,9.695,21515,6945,14570,5.401,16.733,-9049,-7.038,19.39,123,128,2794
2005,3343,424,441,19067,19927,39,8.638,60,13.289,1500,106,1394,0.532,7.527,3213,2040,1173,10.237,16.124,-1713,-8.596,15.055,46,46,718
2005,3344,4115,4654,361462,364105,239,5.066,367,7.779,31927,4371,27556,1.2,8.769,37112,11250,25862,3.09,10.193,-5185,-1.424,17.537,246,251,3279
2005,3345,4282,4951,402039,396266,308,6.204,335,6.748,41700,5867,35833,1.481,10.523,29375,11119,18256,2.806,7.413,12325,3.11,14.826,210,210,2289
2005,3346,734,782,34859,35555,75,9.434,101,12.704,4121,1042,3079,2.931,11.59,5433,1804,3629,5.074,15.281,-1312,-3.69,23.181,80,81,1626
2005,3351,1059,1151,59733,60442,65,5.611,80,6.905,4544,549,3995,0.908,7.518,5933,1730,4203,2.862,9.816,-1389,-2.298,15.036,63,63,859
2005,3352,287,343,82619,84475,47,13.967,34,10.104,7269,1404,5865,1.662,8.605,10719,3711,7008,4.393,12.689,-3450,-4.084,17.21,22,22,130
2005,3353,1985,2341,139105,138304,137,5.827,157,6.678,13708,3370,10338,2.437,9.911,12056,4554,7502,3.293,8.717,1652,1.194,17.434,109,109,1446
2005,3359,1768,2106,147047,149725,151,7.165,154,7.307,12287,4057,8230,2.71,8.206,17684,5304,12380,3.542,11.811,-5397,-3.605,16.413,105,105,1649
2005,3361,285,358,208492,212803,39,11.001,32,9.027,18544,7132,11412,3.351,8.714,28913,3633,25280,1.707,13.587,-10369,-4.873,17.428,25,25,125
2005,3362,1773,2026,149144,144639,152,7.438,187,9.151,20285,3202,17083,2.214,14.025,11633,4393,7240,3.037,8.043,8652,5.982,16.086,140,141,2467
2005,3363,4305,5428,671492,675246,337,6.191,367,6.743,65577,14755,50822,2.185,9.712,73053,15644,57409,2.317,10.819,-7476,-1.107,19.423,246,250,5836
2005,3364,1177,1524,393747,386417,83,5.421,97,6.336,33862,2632,31230,0.681,8.763,18625,2414,16211,0.625,4.82,15237,3.943,9.64,66,66,814
2005,3365,147,201,28980,26763,14,7.071,8,4.04,5501,865,4636,3.232,20.555,1054,247,807,0.923,3.938,4447,16.617,7.877,6,6,209
2005,3366,1537,1661,144646,143454,147,8.847,148,8.908,13091,1915,11176,1.335,9.126,10887,2499,8388,1.742,7.589,2204,1.536,15.178,111,112,2117
2005,3369,789,821,45191,43002,123,15.452,73,9.171,7958,883,7075,2.053,18.506,3321,555,2766,1.291,7.723,4637,10.783,15.446,55,55,346
2005,3371,14532,14997,359509,361025,1335,8.862,1470,9.758,43060,12469,30591,3.454,11.927,46105,16090,30015,4.457,12.771,-3045,-0.843,23.854,1122,1126,8289
2005,3372,3790,3989,146461,148054,243,6.036,317,7.874,16274,3559,12715,2.404,10.992,19437,5373,14064,3.629,13.128,-3163,-2.136,21.984,241,241,2775
2005,3379,898,1036,46596,46433,67,6.439,76,7.304,5161,1683,3478,3.625,11.115,4876,1496,3380,3.222,10.501,285,0.614,21.003,56,57,944
2005,3391,10661,11438,307907,304996,761,6.635,823,7.176,35414,9060,26354,2.971,11.611,29263,7649,21614,2.508,9.595,6151,2.017,19.189,612,615,4260
2005,3399,17180,17646,377159,381499,1495,8.427,1686,9.503,42244,10775,31469,2.824,11.073,50848,15975,34873,4.187,13.328,-8604,-2.255,22.146,1312,1318,10007
2005,4231,17443,24026,368409,365428,1865,7.758,1894,7.878,46336,15143,31193,4.144,12.68,40612,12199,28413,3.338,11.114,5724,1.566,22.227,1348,1400,7664
2005,4232,10967,12607,162103,162144,1237,9.806,1253,9.933,22726,6415,16311,3.956,14.016,22844,7223,15621,4.455,14.089,-118,-0.073,28.032,971,1000,5216
2005,4233,11765,17676,263639,254764,1757,10.092,1223,7.025,43414,15064,28350,5.913,17.041,25667,9141,16526,3.588,10.075,17747,6.966,20.15,812,854,5227
2005,4234,25222,34318,722080,723565,2940,8.488,3581,10.338,99681,27844,71837,3.848,13.776,102410,32630,69780,4.51,14.154,-2729,-0.377,27.553,2214,2278,14597
2005,4235,7378,10090,151265,148782,703,6.988,643,6.392,20147,5608,14539,3.769,13.541,15217,4621,10596,3.106,10.228,4930,3.314,20.455,383,397,2468
2005,4236,19495,28760,469383,471622,2432,8.44,2544,8.828,65375,18549,46826,3.933,13.862,69206,23355,45851,4.952,14.674,-3831,-0.812,27.723,1394,1521,8996
2005,4237,11013,18302,219880,217880,1310,7.224,972,5.36,28045,9017,19028,4.139,12.872,23887,5719,18168,2.625,10.963,4158,1.908,21.927,596,621,3079
2005,4238,42341,57539,690582,689596,3618,6.266,4012,6.949,84681,23296,61385,3.378,12.28,83354,31561,51793,4.577,12.087,1327,0.192,24.175,2595,2734,14223
2005,4239,27932,30904,333230,330172,3411,11.09,3118,10.137,51040,17609,33431,5.333,15.459,45088,13700,31388,4.149,13.656,5952,1.803,27.312,2434,2456,9911
2005,4241,9218,11949,203245,203887,769,6.393,928,7.715,23040,7861,15179,3.856,11.3,24344,5358,18986,2.628,11.94,-1304,-0.64,22.601,631,640,3223
2005,4242,5732,7510,265360,269577,811,10.885,692,9.288,35567,15461,20106,5.735,13.194,44377,17789,26588,6.599,16.462,-8810,-3.268,26.387,493,497,3277
2005,4243,13561,14721,204625,204086,1680,11.372,1784,12.076,31661,9488,22173,4.649,15.514,30476,8671,21805,4.249,14.933,1185,0.581,29.866,1421,1432,6472
2005,4244,25541,31570,768145,771117,2724,8.577,3105,9.776,93950,30813,63137,3.996,12.184,99191,28335,70856,3.675,12.863,-5241,-0.68,24.367,2223,2263,14266
2005,4245,4100,6569,63926,63931,308,4.641,442,6.661,8015,1570,6445,2.456,12.537,8084,2033,6051,3.18,12.645,-69,-0.108,25.074,247,272,1074
2005,4246,8391,12140,146220,144887,872,7.163,939,7.713,22155,8372,13783,5.778,15.291,19373,6621,12752,4.57,13.371,2782,1.92,26.742,514,530,2226
2005,4247,5061,7205,106652,107260,434,5.989,518,7.148,13826,3641,10185,3.395,12.89,15140,4196,10944,3.912,14.115,-1314,-1.225,25.78,306,318,2282
2005,4248,3139,3927,171091,170397,266,6.754,289,7.338,15670,3233,12437,1.897,9.196,14228,5372,8856,3.153,8.35,1442,0.846,16.7,199,203,2745
2005,4249,23019,28957,379601,381720,2971,10.277,2873,9.938,48990,15355,33635,4.023,12.834,53415,17233,36182,4.515,13.993,-4425,-1.159,25.668,2141,2177,11807
2005,4251,37650,39682,297544,293481,5251,13.479,3801,9.757,53662,19116,34546,6.514,18.285,45159,14185,30974,4.833,15.387,8503,2.897,30.775,2745,2781,9735
2005,4411,43836,48282,1288782,1293741,4664,9.676,4504,9.344,139742,52538,87204,4.061,10.801,149425,51171,98254,3.955,11.55,-9683,-0.748,21.603,3599,3642,38993
2005,4412,13508,15077,162997,161873,1611,10.796,1301,8.719,26551,11127,15424,6.874,16.402,24349,8619,15730,5.325,15.042,2202,1.36,30.084,982,998,5883
2005,4413,31753,56236,494083,492919,4066,7.256,3665,6.54,64519,24436,40083,4.957,13.089,62310,20497,41813,4.158,12.641,2209,0.448,25.282,2529,2634,11319
2005,4421,19036,26866,273729,273404,2742,10.249,2517,9.408,42548,18040,24508,6.598,15.562,41685,13968,27717,5.109,15.247,863,0.316,30.493,1838,1959,9281
2005,4422,25236,34453,297324,301264,3506,10.219,3215,9.371,44811,19464,25347,6.461,14.874,52366,14313,38053,4.751,17.382,-7555,-2.508,29.749,2318,2391,8826
2005,4431,30082,50318,508803,503843,6733,13.514,5745,11.531,100218,36731,63487,7.29,19.891,87385,27356,60029,5.429,17.344,12833,2.547,34.687,3727,3945,15028
2005,4441,43877,64171,1113104,1090292,4476,7.013,3781,5.924,136391,48587,87804,4.456,12.51,91246,23036,68210,2.113,8.369,45145,4.141,16.738,2759,2902,15251
2005,4442,15433,18590,168712,171808,1226,6.524,1629,8.669,21690,5869,15821,3.416,12.625,28021,8682,19339,5.053,16.309,-6331,-3.685,25.249,1038,1060,4404
2005,4451,59508,85808,2613947,2624688,9701,11.299,9801,11.415,286435,123346,163089,4.699,10.913,307080,107417,199663,4.093,11.7,-20645,-0.787,21.826,6940,7108,41182
2005,4452,17253,20866,143895,144891,3416,16.179,3911,18.524,31839,15830,16009,10.925,21.975,33709,14084,19625,9.72,23.265,-1870,-1.291,43.949,2229,2257,9270
2005,4453,23723,27111,136826,139646,2816,10.438,2549,9.449,22300,10027,12273,7.18,15.969,27791,8754,19037,6.269,19.901,-5491,-3.932,31.938,1941,1958,6795
2005,4461,40011,80065,1016944,1023002,6303,7.904,5658,7.095,132075,53126,78949,5.193,12.911,146677,30306,116371,2.962,14.338,-14602,-1.427,25.821,3244,3345,16798
2005,4471,63007,112033,911342,925459,9443,8.401,10188,9.064,141626,56143,85483,6.067,15.303,168563,58892,109671,6.364,18.214,-26937,-2.911,30.607,6317,6867,37338
2005,4481,35264,86886,1182343,1182689,8849,10.253,7683,8.902,185444,65994,119450,5.58,15.68,187324,53341,133983,4.51,15.839,-1880,-0.159,31.36,4019,4353,20272
2005,4482,6099,25339,186054,191597,1438,5.549,2585,9.976,30455,8190,22265,4.275,15.895,41652,15879,25773,8.288,21.739,-11197,-5.844,31.791,632,833,4094
2005,4483,18163,28891,169755,167098,3064,10.761,2229,7.828,27216,12065,15151,7.22,16.287,22107,7740,14367,4.632,13.23,5109,3.057,26.46,1469,1500,4668
2005,4511,28214,38089,417182,413186,3974,10.401,4210,11.019,65073,28331,36742,6.857,15.749,57567,20853,36714,5.047,13.932,7506,1.817,27.865,2839,3033,12257
2005,4512,6132,11694,140673,143672,911,7.743,1053,8.95,14784,4958,9826,3.451,10.29,20284,5659,14625,3.939,14.118,-5500,-3.828,20.58,722,749,3162
2005,4522,159,5231,712647,726839,118,2.258,106,2.029,31975,8741,23234,1.203,4.399,61360,8823,52537,1.214,8.442,-29385,-4.043,8.798,15,15,32
2005,4523,8943,37810,2038767,2017524,3613,9.788,1818,4.925,189834,74196,115638,3.678,9.409,148097,11228,136869,0.557,7.341,41737,2.069,14.681,1231,1272,5089
2005,4531,18530,19395,101848,106052,1745,8.874,2283,11.61,15062,5694,9368,5.369,14.202,23519,7283,16236,6.867,22.177,-8457,-7.974,28.405,1883,1900,5760
2005,4532,27079,38239,319531,321757,4359,11.326,4854,12.612,51099,21454,29645,6.668,15.881,55791,21756,34035,6.762,17.34,-4692,-1.458,31.763,3585,3676,12973
2005,4533,12294,16571,128113,128344,1661,10.013,1696,10.224,19204,7486,11718,5.833,14.963,19718,5963,13755,4.646,15.363,-514,-0.4,29.926,1335,1345,4005
2005,4539,31873,40402,259131,257515,4847,12.03,4627,11.484,48324,18934,29390,7.353,18.766,44739,15406,29333,5.983,17.373,3585,1.392,34.747,3311,3600,11626
2005,4541,14499,15446,269369,268506,2486,16.494,1738,11.531,48242,19532,28710,7.274,17.967,46473,16930,29543,6.305,17.308,1769,0.659,34.616,1319,1333,6815
2005,4542,4322,4903,52940,53843,495,10.024,565,11.442,5414,1771,3643,3.289,10.055,7281,2772,4509,5.148,13.523,-1867,-3.468,20.111,440,444,2158
2005,4543,21585,27178,216899,221496,2674,9.751,3163,11.534,32541,13882,18659,6.267,14.691,41233,18289,22944,8.257,18.616,-8692,-3.924,29.383,2124,2178,7992
2005,4811,576,3152,434704,436033,258,8.198,248,7.881,23071,4747,18324,1.089,5.291,25623,3353,22270,0.769,5.876,-2552,-0.585,10.582,48,60,449
2005,4812,1985,2150,38918,37964,295,13.879,246,11.574,6426,2112,4314,5.563,16.927,4465,2187,2278,5.761,11.761,1961,5.165,23.523,192,196,1566
2005,4831,769,1168,47691,46606,142,12.38,100,8.718,7759,2939,4820,6.306,16.648,5575,877,4698,1.882,11.962,2184,4.686,23.924,71,71,599
2005,4832,470,526,19094,19464,74,14.327,55,10.649,3561,814,2747,4.182,18.295,4502,2947,1555,15.141,23.13,-941,-4.835,36.591,37,37,2672
2005,4841,44966,54289,1023398,1006673,9506,17.822,7606,14.26,153621,42477,111144,4.22,15.26,118975,42915,76060,4.263,11.819,34646,3.442,23.637,5710,5840,26081
2005,4842,41800,45441,457651,454524,6181,13.657,5818,12.855,80665,28794,51871,6.335,17.747,74004,24967,49037,5.493,16.282,6661,1.465,32.563,4360,4382,17362
2005,4851,597,883,51187,50301,96,10.847,100,11.299,7352,4318,3034,8.584,14.616,5664,2101,3563,4.177,11.26,1688,3.356,22.521,72,72,1187
2005,4852,194,505,17590,17757,69,14.067,40,8.155,2260,1200,1060,6.758,12.728,2591,759,1832,4.274,14.592,-331,-1.864,25.455,19,19,377
2005,4853,5869,5991,63585,63639,941,15.797,873,14.655,11696,4784,6912,7.517,18.379,11818,4993,6825,7.846,18.571,-122,-0.192,36.758,728,728,3651
2005,4854,2984,4130,183848,182521,276,6.646,322,7.753,22172,8822,13350,4.833,12.148,19637,6976,12661,3.822,10.759,2535,1.389,21.518,206,206,2452
2005,4855,1058,1166,27794,28518,141,12.046,150,12.815,4295,1406,2889,4.93,15.061,5741,2317,3424,8.125,20.131,-1446,-5.07,30.121,113,116,1433
2005,4859,2578,2823,57871,58010,423,15.029,406,14.425,9931,4196,5735,7.233,17.12,10343,4152,6191,7.157,17.83,-412,-0.71,34.239,314,315,2915
2005,4861,53,400,6116,6486,30,7.605,19,4.816,1151,570,581,8.788,17.746,1969,248,1721,3.824,30.358,-818,-12.612,35.492,4,4,40
2005,4862,127,1591,23572,23969,65,4.037,103,6.398,2075,876,1199,3.655,8.657,2800,1641,1159,6.846,11.682,-725,-3.025,17.314,11,12,94
2005,4869,55,619,6656,6544,79,13.266,32,5.374,1214,736,478,11.248,18.553,980,342,638,5.227,14.977,234,3.576,29.953,4,4,11
2005,4871,460,512,8723,8623,76,15.079,60,11.905,1255,352,903,4.082,14.554,1070,405,665,4.697,12.409,185,2.145,24.817,50,50,254
2005,4872,1168,1201,11274,11325,184,15.238,197,16.315,1790,626,1164,5.528,15.806,1913,554,1359,4.892,16.893,-123,-1.086,31.613,133,133,405
2005,4879,133,138,2247,2172,20,14.981,11,8.24,338,56,282,2.579,15.565,199,19,180,0.875,9.164,139,6.401,18.328,7,7,15
2005,4881,3432,4765,146109,142916,510,10.674,536,11.218,25050,9770,15280,6.836,17.528,18798,7481,11317,5.235,13.153,6252,4.375,26.306,254,261,2207
2005,4882,469,932,26799,26831,102,11.24,53,5.84,4516,2047,2469,7.629,16.832,4587,982,3605,3.66,17.096,-71,-0.265,33.663,24,31,669
2005,4883,1623,2135,89940,89516,182,8.499,195,9.106,11919,3092,8827,3.454,13.315,10953,2749,8204,3.071,12.236,966,1.079,24.472,119,119,761
2005,4884,7543,8049,66130,65716,1187,15.003,912,11.528,13640,6129,7511,9.326,20.756,12586,4257,8329,6.478,19.152,1054,1.604,38.304,707,709,3182
2005,4885,11897,16696,187151,183609,2064,12.6,1434,8.754,32171,11738,20433,6.393,17.522,25276,10566,14710,5.755,13.766,6895,3.755,27.532,837,878,4393
2005,4889,1186,1286,28508,28431,279,22.609,175,14.182,3822,1037,2785,3.647,13.443,3604,969,2635,3.408,12.676,218,0.767,25.353,125,125,578
2005,4921,2866,8560,503430,523732,932,10.913,892,10.445,59249,33826,25423,6.459,11.313,97116,12076,85040,2.306,18.543,-37867,-7.23,22.626,339,368,1859
2005,4922,4054,4545,45447,46146,636,14.006,628,13.83,7813,2871,4942,6.222,16.931,9257,3263,5994,7.071,20.06,-1444,-3.129,33.862,505,506,2608
2005,4931,6745,13069,597208,595062,1108,8.493,1063,8.148,81379,28110,53269,4.724,13.676,78025,24619,53406,4.137,13.112,3354,0.564,26.224,396,405,4349
2005,5111,15027,20942,700988,702564,1975,9.462,1835,8.792,68433,22395,46038,3.188,9.74,71365,24156,47209,3.438,10.158,-2932,-0.417,19.481,1189,1219,10536
2005,5112,5917,8348,329528,325878,900,10.705,1018,12.109,51468,13705,37763,4.206,15.794,44612,19807,24805,6.078,13.69,6856,2.104,27.38,526,563,7823
2005,5121,12012,15514,282623,282949,2178,14.136,1966,12.76,40764,18523,22241,6.546,14.407,41481,13583,27898,4.801,14.66,-717,-0.253,28.814,1214,1227,6642
2005,5122,2611,2832,22465,23876,403,14.049,476,16.594,4002,1765,2237,7.392,16.762,6731,4248,2483,17.792,28.191,-2729,-11.43,33.523,290,290,891
2005,5151,4395,8963,245782,245388,703,7.83,734,8.175,25832,10981,14851,4.475,10.527,24937,9097,15840,3.707,10.162,895,0.365,20.325,362,387,4646
2005,5152,332,586,39025,38803,111,17.33,220,34.348,6743,4542,2201,11.705,17.378,6185,3446,2739,8.881,15.94,558,1.438,31.879,32,37,1053
2005,5173,6040,43951,1211651,1251982,5353,12.195,5241,11.94,166364,56792,109572,4.536,13.288,246529,75769,170760,6.052,19.691,-80165,-6.403,26.576,944,1181,10968
2005,5174,455,583,11813,11922,125,22.202,85,15.098,1785,879,906,7.373,14.972,2011,725,1286,6.081,16.868,-226,-1.896,29.945,47,47,307
2005,5179,4967,5660,72817,70089,1208,21.187,1291,22.643,26806,19983,6823,28.511,38.246,22277,11148,11129,15.905,31.784,4529,6.462,63.568,861,891,5968
2005,5182,7322,14040,392508,391549,2032,14.777,1454,10.574,64545,26821,37724,6.85,16.485,63015,19190,43825,4.901,16.094,1530,0.391,32.188,662,679,6451
2005,5191,4873,5914,105198,102080,777,13.423,526,9.087,18513,6530,11983,6.397,18.136,11998,3259,8739,3.193,11.754,6515,6.382,23.507,378,379,2287
2005,5211,19,54,20078,20863,3,5.31,8,14.159,569,10,559,0.048,2.727,2216,426,1790,2.042,10.622,-1647,-7.894,5.455,(D),(D),(D)
2005,5221,16124,115006,2101561,2098056,9318,8.12,8817,7.683,270671,99489,171182,4.742,12.901,265702,114856,150846,5.474,12.664,4969,0.237,25.328,550,803,8717
2005,5222,18785,50876,791616,775000,8431,16.825,6896,13.762,183454,82226,101228,10.61,23.671,151760,66630,85130,8.597,19.582,31694,4.09,39.164,2004,2096,12010
2005,5223,24664,39555,328961,325099,7808,20.771,3880,10.322,77395,31626,45769,9.728,23.807,68799,20489,48310,6.302,21.162,8596,2.644,42.325,2486,2573,12874
2005,5231,12318,35766,482245,497747,5620,15.139,8331,22.443,122192,86617,35575,17.402,24.549,151214,93646,57568,18.814,30.38,-29022,-5.831,49.098,1054,1087,6764
2005,5232,55,60,6637,6888,12,20.69,8,13.793,239,65,174,0.944,3.47,760,417,343,6.054,11.034,-521,-7.564,6.94,6,6,31
2005,5239,32396,36493,355302,345405,6529,18.386,4563,12.85,80032,46356,33676,13.421,23.171,60471,24508,35963,7.095,17.507,19561,5.663,35.015,3017,3049,11469
2005,5241,6253,32329,1407808,1451240,6488,20.378,5508,17.3,138297,55563,82734,3.829,9.53,223822,87045,136777,5.998,15.423,-85525,-5.893,19.059,462,493,10448
2005,5242,118408,132202,925702,913738,13471,10.3,10651,8.143,159844,68972,90872,7.548,17.493,135268,49470,85798,5.414,14.804,24576,2.69,29.608,7289,7461,27281
2005,5259,770,812,6357,5530,195,24.606,156,19.685,3048,793,2255,14.341,55.123,1519,745,774,13.473,27.471,1529,27.652,54.942,112,114,551
2005,5311,86778,104982,543873,546109,11770,11.273,10622,10.174,96628,47491,49137,8.696,17.694,101710,39247,62463,7.187,18.625,-5082,-0.931,35.388,7757,8240,28559
2005,5312,71471,79981,339411,330675,16279,21.33,8953,11.731,84900,46858,38042,14.17,25.675,67716,24548,43168,7.424,20.478,17184,5.197,40.956,5656,5722,14193
2005,5313,58143,66032,606765,594919,11340,17.772,6890,10.798,113409,57597,55812,9.681,19.063,89370,31112,58258,5.23,15.022,24039,4.041,30.044,4568,4629,19350
2005,5321,4085,11954,171362,169537,2528,22.593,999,8.928,30137,18173,11964,10.719,17.776,25870,5465,20405,3.223,15.259,4267,2.517,30.518,550,569,2746
2005,5322,11970,32026,264287,263322,2878,8.989,2858,8.927,40354,16373,23981,6.218,15.325,38661,12331,26330,4.683,14.682,1693,0.643,29.364,1484,1786,6582
2005,5323,3219,4971,32533,32749,380,7.609,426,8.53,4751,1596,3155,4.873,14.507,5097,2079,3018,6.348,15.564,-346,-1.057,29.015,241,278,1245
2005,5324,7419,12274,153242,154880,1329,10.874,1224,10.015,27025,9845,17180,6.357,17.449,29903,10668,19235,6.888,19.307,-2878,-1.858,34.898,622,653,3209
2005,5331,1924,1992,28578,28601,253,12.768,232,11.708,5711,1568,4143,5.482,19.968,5692,2811,2881,9.828,19.901,19,0.066,39.803,167,170,789
2005,5411,162350,171296,1202778,1210217,15111,8.869,13285,7.797,133620,45358,88262,3.748,11.041,148165,42385,105780,3.502,12.243,-14545,-1.202,22.082,9708,9811,30518
2005,5412,92954,106421,1212933,1216575,11022,10.462,8880,8.429,217504,76979,140525,6.328,17.878,220515,60733,159782,4.992,18.126,-3011,-0.247,35.757,5858,5940,35299
2005,5413,86072,98678,1299910,1284308,10945,11.22,8679,8.897,193386,56905,136481,4.431,15.058,162047,55540,106507,4.325,12.617,31339,2.44,25.235,5458,5562,26353
2005,5414,26439,26718,119547,118843,4126,15.612,3547,13.421,22936,9142,13794,7.693,19.299,21640,9402,12238,7.911,18.209,1296,1.091,36.418,2526,2533,6668
2005,5415,77060,87436,1142937,1126201,17504,20.332,14815,17.208,244451,93230,151221,8.278,21.706,210345,90720,119625,8.055,18.677,34106,3.028,37.355,9412,9532,40611
2005,5416,89929,95768,816072,788818,19348,20.696,14786,15.816,192643,76803,115840,9.736,24.422,138985,59422,79563,7.533,17.619,53658,6.802,35.239,10310,10397,37691
2005,5417,10907,14264,634656,630124,1867,13.167,1697,11.968,91136,27333,63803,4.338,14.463,81946,25386,56560,4.029,13.005,9190,1.458,26.009,942,961,9263
2005,5418,30794,34064,417622,404142,4048,11.911,3893,11.455,90874,27691,63183,6.852,22.486,62788,23430,39358,5.797,15.536,28086,6.95,31.072,2637,2655,11055
2005,5419,52931,61247,555703,550388,6671,10.997,5497,9.062,93122,27163,65959,4.935,16.919,82790,21879,60911,3.975,15.042,10332,1.877,30.084,3814,3871,15285
2005,5511,25969,47970,2843426,2844730,4654,9.816,3540,7.466,423765,141424,282341,4.971,14.896,426586,116886,309700,4.109,14.996,-2821,-0.099,29.793,1057,1101,16769
2005,5611,20276,22221,437708,432311,4303,20.093,2691,12.566,95988,45543,50445,10.535,22.203,85276,35887,49389,8.301,19.726,10712,2.478,39.451,1998,2019,20447
2005,5612,1646,4132,172847,169805,534,13.187,369,9.112,28536,11004,17532,6.48,16.805,22739,7208,15531,4.245,13.391,5797,3.414,26.783,136,139,1465
2005,5613,26982,44158,4282681,4079331,6403,14.637,5577,12.749,1202346,327936,874410,8.039,29.474,795978,319239,476739,7.826,19.512,406368,9.962,39.025,2966,3114,165116
2005,5614,26791,32734,781887,782203,4364,13.439,3843,11.834,149278,58819,90459,7.52,19.084,150269,51789,98480,6.621,19.211,-991,-0.127,38.169,2725,2764,23084
2005,5615,16149,21712,253068,257217,2079,9.39,2935,13.257,43198,21180,22018,8.234,16.794,51910,18607,33303,7.234,20.181,-8712,-3.387,33.589,1547,1591,6437
2005,5616,16909,21412,759102,752020,2538,11.884,2427,11.364,124307,34648,89659,4.607,16.53,110170,36382,73788,4.838,14.65,14137,1.88,29.3,1597,1669,21084
2005,5617,128383,134541,1614940,1606240,21558,16.207,18513,13.918,314433,106821,207612,6.65,19.576,298297,101727,196570,6.333,18.571,16136,1.005,37.142,12769,12811,66479
2005,5619,17050,19273,348870,348892,2126,11.086,1936,10.095,60229,17509,42720,5.018,17.263,61429,22757,38672,6.523,17.607,-1200,-0.344,34.526,1323,1335,9338
2005,5621,6576,8469,183529,181262,851,10.158,669,7.985,21477,6093,15384,3.361,11.849,16908,5794,11114,3.196,9.328,4569,2.521,18.656,464,466,2822
2005,5622,1454,2478,57167,56959,211,8.541,196,7.934,7330,2306,5024,4.049,12.869,6897,2737,4160,4.805,12.109,433,0.76,24.217,95,95,572
2005,5629,6571,7275,110098,111041,811,11.286,633,8.809,22246,7120,15126,6.412,20.034,24073,4530,19543,4.08,21.679,-1827,-1.645,40.068,447,448,2562
2005,6111,17202,19418,784487,774084,1177,6.127,764,3.977,72601,21445,51156,2.77,9.379,51724,10023,41701,1.295,6.682,20877,2.697,13.364,547,553,7271
2005,6112,471,829,84329,79792,63,7.702,41,5.012,14640,5651,8989,7.082,18.348,5571,587,4984,0.736,6.982,9069,11.366,13.964,33,33,440
2005,6113,2276,3452,1513550,1507973,453,13.761,133,4.04,105213,30243,74970,2.006,6.977,93849,7172,86677,0.476,6.224,11364,0.754,12.447,62,62,1158
2005,6114,5928,6439,60875,61185,893,13.812,946,14.632,11395,4530,6865,7.404,18.624,12127,4806,7321,7.855,19.82,-732,-1.196,37.248,655,671,3247
2005,6115,5894,7062,105990,104375,741,10.561,650,9.264,18664,5537,13127,5.305,17.882,15439,4196,11243,4.02,14.792,3225,3.09,29.584,481,491,2821
2005,6116,27434,29525,271050,263951,4513,15.649,3139,10.885,58859,22682,36177,8.593,22.299,45038,13926,31112,5.276,17.063,13821,5.236,34.126,2228,2238,9472
2005,6117,4661,5099,61815,60039,898,18.145,598,12.083,13613,6472,7141,10.78,22.674,10190,3062,7128,5.1,16.972,3423,5.701,33.945,402,405,2115
2005,6211,173135,197547,2029026,2037394,16119,8.216,13423,6.842,251367,86364,165003,4.239,12.338,268008,71803,196205,3.524,13.154,-16641,-0.817,24.675,9696,9905,45939
2005,6212,111766,116874,787378,794415,6356,5.476,4752,4.094,94122,30533,63589,3.843,11.848,108358,21938,86420,2.762,13.64,-14236,-1.792,23.696,3881,3958,18671
2005,6213,95334,104491,551295,548410,11424,11.11,8096,7.873,99859,35896,63963,6.545,18.209,94312,29350,64962,5.352,17.197,5547,1.011,34.395,5558,5643,20090
2005,6214,12659,25633,647925,643360,2349,9.33,1435,5.7,80685,29783,50902,4.629,12.541,72005,16834,55171,2.617,11.192,8680,1.349,22.384,752,784,8008
2005,6215,6909,10971,217755,215445,1718,16.284,876,8.303,34181,13331,20850,6.188,15.865,29661,11346,18315,5.266,13.767,4520,2.098,27.535,547,559,3812
2005,6216,12521,18287,910776,883374,3172,18.073,1700,9.686,162623,47785,114838,5.409,18.409,108570,30031,78539,3.4,12.29,54053,6.119,24.581,1133,1190,17182
2005,6219,5481,8344,247164,239875,774,9.325,686,8.265,42659,12253,30406,5.108,17.784,28261,9275,18986,3.867,11.782,14398,6.002,23.563,367,380,4751
2005,6221,3260,5237,4847605,4824804,130,2.489,100,1.915,201411,34462,166949,0.714,4.174,155597,37109,118488,0.769,3.225,45814,0.95,6.45,42,43,7861
2005,6222,526,666,211730,212763,49,7.441,34,5.163,8300,2732,5568,1.284,3.901,10304,6329,3975,2.975,4.843,-2004,-0.942,7.802,18,19,2873
2005,6223,547,887,203698,201147,122,14.353,48,5.647,16099,4708,11391,2.341,8.004,11254,3313,7941,1.647,5.595,4845,2.409,11.19,24,24,756
2005,6231,8488,16072,1606463,1607747,1347,8.467,1019,6.406,148065,70177,77888,4.365,9.209,150988,67780,83208,4.216,9.391,-2923,-0.182,18.419,517,534,27649
2005,6232,8015,30165,555177,545305,2615,8.854,1353,4.581,75935,25699,50236,4.713,13.925,56420,13299,43121,2.439,10.347,19515,3.579,20.693,366,453,4604
2005,6233,13185,17632,624936,614208,1869,10.675,1623,9.27,84251,38483,45768,6.265,13.717,62849,24971,37878,4.066,10.233,21402,3.484,20.465,1146,1206,15443
2005,6239,3556,6126,156119,156879,448,7.317,441,7.203,16973,4585,12388,2.923,10.819,18312,5334,12978,3.4,11.673,-1339,-0.854,21.638,236,248,2487
2005,6241,36962,51257,1040017,1015613,4560,9.019,3170,6.27,155183,41821,113362,4.118,15.28,106737,26185,80552,2.578,10.51,48446,4.77,21.019,1968,2017,14425
2005,6242,9251,12502,155774,154126,604,4.843,545,4.37,18680,3386,15294,2.197,12.12,15461,3474,11987,2.254,10.031,3219,2.089,20.063,279,284,1816
2005,6243,4869,7933,333747,328355,514,6.492,484,6.113,51535,12034,39501,3.665,15.695,40761,7546,33215,2.298,12.414,10774,3.281,24.827,246,271,3035
2005,6244,53051,66567,799735,794699,7622,11.526,6742,10.196,124736,50162,74574,6.312,15.696,114499,40376,74123,5.081,14.408,10237,1.288,28.816,4979,5084,28666
2005,7111,7379,7523,133113,129405,896,11.86,960,12.707,30169,12520,17649,9.675,23.314,22180,6781,15399,5.24,17.14,7989,6.174,34.28,639,643,4692
2005,7112,3297,3471,116967,114823,521,15.156,454,13.207,20956,6556,14400,5.71,18.251,16841,3900,12941,3.397,14.667,4115,3.584,29.334,334,335,2244
2005,7113,4508,4829,105678,106125,603,12.58,532,11.098,19886,4318,15568,4.069,18.738,20789,4547,16242,4.285,19.589,-903,-0.851,37.477,373,373,2449
2005,7114,2646,2706,18947,17310,432,16.14,373,13.936,6304,4989,1315,28.822,36.419,3292,1094,2198,6.32,19.018,3012,17.401,38.037,267,271,840
2005,7115,12176,12193,42869,43598,2604,21.843,2061,17.288,13260,6188,7072,14.193,30.414,14765,5510,9255,12.638,33.866,-1505,-3.452,60.828,1219,1222,3176
2005,7121,5932,6349,121146,120433,432,6.867,315,5.008,10708,1555,9153,1.291,8.891,9341,974,8367,0.809,7.756,1367,1.135,15.512,187,187,587
2005,7131,1823,2348,146205,143082,368,15.703,359,15.319,17222,4827,12395,3.374,12.036,11016,2829,8187,1.977,7.699,6206,4.337,15.398,228,231,2136
2005,7132,1688,2189,188560,183482,277,12.926,185,8.633,24993,8760,16233,4.774,13.621,15249,2044,13205,1.114,8.311,9744,5.311,16.622,140,140,1417
2005,7139,49959,55366,1065763,1059351,7328,13.436,5677,10.409,163807,62215,101592,5.873,15.463,151299,47861,103438,4.518,14.282,12508,1.181,28.564,4368,4400,34551
2005,7211,36926,46788,1797087,1792649,4971,10.646,4784,10.245,234854,104347,130507,5.821,13.101,225360,98521,126839,5.496,12.571,9494,0.53,25.143,3146,3333,57523
2005,7212,5014,5500,37743,37750,532,9.675,529,9.621,6869,2318,4551,6.14,18.196,6919,2139,4780,5.666,18.329,-50,-0.132,36.393,355,358,1444
2005,7213,2168,2235,12413,12861,142,6.264,206,9.087,1664,458,1206,3.561,12.938,2578,1168,1410,9.082,20.045,-914,-7.107,25.877,141,143,980
2005,7223,11263,29358,560213,542634,4368,15.285,2806,9.819,118716,67775,50941,12.49,21.878,84848,31136,53712,5.738,15.636,33868,6.241,31.273,1434,1477,10465
2005,7224,41934,42494,352677,356722,5159,12.049,5807,13.562,76141,40754,35387,11.425,21.345,84073,33950,50123,9.517,23.568,-7932,-2.224,42.689,4787,4805,28162
2005,7225,301409,411287,8282728,8159697,56199,13.864,44367,10.945,1530421,805583,724838,9.873,18.756,1289708,453117,836591,5.553,15.806,240713,2.95,31.612,34310,35188,327684
2005,8111,139431,152463,876656,888510,15166,9.939,15421,10.106,145340,62803,82537,7.068,16.358,168699,57455,111244,6.466,18.987,-23359,-2.629,32.715,11835,12029,43808
2005,8112,10922,12360,129427,129665,1284,10.266,1579,12.624,21808,8953,12855,6.905,16.819,22434,6984,15450,5.386,17.302,-626,-0.483,33.638,1123,1146,3732
2005,8113,20915,22319,181975,181242,2219,10.011,1911,8.622,28275,8230,20045,4.541,15.601,27009,8085,18924,4.461,14.902,1266,0.699,29.804,1417,1430,5454
2005,8114,19944,21069,103540,105485,2462,11.607,2745,12.942,16471,6704,9767,6.355,15.615,20376,7410,12966,7.025,19.316,-3905,-3.702,31.229,2013,2065,5443
2005,8121,81689,95659,591023,587282,13708,14.516,11252,11.916,107841,56048,51793,9.544,18.363,100302,39957,60345,6.804,17.079,7539,1.284,34.158,9061,9257,32772
2005,8122,14733,20438,136678,140871,934,4.532,1278,6.201,16093,3521,12572,2.499,11.424,24747,5863,18884,4.162,17.567,-8654,-6.143,22.848,474,493,1638
2005,8123,32001,38570,368592,374705,4239,10.954,4496,11.618,49027,19673,29354,5.25,13.084,61126,22085,39041,5.894,16.313,-12099,-3.229,26.168,3268,3375,14561
2005,8129,20672,31708,226702,228050,5076,16.064,4858,15.374,49090,22273,26817,9.767,21.526,51549,21804,29745,9.561,22.604,-2459,-1.078,43.052,2682,2723,10819
2005,8131,165156,165535,1615566,1619437,8367,5.081,6634,4.029,156086,27396,128690,1.692,9.638,164354,22993,141361,1.42,10.149,-8268,-0.511,19.277,4168,4168,11998
2005,8132,13728,15664,153033,151673,1285,8.313,871,5.635,17083,4019,13064,2.65,11.263,14378,3493,10885,2.303,9.48,2705,1.783,18.959,553,566,2573
2005,8133,11549,13688,121960,121210,1137,8.391,863,6.369,17143,4258,12885,3.513,14.143,15782,3397,12385,2.803,13.02,1361,1.123,26.041,498,498,1957
2005,8134,28206,30275,321848,323697,1437,4.734,1596,5.258,34040,5553,28487,1.715,10.516,37638,6176,31462,1.908,11.628,-3598,-1.112,21.032,1109,1112,4381
2005,8139,60411,62321,529128,535732,2632,4.194,3492,5.565,58368,9318,49050,1.739,10.895,71373,16084,55289,3.002,13.323,-13005,-2.428,21.79,2363,2374,10345
2006,1131,326,371,2713,3546,46,12.366,48,12.903,431,175,256,4.935,12.155,2172,1942,230,54.766,61.252,-1741,-49.098,24.309,32,32,338
2006,1132,131,186,1920,1785,30,16.62,19,10.526,517,279,238,15.63,28.964,246,133,113,7.451,13.782,271,15.182,27.563,13,13,101
2006,1133,8935,9006,61694,62553,977,10.767,1113,12.266,9930,3413,6517,5.456,15.875,11535,4167,7368,6.662,18.44,-1605,-2.566,31.749,830,830,2749
2006,1141,1161,1173,5501,5412,249,21.466,223,19.224,1237,534,703,9.868,22.859,1055,453,602,8.371,19.496,182,3.363,38.991,132,132,272
2006,1142,270,270,1821,1743,45,17.045,33,12.5,339,109,230,6.255,19.455,185,62,123,3.558,10.617,154,8.838,21.234,27,27,54
2006,1151,3405,3723,58190,57789,481,12.989,441,11.909,11654,3933,7721,6.806,20.166,10793,3198,7595,5.534,18.677,861,1.49,37.353,323,323,2259
2006,1152,3489,3558,18658,18476,573,16.196,533,15.065,3410,1396,2014,7.556,18.456,3003,1379,1624,7.464,16.254,407,2.203,32.507,423,423,1153
2006,1153,1282,1354,13774,13901,224,16.867,172,12.952,3110,1013,2097,7.288,22.373,3347,1214,2133,8.733,24.078,-237,-1.705,44.747,121,121,934
2006,2111,5728,6849,91077,86865,780,11.582,551,8.182,19525,7982,11543,9.189,22.478,10870,4623,6247,5.322,12.514,8655,9.964,25.027,350,353,1436
2006,2121,628,1049,78189,76096,125,12.054,101,9.74,12524,3840,8684,5.046,16.458,8314,3108,5206,4.084,10.926,4210,5.532,21.851,58,63,1281
2006,2122,189,259,27934,27061,31,11.969,31,11.969,2747,185,2562,0.684,10.151,962,316,646,1.168,3.555,1785,6.596,7.11,21,21,48
2006,2123,3296,5468,99618,98070,498,9.246,334,6.201,13990,4491,9499,4.579,14.265,10903,2603,8300,2.654,11.118,3087,3.148,22.235,192,194,1059
2006,2131,8103,9660,255017,234893,1551,16.684,824,8.864,66877,25606,41271,10.901,28.471,26333,12208,14125,5.197,11.211,40544,17.261,22.421,500,515,4546
2006,2211,1581,9409,498244,506070,568,6.054,513,5.468,37538,13718,23820,2.711,7.418,52840,9150,43690,1.808,10.441,-15302,-3.024,14.835,56,58,1561
2006,2212,468,2437,81212,81053,257,10.546,257,10.546,9240,3428,5812,4.229,11.4,8830,3770,5060,4.651,10.894,410,0.506,21.788,29,32,155
2006,2213,4063,4868,41036,40812,295,6.042,324,6.636,5113,1669,3444,4.09,12.528,4647,1574,3073,3.857,11.386,466,1.142,22.773,178,178,1013
2006,2361,165941,167263,986431,945679,33796,20.783,24492,15.062,272448,113463,158985,11.998,28.81,191696,80396,111300,8.501,20.271,80752,8.539,40.541,18063,18116,58270
2006,2362,37421,38575,728082,705262,4795,12.623,3616,9.519,150812,31922,118890,4.526,21.384,105240,23621,81619,3.349,14.922,45572,6.462,29.844,2697,2708,15922
2006,2371,18696,19700,500844,477131,1979,10.134,1634,8.368,113148,25543,87605,5.353,23.714,66331,17852,48479,3.742,13.902,46817,9.812,27.804,1138,1143,8671
2006,2372,10326,10419,75515,71452,1859,18.286,1354,13.318,19924,6579,13345,9.208,27.884,11754,5263,6491,7.366,16.45,8170,11.434,32.9,1057,1057,4181
2006,2373,9873,10632,326747,318824,931,8.813,794,7.516,59309,11169,48140,3.503,18.602,43496,8104,35392,2.542,13.643,15813,4.96,27.285,509,510,3942
2006,2379,4368,4585,87844,84381,668,14.902,463,10.329,19023,4700,14323,5.57,22.544,12016,2643,9373,3.132,14.24,7007,8.304,28.48,321,322,1373
2006,2381,98451,99142,1171835,1122201,15645,16.066,12124,12.45,300639,85786,214853,7.644,26.79,201511,59981,141530,5.345,17.957,99128,8.833,35.914,8939,8945,45193
2006,2382,160085,163662,1954645,1887897,20704,12.903,14301,8.912,396936,94818,302118,5.022,21.025,263975,71363,192612,3.78,13.982,132961,7.043,27.965,10814,10858,52110
2006,2383,112170,113375,975305,937192,20188,18.242,14779,13.354,249399,79956,169443,8.531,26.611,174270,56200,118070,5.997,18.595,75129,8.016,37.19,11106,11109,42211
2006,2389,59398,59948,557011,525697,11485,19.928,6855,11.894,143636,49490,94146,9.414,27.323,80981,27409,53572,5.214,15.405,62655,11.918,30.809,4992,4993,19437
2006,3111,1163,1730,48127,47550,120,6.987,95,5.531,5263,1273,3990,2.677,11.068,4062,1011,3051,2.126,8.543,1201,2.526,17.085,58,60,384
2006,3112,456,777,55275,55810,39,5,45,5.769,3241,593,2648,1.063,5.807,4335,718,3617,1.287,7.767,-1094,-1.96,11.614,25,25,217
2006,3113,1506,1675,71768,73077,147,8.74,161,9.572,6163,950,5213,1.3,8.434,8797,2512,6285,3.437,12.038,-2634,-3.604,16.867,134,134,1020
2006,3114,1219,1589,162797,162706,103,6.394,147,9.125,15497,3414,12083,2.098,9.525,15358,4448,10910,2.734,9.439,139,0.085,18.878,91,91,1367
2006,3115,995,1487,130681,131917,89,5.959,102,6.83,9200,2679,6521,2.031,6.974,11702,4692,7010,3.557,8.871,-2502,-1.897,13.948,55,56,1402
2006,3116,2950,3563,499487,497852,197,5.483,257,7.153,34292,4841,29451,0.972,6.888,31653,7664,23989,1.539,6.358,2639,0.53,12.716,193,193,2144
2006,3117,515,607,35827,36834,43,6.891,77,12.34,3547,700,2847,1.9,9.63,5490,1959,3531,5.319,14.905,-1943,-5.275,19.26,51,51,733
2006,3118,8877,9643,293405,294227,880,9.047,1047,10.764,32340,8411,23929,2.859,10.992,33859,12101,21758,4.113,11.508,-1519,-0.516,21.983,826,839,6321
2006,3119,2534,2969,160068,159911,277,9.388,240,8.134,15204,4211,10993,2.633,9.508,14833,4840,9993,3.027,9.276,371,0.232,18.552,181,183,3173
2006,3121,2624,3178,134879,134036,381,12.328,206,6.666,12960,2640,10320,1.97,9.669,11477,2394,9083,1.786,8.563,1483,1.106,17.125,150,150,1342
2006,3122,84,116,21222,21579,17,14.592,18,15.451,926,173,753,0.802,4.291,1602,279,1323,1.293,7.424,-676,-3.133,8.582,9,9,32
2006,3131,290,435,48503,50370,29,6.452,58,12.903,4277,1319,2958,2.619,8.491,8093,3659,4434,7.264,16.067,-3816,-7.576,16.982,32,32,276
2006,3132,1129,1311,93330,98852,60,4.433,145,10.713,6696,2436,4260,2.464,6.774,18136,7050,11086,7.132,18.347,-11440,-11.573,13.548,93,95,1155
2006,3133,1233,1299,48822,50370,102,7.716,148,11.195,5006,1777,3229,3.528,9.938,8126,3477,4649,6.903,16.133,-3120,-6.194,19.877,111,113,1815
2006,3141,2299,2445,80893,83828,186,7.433,301,12.028,5818,1395,4423,1.664,6.94,11725,5084,6641,6.065,13.987,-5907,-7.047,13.881,241,243,1764
2006,3149,4196,4318,80290,81630,349,7.935,509,11.573,9618,1986,7632,2.433,11.783,12402,4888,7514,5.988,15.193,-2784,-3.411,23.565,416,416,2752
2006,3151,439,485,30475,31816,26,5.123,71,13.99,3198,1836,1362,5.771,10.052,5790,2243,3547,7.05,18.199,-2592,-8.147,20.103,57,57,978
2006,3152,7130,7273,159004,166924,1350,18.362,1508,20.511,28561,14363,14198,8.605,17.11,44311,21091,23220,12.635,26.546,-15750,-9.435,34.22,1351,1354,15802
2006,3159,816,841,16724,17614,70,8.005,137,15.666,1700,625,1075,3.548,9.652,3514,1305,2209,7.409,19.951,-1814,-10.299,19.303,112,112,605
2006,3161,215,223,6098,6427,21,9.524,16,7.256,510,89,421,1.385,7.936,1156,180,976,2.801,17.988,-646,-10.052,15.872,13,13,113
2006,3162,239,263,15328,15674,16,5.893,33,12.155,1202,376,826,2.399,7.669,1864,762,1102,4.862,11.893,-662,-4.224,15.338,20,22,365
2006,3169,752,763,15995,16276,68,8.769,93,11.992,1975,363,1612,2.23,12.134,2570,1354,1216,8.319,15.79,-595,-3.656,24.269,71,71,549
2006,3211,3583,4024,118004,117000,321,7.968,330,8.192,13001,3713,9288,3.174,11.112,10931,3873,7058,3.31,9.343,2070,1.769,18.686,259,259,2356
2006,3212,1475,1887,125268,123164,147,7.869,109,5.835,14182,4060,10122,3.296,11.515,9994,2379,7615,1.932,8.114,4188,3.4,16.229,67,67,936
2006,3219,9216,10160,343331,336007,961,9.499,875,8.649,50457,14726,35731,4.383,15.017,35475,11077,24398,3.297,10.558,14982,4.459,21.116,681,687,6488
2006,3221,273,564,138066,142221,30,5.222,51,8.877,3439,880,2559,0.619,2.418,11993,6078,5915,4.274,8.433,-8554,-6.015,4.836,16,16,707
2006,3222,2977,4470,304062,307674,190,4.204,288,6.373,22393,6637,15756,2.157,7.278,29851,10464,19387,3.401,9.702,-7458,-2.424,14.556,146,146,2283
2006,3231,30406,32019,646886,655095,1995,6.143,2912,8.966,61925,18832,43093,2.875,9.453,78264,28051,50213,4.282,11.947,-16339,-2.494,18.906,2404,2409,16578
2006,3241,1037,2277,100153,100793,190,8.441,138,6.131,8081,2464,5617,2.445,8.017,9502,4444,5058,4.409,9.427,-1421,-1.41,16.035,47,47,812
2006,3251,1233,2320,162909,163946,168,7.273,148,6.407,10380,3110,7270,1.897,6.331,12547,2601,9946,1.586,7.653,-2167,-1.322,12.663,52,53,401
2006,3252,749,1066,89069,90964,79,7.432,73,6.867,5641,1155,4486,1.27,6.201,9375,3139,6236,3.451,10.306,-3734,-4.105,12.403,40,41,1198
2006,3253,630,884,29162,29611,66,7.496,59,6.701,1987,490,1497,1.655,6.71,2832,794,2038,2.681,9.564,-845,-2.854,13.421,33,33,220
2006,3254,1392,1805,247288,244930,153,8.55,122,6.818,20562,3279,17283,1.339,8.395,15833,3984,11849,1.627,6.464,4729,1.931,12.929,74,74,1312
2006,3255,1447,1848,63924,64199,111,6.008,110,5.954,5465,1471,3994,2.291,8.513,6150,1715,4435,2.671,9.58,-685,-1.067,17.025,72,72,746
2006,3256,1946,2169,103687,104073,146,6.741,140,6.464,8590,2571,6019,2.47,8.254,9374,2223,7151,2.136,9.007,-784,-0.753,16.508,102,102,1266
2006,3259,2072,2663,107487,108535,216,8.133,202,7.605,9092,1844,7248,1.699,8.377,11111,3081,8030,2.839,10.237,-2019,-1.86,16.754,116,116,956
2006,3261,9377,11941,738485,738119,624,5.198,751,6.256,70532,17435,53097,2.362,9.556,70093,20182,49911,2.734,9.496,439,0.059,18.992,501,509,7951
2006,3262,1688,2190,157395,158491,122,5.589,108,4.947,9045,2331,6714,1.471,5.707,11100,2149,8951,1.356,7.004,-2055,-1.297,11.414,72,72,667
2006,3271,1237,1443,53041,53988,131,8.988,160,10.978,4501,1001,3500,1.854,8.337,6356,2056,4300,3.808,11.773,-1855,-3.436,16.674,119,119,540
2006,3272,1656,1980,102054,102290,152,7.632,175,8.787,8908,1144,7764,1.118,8.709,9205,2882,6323,2.817,8.999,-297,-0.29,17.417,134,134,940
2006,3273,4941,9749,229571,223480,913,9.573,489,5.127,39367,14380,24987,6.435,17.615,27033,5955,21078,2.665,12.096,12334,5.519,24.193,228,245,2581
2006,3274,209,336,18157,18034,17,5.022,22,6.499,1510,227,1283,1.259,8.373,1238,158,1080,0.876,6.865,272,1.508,13.73,15,15,113
2006,3279,2710,3167,81970,79326,370,12.001,202,6.552,12488,4137,8351,5.215,15.743,7125,2399,4726,3.024,8.982,5363,6.761,17.964,147,147,1765
2006,3311,399,515,107896,107586,38,7.266,54,10.325,4655,986,3669,0.916,4.327,4114,912,3202,0.848,3.824,541,0.503,7.648,38,38,415
2006,3312,470,611,45595,45736,36,5.882,38,6.209,3393,688,2705,1.504,7.419,3648,1111,2537,2.429,7.976,-255,-0.558,14.837,26,26,243
2006,3313,416,572,65275,65716,36,6.299,35,6.124,3628,899,2729,1.368,5.521,4605,701,3904,1.067,7.007,-977,-1.487,11.042,20,20,124
2006,3314,722,917,61433,61875,51,5.583,44,4.817,3465,712,2753,1.151,5.6,4449,841,3608,1.359,7.19,-984,-1.59,11.2,27,27,103
2006,3315,1880,2137,167771,166275,100,4.666,112,5.226,14522,2711,11811,1.63,8.734,11582,2642,8940,1.589,6.966,2940,1.768,13.931,82,83,1465
2006,3321,2390,2641,126514,126604,129,4.885,128,4.848,11765,3128,8637,2.471,9.293,11802,3356,8446,2.651,9.322,-37,-0.029,18.586,88,90,1855
2006,3322,1297,1416,53867,55007,84,5.882,108,7.563,3876,511,3365,0.929,7.046,6169,2416,3753,4.392,11.215,-2293,-4.169,14.093,73,73,398
2006,3323,12028,12972,398000,386876,973,7.546,817,6.336,57432,11366,46066,2.938,14.845,34991,9210,25781,2.381,9.045,22441,5.801,18.089,598,599,4660
2006,3324,1246,1508,88410,87469,64,4.212,87,5.726,8262,958,7304,1.095,9.446,6370,1804,4566,2.062,7.283,1892,2.163,14.565,58,66,854
2006,3325,693,775,44774,46986,41,5.287,42,5.416,2898,737,2161,1.569,6.168,7263,3801,3462,8.09,15.458,-4365,-9.29,12.336,30,30,643
2006,3326,1410,1590,54772,55085,55,3.403,107,6.621,4949,815,4134,1.48,8.984,5674,1328,4346,2.411,10.301,-725,-1.316,17.969,74,74,615
2006,3327,23230,23674,390279,384034,1516,6.409,1474,6.232,47146,9720,37426,2.531,12.277,34667,9676,24991,2.52,9.027,12479,3.249,18.054,1170,1175,6766
2006,3328,5392,5950,137233,136696,326,5.446,399,6.665,15485,3799,11686,2.779,11.328,14510,4223,10287,3.089,10.615,975,0.713,21.23,305,309,2473
2006,3329,5597,6139,275319,270883,506,8.342,359,5.919,30350,8749,21601,3.23,11.204,21594,6382,15212,2.356,7.972,8756,3.232,15.943,244,244,3028
2006,3331,2505,2826,195419,189285,202,7.21,153,5.461,26717,4564,22153,2.411,14.115,13766,4448,9318,2.35,7.273,12951,6.842,14.545,105,106,991
2006,3332,3515,3713,133824,134121,209,5.579,276,7.367,12370,2675,9695,1.994,9.223,12876,4713,8163,3.514,9.6,-506,-0.377,18.446,185,186,1871
2006,3333,2046,2196,97699,98398,149,6.764,163,7.399,8099,2455,5644,2.495,8.231,9389,2949,6440,2.997,9.542,-1290,-1.311,16.462,118,118,1140
2006,3334,1455,1755,152204,151143,113,6.428,119,6.769,14352,1701,12651,1.125,9.496,12312,4779,7533,3.162,8.146,2040,1.35,16.292,82,84,1456
2006,3335,7572,7866,174065,173908,332,4.176,500,6.289,16345,2626,13719,1.51,9.399,15941,5627,10314,3.236,9.166,404,0.232,18.333,397,397,3249
2006,3336,743,900,101963,100393,57,6.372,46,5.143,7950,907,7043,0.903,7.919,4599,1162,3437,1.157,4.581,3351,3.338,9.162,28,28,352
2006,3339,5423,6070,284780,284041,361,5.93,397,6.521,27189,5253,21936,1.849,9.572,25786,10868,14918,3.826,9.078,1403,0.494,18.157,266,266,2880
2006,3341,1121,1186,99066,96087,115,9.571,146,12.151,17477,7755,9722,8.071,18.189,10820,2533,8287,2.636,11.261,6657,6.928,22.521,110,112,1373
2006,3342,1530,1736,146400,144227,131,7.527,140,8.044,23189,3247,19942,2.251,16.078,19700,7158,12542,4.963,13.659,3489,2.419,27.318,97,98,1562
2006,3343,429,449,18667,19330,53,12.1,31,7.078,1652,446,1206,2.307,8.546,2996,712,2284,3.683,15.499,-1344,-6.953,17.093,28,28,185
2006,3344,4091,4623,367527,363929,290,6.26,309,6.67,39535,7670,31865,2.108,10.863,31941,9638,22303,2.648,8.777,7594,2.087,17.553,202,202,3117
2006,3345,4344,5048,389134,394012,378,7.538,311,6.202,35744,8460,27284,2.147,9.072,45416,11005,34411,2.793,11.527,-9672,-2.455,18.144,203,205,2467
2006,3346,703,749,33024,33718,64,8.477,76,10.066,2276,461,1815,1.367,6.75,3654,1112,2542,3.298,10.837,-1378,-4.087,13.5,52,52,807
2006,3351,1044,1132,57330,58220,65,5.677,91,7.948,4525,788,3737,1.353,7.772,6422,2014,4408,3.459,11.031,-1897,-3.258,15.544,62,62,805
2006,3352,275,329,74669,77699,34,10.256,39,11.765,2548,309,2239,0.398,3.279,8884,1219,7665,1.569,11.434,-6336,-8.155,6.559,30,30,361
2006,3353,1997,2331,139402,139246,116,4.97,122,5.227,11938,1773,10165,1.273,8.573,11425,3737,7688,2.684,8.205,513,0.368,16.41,70,70,780
2006,3359,1762,2112,150433,148470,154,7.311,143,6.789,15230,4583,10647,3.087,10.258,11299,3815,7484,2.57,7.61,3931,2.648,15.221,91,91,1332
2006,3361,264,335,205734,206877,24,6.957,44,12.754,21283,2729,18554,1.319,10.288,24180,6669,17511,3.224,11.688,-2897,-1.4,20.576,31,31,400
2006,3362,1796,2082,157858,153700,187,9.058,152,7.363,21614,4381,17233,2.85,14.063,13489,4432,9057,2.884,8.776,8125,5.286,17.552,118,118,2825
2006,3363,4330,5472,642542,655751,388,7.102,371,6.791,53559,15830,37729,2.414,8.168,79202,19909,59293,3.036,12.078,-25643,-3.91,16.335,247,261,7886
2006,3364,1199,1569,398469,389994,119,7.663,87,5.602,52827,8028,44799,2.058,13.546,35608,3181,32427,0.816,9.13,17219,4.415,18.261,64,65,1569
2006,3365,160,219,30467,29965,10,4.608,6,2.765,3037,181,2856,0.604,10.135,2050,118,1932,0.394,6.841,987,3.294,13.683,3,3,17
2006,3366,1517,1645,144958,144600,174,10.603,166,10.116,10781,2061,8720,1.425,7.456,10037,3095,6942,2.14,6.941,744,0.515,13.882,129,129,1242
2006,3369,846,879,45689,45864,131,15.313,84,9.819,5359,1877,3482,4.093,11.685,5902,1526,4376,3.327,12.869,-543,-1.184,23.369,66,66,799
2006,3371,14741,15177,355754,358334,1402,9.232,1420,9.351,37616,8701,28915,2.428,10.497,42255,16367,25888,4.568,11.792,-4639,-1.295,20.995,1118,1123,7509
2006,3372,3801,3985,145559,145553,264,6.612,279,6.988,16248,3574,12674,2.455,11.163,16101,4898,11203,3.365,11.062,147,0.101,22.124,207,208,2191
2006,3379,869,1003,46230,46588,56,5.498,87,8.542,5376,796,4580,1.709,11.539,5957,1935,4022,4.153,12.787,-581,-1.247,23.079,61,64,728
2006,3391,10716,11522,314715,310660,794,6.888,804,6.975,34258,7000,27258,2.253,11.028,26051,7547,18504,2.429,8.386,8207,2.642,16.771,604,607,4194
2006,3399,17306,17788,372638,373309,1750,9.873,1625,9.168,45265,12924,32341,3.462,12.125,46905,13981,32924,3.745,12.565,-1640,-0.439,24.251,1299,1306,9288
2006,4231,17421,24342,376298,373119,2154,8.897,1889,7.803,51214,18765,32449,5.029,13.726,45119,15550,29569,4.168,12.092,6095,1.634,24.185,1281,1353,7656
2006,4232,11099,12850,165734,164397,1363,10.699,1143,8.972,23265,7066,16199,4.298,14.152,20661,6560,14101,3.99,12.568,2604,1.584,25.136,872,897,4670
2006,4233,12125,18404,276895,270038,1810,10.026,1108,6.137,44264,15289,28975,5.662,16.392,30719,9094,21625,3.368,11.376,13545,5.016,22.752,676,703,4487
2006,4234,25140,34677,730062,723713,3556,10.298,3261,9.444,107035,36737,70298,5.076,14.79,95087,31614,63473,4.368,13.139,11948,1.651,26.278,1964,2053,12561
2006,4235,7496,10338,158051,154488,750,7.335,525,5.134,20295,5478,14817,3.546,13.137,13170,3053,10117,1.976,8.525,7125,4.612,17.05,344,349,1613
2006,4236,19709,29103,471632,472157,2747,9.483,2479,8.557,68314,20273,48041,4.294,14.469,68840,28980,39860,6.138,14.58,-526,-0.111,28.937,1292,1389,9254
2006,4237,11034,18975,231198,225164,1881,10.094,1201,6.445,37748,16994,20754,7.547,16.765,24702,9825,14877,4.363,10.971,13046,5.794,21.941,547,609,3401
2006,4238,42349,58130,718388,705234,4071,7.031,3612,6.238,94856,29354,65502,4.162,13.45,68699,22805,45894,3.234,9.741,26157,3.709,19.483,2313,2405,12894
2006,4239,27848,30888,341098,337175,3414,11.092,3195,10.381,52261,17921,34340,5.315,15.5,44601,16640,27961,4.935,13.228,7660,2.272,26.456,2422,2456,11660
2006,4241,9009,11692,182276,192446,893,7.544,1183,9.994,22038,7493,14545,3.894,11.452,41931,12237,29694,6.359,21.788,-19893,-10.337,22.903,635,656,3977
2006,4242,5759,7641,263383,264516,937,12.35,829,10.927,41558,16884,24674,6.383,15.711,42670,16985,25685,6.421,16.131,-1112,-0.42,31.422,566,572,7393
2006,4243,13622,14852,205220,207826,1840,12.444,1709,11.558,31422,11904,19518,5.728,15.119,36846,9415,27431,4.53,17.729,-5424,-2.61,30.239,1364,1381,6533
2006,4244,25373,31535,778834,772374,2884,9.14,2919,9.251,101791,27759,74032,3.594,13.179,89963,23682,66281,3.066,11.648,11828,1.531,23.295,2160,2184,14344
2006,4245,3944,6458,62331,62854,346,5.318,442,6.794,7778,2272,5506,3.615,12.375,8777,2559,6218,4.071,13.964,-999,-1.589,24.75,258,284,1282
2006,4246,8327,12277,142682,144028,979,8.017,849,6.952,18064,5281,12783,3.667,12.542,20810,8437,12373,5.858,14.449,-2746,-1.907,25.084,525,533,2591
2006,4247,4934,7055,104874,105550,406,5.696,552,7.744,13097,3634,9463,3.443,12.408,14441,5042,9399,4.777,13.682,-1344,-1.273,24.817,286,296,1833
2006,4248,3135,3943,176348,173285,330,8.404,297,7.564,18873,5390,13483,3.11,10.891,12621,5807,6814,3.351,7.283,6252,3.608,14.567,221,223,3299
2006,4249,22731,28824,372444,375261,3103,10.782,3012,10.466,47294,17524,29770,4.67,12.603,52977,16328,36649,4.351,14.117,-5683,-1.514,25.206,2225,2256,9874
2006,4251,38748,40848,298342,298986,5647,13.94,4969,12.266,46331,16541,29790,5.532,15.496,48545,22287,26258,7.454,16.237,-2214,-0.741,30.992,3873,3898,15231
2006,4411,43727,48471,1285341,1286702,4803,9.942,4483,9.279,143308,58942,84366,4.581,11.138,145923,43522,102401,3.382,11.341,-2615,-0.203,22.275,3586,3628,32364
2006,4412,13755,15460,167020,164945,1724,11.289,1347,8.82,26560,10022,16538,6.076,16.102,22247,6924,15323,4.198,13.488,4313,2.615,26.975,1091,1102,4999
2006,4413,31105,56409,490610,491362,3898,6.933,3529,6.277,55678,21661,34017,4.408,11.331,56887,14204,42683,2.891,11.577,-1209,-0.246,22.663,2537,2654,9615
2006,4421,18830,26907,277504,275882,2885,10.721,2891,10.743,47143,20156,26987,7.306,17.088,44107,14749,29358,5.346,15.988,3036,1.1,31.975,2030,2210,10385
2006,4422,24995,34306,297187,297558,3472,10.12,3474,10.126,42995,18429,24566,6.193,14.449,44165,14408,29757,4.842,14.843,-1170,-0.393,28.899,2408,2470,8300
2006,4431,29064,49212,511780,510192,5310,10.702,6124,12.342,88990,27977,61013,5.484,17.442,85298,38790,46508,7.603,16.719,3692,0.724,33.438,4082,4225,19186
2006,4441,43829,65604,1215328,1162533,5468,8.448,3713,5.736,200151,108878,91273,9.366,17.217,96904,24584,72320,2.115,8.336,103247,8.881,16.671,2684,2755,13013
2006,4442,15251,18579,171382,170410,1480,7.975,1437,7.743,25189,8466,16723,4.968,14.781,23219,6833,16386,4.01,13.625,1970,1.156,27.251,1041,1054,4780
2006,4451,58264,84677,2604308,2614069,9111,10.748,9288,10.957,278352,110429,167923,4.224,10.648,300126,93201,206925,3.565,11.481,-21774,-0.833,21.296,6923,7025,41111
2006,4452,17089,20589,144617,144540,3296,16.021,3263,15.861,31710,15804,15906,10.934,21.939,31206,14062,17144,9.729,21.59,504,0.349,43.18,2338,2370,9033
2006,4453,24108,27592,141379,138708,3062,11.204,2537,9.283,25990,10938,15052,7.886,18.737,20649,8554,12095,6.167,14.887,5341,3.851,29.773,2003,2021,7062
2006,4461,40088,83343,1089981,1055159,8673,10.605,5559,6.797,184049,86598,97451,8.207,17.443,116337,33655,82682,3.19,11.026,67712,6.417,22.051,3343,3534,16247
2006,4471,63606,112844,921793,919018,10720,9.506,10568,9.371,160574,69008,91566,7.509,17.472,154670,58081,96589,6.32,16.83,5904,0.642,33.66,6695,7134,36859
2006,4481,35706,89377,1250983,1217006,10690,12.13,8191,9.294,216683,92069,124614,7.565,17.805,151505,42545,108960,3.496,12.449,65178,5.356,24.898,4304,5082,18913
2006,4482,6209,25615,203085,194582,1932,7.582,1666,6.538,50593,12529,38064,6.439,26.001,32678,8423,24255,4.329,16.794,17915,9.207,33.588,568,763,2732
2006,4483,17803,28197,170855,169033,2202,7.784,2386,8.434,27804,8208,19596,4.856,16.449,23710,6781,16929,4.012,14.027,4094,2.422,28.054,1613,1640,4333
2006,4511,27940,38210,432578,425155,4314,11.312,4167,10.927,77178,38624,38554,9.085,18.153,61246,22825,38421,5.369,14.406,15932,3.747,28.811,3133,3219,11639
2006,4512,5784,11505,146765,143405,986,8.513,1140,9.843,22775,9249,13526,6.45,15.882,15480,5401,10079,3.766,10.795,7295,5.087,21.589,818,840,3351
2006,4522,130,5406,736507,725423,305,5.733,133,2.5,61770,30142,31628,4.155,8.515,39654,6634,33020,0.915,5.466,22116,3.049,10.933,36,49,976
2006,4523,8676,38679,2150659,2095092,3303,8.638,2423,6.336,223283,81724,141559,3.901,10.657,112441,15339,97102,0.732,5.367,110842,5.291,10.734,1511,1605,7051
2006,4531,17780,18650,97644,99829,1689,8.874,2454,12.894,15254,5279,9975,5.288,15.28,19356,7104,12252,7.116,19.389,-4102,-4.109,30.56,2069,2075,5907
2006,4532,26189,37452,315142,317587,4261,11.267,4994,13.205,48683,20291,28392,6.389,15.329,53542,19072,34470,6.005,16.859,-4859,-1.53,30.658,3812,3945,13580
2006,4533,11977,16383,133336,131075,1739,10.535,1988,12.043,22370,8408,13962,6.415,17.067,17718,6536,11182,4.986,13.518,4652,3.549,27.035,1578,1615,4561
2006,4539,31534,40287,259946,259109,4922,12.223,4883,12.126,49282,20788,28494,8.023,19.02,47590,17927,29663,6.919,18.367,1692,0.653,36.734,3681,3795,12424
2006,4541,15638,16615,285472,277818,2904,18.032,1883,11.692,55421,21370,34051,7.692,19.949,39755,15631,24124,5.626,14.31,15666,5.639,28.62,1487,1491,7657
2006,4542,4148,4716,52032,52640,456,9.508,616,12.844,5904,2228,3676,4.233,11.216,7153,2551,4602,4.846,13.589,-1249,-2.373,22.432,497,508,1935
2006,4543,20951,26431,211395,213776,2396,8.987,2853,10.702,27862,9220,18642,4.313,13.033,32564,12485,20079,5.84,15.233,-4702,-2.2,26.067,2077,2114,7958
2006,4811,507,2996,423341,429246,229,7.528,321,10.552,33182,7992,25190,1.862,7.73,46188,13505,32683,3.146,10.76,-13006,-3.03,15.461,53,54,1987
2006,4812,1994,2196,41970,40351,324,14.945,268,12.362,7586,2158,5428,5.348,18.8,4239,1023,3216,2.535,10.505,3347,8.295,21.011,208,208,748
2006,4831,771,1150,52716,50036,116,10.069,120,10.417,10238,2817,7421,5.63,20.461,4887,1098,3789,2.194,9.767,5351,10.694,19.534,54,55,361
2006,4832,470,523,19893,19337,63,12.081,60,11.505,2342,313,2029,1.619,12.111,1257,458,799,2.369,6.5,1085,5.611,13.001,42,42,381
2006,4841,47128,56674,1055637,1040009,10740,19.372,8274,14.924,159431,58077,101354,5.584,15.33,127926,48676,79250,4.68,12.3,31505,3.029,24.601,6244,6379,28032
2006,4842,42658,46530,474727,466313,6791,14.734,5913,12.829,88936,32625,56311,6.996,19.072,72257,24170,48087,5.183,15.495,16679,3.577,30.991,4629,4646,16919
2006,4851,581,885,51339,51505,110,12.5,100,11.364,8106,6140,1966,11.921,15.738,8563,2980,5583,5.786,16.626,-457,-0.887,31.477,52,53,645
2006,4852,198,528,17324,17510,75,14.507,53,10.251,2048,682,1366,3.895,11.696,2418,868,1550,4.957,13.809,-370,-2.113,23.392,19,20,133
2006,4853,5799,5893,67512,65878,995,16.795,1058,17.858,13724,5633,8091,8.551,20.832,10349,5467,4882,8.299,15.709,3375,5.123,31.419,850,886,4077
2006,4854,2930,4139,192391,188681,292,7.058,288,6.962,23971,9345,14626,4.953,12.705,16582,5974,10608,3.166,8.788,7389,3.916,17.577,190,190,2856
2006,4855,1068,1172,28394,28188,145,12.393,141,12.051,4231,1369,2862,4.857,15.01,3876,1383,2493,4.906,13.751,355,1.259,27.501,112,113,960
2006,4859,2690,2952,60955,59923,480,16.529,384,13.223,12887,6526,6361,10.891,21.506,10866,4966,5900,8.287,18.133,2021,3.373,36.267,318,321,4130
2006,4861,45,328,5806,5952,50,13.793,119,32.828,1248,695,553,11.678,20.97,1479,1086,393,18.248,24.851,-231,-3.881,41.939,3,3,306
2006,4862,127,1521,24133,23983,248,15.969,312,20.09,4870,3141,1729,13.097,20.306,4697,3215,1482,13.406,19.585,173,0.721,39.17,11,11,44
2006,4869,59,676,7151,7228,89,13.414,64,9.646,967,522,445,7.222,13.379,1102,312,790,4.317,15.247,-135,-1.868,26.759,(D),(D),(D)
2006,4871,468,522,8821,8816,69,13.333,60,11.594,1415,346,1069,3.925,16.051,1333,249,1084,2.825,15.121,82,0.93,30.242,42,42,195
2006,4872,1215,1250,11407,11254,242,19.699,199,16.199,2091,713,1378,6.336,18.581,1782,605,1177,5.376,15.835,309,2.746,31.67,138,140,371
2006,4879,137,146,2383,2315,21,14.737,14,9.825,414,188,226,8.123,17.887,293,53,240,2.29,12.659,121,5.228,25.319,10,10,46
2006,4881,3545,4984,157759,152301,625,12.788,432,8.839,31114,10679,20435,7.012,20.429,20194,5498,14696,3.61,13.259,10920,7.17,26.519,271,279,2309
2006,4882,477,963,28167,27149,115,12.15,82,8.663,5009,1933,3076,7.12,18.45,2945,1165,1780,4.291,10.848,2064,7.603,21.695,32,39,727
2006,4883,1645,2155,92789,91368,194,9.044,174,8.112,13160,2392,10768,2.618,14.403,10555,2746,7809,3.005,11.552,2605,2.851,23.104,101,101,842
2006,4884,7729,8276,68110,67546,1259,15.395,1063,12.998,13448,6388,7060,9.457,19.909,12468,4188,8280,6.2,18.459,980,1.451,36.917,835,851,3095
2006,4885,12507,17986,211999,201284,2623,15.076,1447,8.317,48897,26347,22550,13.089,24.293,26505,11486,15019,5.706,13.168,22392,11.125,26.336,861,912,5705
2006,4889,1167,1272,28235,28298,220,17.642,170,13.633,3189,877,2312,3.099,11.27,3222,1311,1911,4.633,11.386,-33,-0.117,22.539,128,130,921
2006,4921,2909,8083,527901,516043,925,11.112,1407,16.903,54463,9915,44548,1.921,10.554,31248,13757,17491,2.666,6.055,23215,4.499,12.111,356,372,2286
2006,4922,3987,4495,44570,45280,612,13.583,633,14.049,8109,3008,5101,6.643,17.909,9528,4358,5170,9.625,21.042,-1419,-3.134,35.817,528,533,3882
2006,4931,6810,13445,630625,620486,1348,10.101,1149,8.61,115149,51874,63275,8.36,18.558,95922,26218,69704,4.225,15.459,19227,3.099,30.918,393,418,5257
2006,5111,15113,21501,694881,697499,2280,10.714,1839,8.642,67385,25122,42263,3.602,9.661,72355,20732,51623,2.972,10.373,-4970,-0.713,19.322,1235,1252,8847
2006,5112,5784,8388,345361,337945,971,11.588,953,11.374,58312,18703,39609,5.534,17.255,44444,20680,23764,6.119,13.151,13868,4.104,26.303,490,517,7042
2006,5121,12551,16045,315413,306791,2581,16.385,1996,12.671,62665,24957,37708,8.135,20.426,45448,15327,30121,4.996,14.814,17217,5.612,29.628,1223,1234,5453
2006,5122,2679,2914,22488,22484,502,17.394,446,15.454,4813,2053,2760,9.131,21.407,4684,2548,2136,11.333,20.833,129,0.574,41.666,295,303,832
2006,5151,4338,9514,259601,253096,1155,12.493,618,6.684,41340,16939,24401,6.693,16.334,28209,5681,22528,2.245,11.146,13131,5.188,22.291,327,340,2875
2006,5152,339,629,43356,41517,124,20.345,85,13.946,7918,2304,5614,5.55,19.072,4356,1439,2917,3.466,10.492,3562,8.58,20.984,36,39,395
2006,5173,5585,43765,1158785,1186285,5925,13.526,6005,13.708,172293,76836,95457,6.477,14.524,231716,66558,165158,5.611,19.533,-59423,-5.009,29.048,780,967,13713
2006,5174,486,604,11534,11652,106,17.936,80,13.536,1527,383,1144,3.287,13.106,1802,762,1040,6.54,15.466,-275,-2.36,26.211,54,54,294
2006,5179,4686,5273,72142,72453,987,18.286,1236,22.899,16712,5685,11027,7.847,23.066,17364,7359,10005,10.157,23.966,-652,-0.9,46.132,863,880,4548
2006,5182,7407,15399,412829,400762,2716,18.479,1313,8.933,76825,26782,50043,6.683,19.17,53544,14894,38650,3.716,13.361,23281,5.809,26.721,709,724,6263
2006,5191,5123,6426,119186,111910,1150,18.626,646,10.463,26703,8583,18120,7.67,23.861,12256,5192,7064,4.639,10.952,14447,12.909,21.903,423,436,2071
2006,5211,21,55,19872,19971,5,9.346,(D),(D),1158,43,1115,0.215,5.798,1365,(D),1352,(D),6.835,-207,-1.037,11.597,(D),(D),(D)
2006,5221,15790,119864,2147693,2120362,13832,11.796,8618,7.35,374086,168004,206082,7.923,17.643,320164,141560,178604,6.676,15.1,53922,2.543,30.199,512,623,6747
2006,5222,18882,52458,802113,796823,9269,17.981,7451,14.454,200047,92688,107359,11.632,25.106,189736,88121,101615,11.059,23.812,10311,1.294,47.623,2064,2182,10950
2006,5223,26436,43585,345123,337460,8334,19.976,4605,11.038,85741,35325,50416,10.468,25.408,70002,27961,42041,8.286,20.744,15739,4.664,41.488,2996,3069,14142
2006,5231,12420,38591,514507,498877,6746,18.149,3903,10.501,94190,53945,40245,10.813,18.88,60919,21526,39393,4.315,12.211,33271,6.669,24.422,1109,1132,5175
2006,5232,43,124,7150,6953,82,92.135,12,13.483,843,578,265,8.313,12.124,433,42,391,0.604,6.228,410,5.897,12.455,10,10,37
2006,5239,33739,38337,390425,371652,7313,19.631,5143,13.806,94828,42993,51835,11.568,25.515,56805,26835,29970,7.22,15.284,38023,10.231,30.569,3405,3429,11631
2006,5241,6362,33004,1436110,1424650,3659,11.196,3015,9.225,170896,67374,103522,4.729,11.996,146161,44779,101382,3.143,10.259,24735,1.736,20.519,505,515,2980
2006,5242,120484,135452,943763,933110,14506,10.842,11199,8.37,153483,64617,88866,6.925,16.449,130884,52309,78575,5.606,14.027,22599,2.422,28.053,7733,7844,24989
2006,5259,626,657,6378,6244,144,20.734,219,31.533,1709,1082,627,17.329,27.37,1417,917,500,14.686,22.694,292,4.676,45.388,180,181,697
2006,5311,84907,104909,553996,547990,12935,12.354,12531,11.968,105421,53165,52256,9.702,19.238,93897,46430,47467,8.473,17.135,11524,2.103,34.27,9267,9364,31278
2006,5312,78944,88306,369592,355736,19066,22.628,10971,13.021,88502,44851,43651,12.608,24.879,60469,27011,33458,7.593,16.998,28033,7.88,33.997,7726,7785,18089
2006,5313,61504,70999,631450,617582,12558,18.325,7617,11.115,124286,58244,66042,9.431,20.125,96120,35132,60988,5.689,15.564,28166,4.561,31.128,5288,5314,21507
2006,5321,4092,12276,171376,172263,1569,12.958,1234,10.191,24017,6356,17661,3.69,13.942,25663,10813,14850,6.277,14.898,-1646,-0.956,27.884,480,504,2770
2006,5322,11333,32194,254290,260404,3080,9.587,2945,9.167,38194,15089,23105,5.794,14.667,50356,14278,36078,5.483,19.338,-12162,-4.67,29.334,1639,1827,7246
2006,5323,3123,5007,34420,33357,529,10.627,471,9.462,7324,3017,4307,9.045,21.957,5081,2040,3041,6.116,15.232,2243,6.724,30.465,259,288,1251
2006,5324,7498,12654,157810,153284,1581,12.751,1072,8.646,29573,9894,19679,6.455,19.293,20316,7421,12895,4.841,13.254,9257,6.039,26.508,665,682,3270
2006,5331,1915,1997,30006,28968,270,13.692,220,11.156,6027,3132,2895,10.812,20.806,4178,1294,2884,4.467,14.423,1849,6.383,28.846,164,165,803
2006,5411,163993,173402,1218672,1211108,16035,9.303,13966,8.102,148234,52326,95908,4.321,12.24,132280,42177,90103,3.483,10.922,15954,1.317,21.844,10387,10514,31115
2006,5412,93875,109612,1303072,1261644,13294,12.302,10192,9.432,280148,100967,179181,8.003,22.205,198373,55121,143252,4.369,15.723,81775,6.482,31.447,6850,6879,33985
2006,5413,88764,102580,1383170,1338012,12671,12.597,8693,8.642,248209,73976,174233,5.529,18.551,158062,54190,103872,4.05,11.813,90147,6.737,23.626,5730,5792,23671
2006,5414,27583,27852,127499,123638,4685,17.146,3629,13.281,27835,10758,17077,8.701,22.513,19988,9653,10335,7.808,16.167,7847,6.347,32.333,2684,2691,6835
2006,5415,81331,94450,1234244,1187745,20928,23.007,13956,15.342,285321,103859,181462,8.744,24.022,191995,78807,113188,6.635,16.165,93326,7.857,32.329,9504,9628,42471
2006,5416,97910,103961,866785,839331,22942,22.898,15408,15.378,205710,88598,117112,10.556,24.509,150910,72072,78838,8.587,17.98,54800,6.529,35.96,10833,10886,40997
2006,5417,11310,14808,656118,652156,2046,14.052,1550,10.646,91871,25559,66312,3.919,14.087,83968,19984,63984,3.064,12.875,7903,1.212,25.751,910,922,5657
2006,5418,31660,35050,453709,435777,4623,13.331,3879,11.186,97108,26746,70362,6.138,22.284,60890,25164,35726,5.775,13.973,36218,8.311,27.945,2762,2773,14250
2006,5419,53071,61642,568706,560695,7088,11.605,5954,9.749,99677,33224,66453,5.926,17.777,84327,31477,52850,5.614,15.04,15350,2.738,30.079,4123,4154,17494
2006,5511,26294,49394,2930623,2929236,5427,11.108,4348,8.9,484436,149225,335211,5.094,16.538,483751,128855,354896,4.399,16.515,685,0.023,33.029,1099,1142,14627
2006,5611,21216,23852,453907,444818,4427,19.189,2863,12.41,94058,38499,55559,8.655,21.145,76432,31585,44847,7.101,17.183,17626,3.963,34.366,2100,2114,21807
2006,5612,1668,5170,193252,181678,1461,31.733,329,7.146,48092,28355,19737,15.607,26.471,25778,8924,16854,4.912,14.189,22314,12.282,28.378,106,109,1460
2006,5613,27531,46466,4782016,4542099,7730,17.063,5401,11.922,1275497,332055,943442,7.311,28.082,799210,241907,557303,5.326,17.596,476287,10.486,35.191,2871,2953,129292
2006,5614,27160,33672,808269,792326,4750,14.277,3947,11.863,168989,62541,106448,7.893,21.328,137465,55336,82129,6.984,17.35,31524,3.979,34.699,2849,2927,20700
2006,5615,15763,21593,257720,255310,2177,10.053,2301,10.626,38825,14282,24543,5.594,15.207,34033,11225,22808,4.397,13.33,4792,1.877,26.66,1477,1507,6532
2006,5616,17267,22379,787052,772328,3358,15.303,2488,11.338,162143,71051,91092,9.2,20.994,133823,38433,95390,4.976,17.327,28320,3.667,34.654,1641,1666,16701
2006,5617,134694,141269,1714943,1671471,24923,18.052,18503,13.402,361285,122308,238977,7.317,21.615,275234,94785,180449,5.671,16.467,86051,5.148,32.933,13568,13602,61574
2006,5619,17018,19245,350523,351189,2265,11.785,2215,11.524,63624,16994,46630,4.839,18.117,64421,22053,42368,6.28,18.344,-797,-0.227,36.233,1565,1599,9398
2006,5621,6870,8627,179459,181907,899,10.469,819,9.538,21633,7598,14035,4.177,11.892,25712,16407,9305,9.019,14.135,-4079,-2.242,23.785,473,480,3287
2006,5622,1460,2620,58312,59085,244,9.322,239,9.131,8498,3239,5259,5.482,14.383,9997,4609,5388,7.801,16.92,-1499,-2.537,28.766,124,127,1756
2006,5629,6924,7678,113460,112324,1006,13.381,686,9.125,25241,9248,15993,8.233,22.472,22672,7285,15387,6.486,20.185,2569,2.287,40.369,456,466,3398
2006,6111,17369,19729,801868,792684,1217,6.221,887,4.534,77474,23082,54392,2.912,9.774,59093,14158,44935,1.786,7.455,18381,2.319,14.91,632,648,9816
2006,6112,460,860,86125,84602,72,8.571,32,3.81,10084,2357,7727,2.786,11.919,7142,637,6505,0.753,8.442,2942,3.477,16.884,22,22,569
2006,6113,2226,3639,1538303,1526070,362,10.239,155,4.384,98023,11995,86028,0.786,6.423,72995,3472,69523,0.228,4.783,25028,1.64,9.566,88,88,2314
2006,6114,5961,6498,65504,63092,880,13.569,855,13.183,14815,5043,9772,7.993,23.482,10048,4361,5687,6.912,15.926,4767,7.556,31.852,612,636,3041
2006,6115,6026,7375,119910,113257,974,13.48,675,9.342,27110,10779,16331,9.517,23.937,13862,4454,9408,3.933,12.239,13248,11.697,24.479,494,506,2820
2006,6116,28928,31142,293953,282831,4930,16.215,3453,11.357,66245,24251,41994,8.574,23.422,44252,15035,29217,5.316,15.646,21993,7.776,31.292,2611,2638,11580
2006,6117,5008,5686,75176,70320,1202,22.159,679,12.517,19444,6852,12592,9.744,27.651,9551,2532,7019,3.601,13.582,9893,14.069,27.165,515,515,1784
2006,6211,175579,201959,2117508,2074304,17576,8.787,13709,6.854,305020,112846,192174,5.44,14.705,217222,68354,148868,3.295,10.472,87798,4.233,20.944,9862,10090,44140
2006,6212,113184,118732,816530,802126,7032,5.971,5103,4.333,113972,36825,77147,4.591,14.209,85325,23589,61736,2.941,10.637,28647,3.571,21.275,4086,4118,17974
2006,6213,97905,108360,589118,571411,12678,11.906,8931,8.387,116610,47451,69159,8.304,20.407,80630,28852,51778,5.049,14.111,35980,6.297,28.221,6290,6402,19311
2006,6214,13124,27246,676794,662712,3063,11.575,1495,5.65,100682,40228,60454,6.07,15.192,72081,19706,52375,2.974,10.877,28601,4.316,21.753,716,834,8885
2006,6215,7003,11324,226313,222968,1513,13.594,1125,10.108,36711,15044,21667,6.747,16.465,29652,11503,18149,5.159,13.299,7059,3.166,26.598,652,683,4738
2006,6216,13290,19713,972281,942289,3363,17.767,1793,9.473,176925,60383,116542,6.408,18.776,117198,37258,79940,3.954,12.438,59727,6.339,24.875,1208,1242,18410
2006,6219,5511,8464,253093,250101,817,9.742,662,7.894,40035,11643,28392,4.655,16.008,34001,11087,22914,4.433,13.595,6034,2.413,27.19,379,415,5200
2006,6221,3136,5132,4919252,4887965,98,1.907,113,2.199,199470,24165,175305,0.494,4.081,136942,38774,98168,0.793,2.802,62528,1.279,5.603,53,53,13658
2006,6222,452,604,215785,215271,29,4.809,27,4.478,7312,1969,5343,0.915,3.397,6250,3197,3053,1.485,2.903,1062,0.493,5.807,16,16,2278
2006,6223,383,813,217203,211783,143,18.475,65,8.398,28935,16987,11948,8.021,13.663,17339,7119,10220,3.361,8.187,11596,5.475,16.374,34,34,2233
2006,6231,8400,16042,1619734,1616063,1025,6.393,1006,6.275,151503,63115,88388,3.905,9.375,144316,62931,81385,3.894,8.93,7187,0.445,17.86,514,547,29355
2006,6232,8103,31249,566761,558392,2760,8.987,1683,5.48,81208,32000,49208,5.731,14.543,64180,16943,47237,3.034,11.494,17028,3.049,22.987,371,446,6146
2006,6233,13700,18384,651647,640047,2172,12.013,1566,8.661,85177,39122,46055,6.112,13.308,61569,21559,40010,3.368,9.619,23608,3.688,19.239,1146,1169,15623
2006,6239,3615,6267,156601,155931,561,9.048,427,6.887,21276,7078,14198,4.539,13.645,20139,5430,14709,3.482,12.915,1137,0.729,25.831,198,208,2587
2006,6241,38184,53544,1092904,1064497,5821,11.095,3661,6.978,175223,59214,116009,5.563,16.461,119151,28016,91135,2.632,11.193,56072,5.267,22.386,2198,2265,15154
2006,6242,9479,13080,161155,159231,1013,7.882,558,4.342,20068,6068,14000,3.811,12.603,16033,3273,12760,2.056,10.069,4035,2.534,20.138,339,345,1545
2006,6243,4791,8086,338956,336464,688,8.601,515,6.438,50760,14651,36109,4.354,15.086,45260,7997,37263,2.377,13.452,5500,1.635,26.903,247,260,2629
2006,6244,53331,69075,851899,825651,9621,14.196,7017,10.354,161115,80492,80623,9.749,19.514,106894,39809,67085,4.822,12.947,54221,6.567,25.893,5391,5493,30715
2006,7111,7398,7550,132355,132294,949,12.595,919,12.196,21198,5939,15259,4.489,16.023,21163,5702,15461,4.31,15.997,35,0.026,31.994,602,603,4283
2006,7112,3394,3562,122827,119942,599,17.036,507,14.42,20234,4898,15336,4.084,16.87,14432,3028,11404,2.525,12.032,5802,4.837,24.065,374,375,2028
2006,7113,4766,5112,110470,107921,766,15.377,505,10.138,21055,5387,15668,4.992,19.51,15728,4421,11307,4.097,14.574,5327,4.936,29.147,371,372,3190
2006,7114,2629,2684,15604,15268,404,15.077,395,14.742,3239,1411,1828,9.242,21.215,2578,1407,1171,9.216,16.886,661,4.329,33.771,283,283,909
2006,7115,12984,13002,46729,44568,2992,23.724,2211,17.532,15322,7640,7682,17.143,34.379,11027,4796,6231,10.761,24.742,4295,9.637,49.484,1414,1414,3106
2006,7121,5993,6474,123365,122557,525,8.19,398,6.209,11677,2112,9565,1.723,9.528,10029,1085,8944,0.885,8.183,1648,1.345,16.366,238,239,625
2006,7131,1910,2458,144491,145449,486,20.183,386,16.03,13575,5114,8461,3.516,9.333,15449,4137,11312,2.844,10.622,-1874,-1.288,18.666,259,265,2865
2006,7132,1752,2314,191101,190587,292,12.846,210,9.239,21788,7721,14067,4.051,11.432,20649,6895,13754,3.618,10.834,1139,0.598,21.669,155,158,4035
2006,7139,50785,56499,1097493,1082322,7619,13.633,6391,11.436,175016,67505,107511,6.237,16.17,144983,48381,96602,4.47,13.396,30033,2.775,26.791,5078,5113,37345
2006,7211,37511,47410,1833360,1819903,5605,11.881,5135,10.885,263496,119866,143630,6.586,14.479,237850,103970,133880,5.713,13.069,25646,1.409,26.139,3608,3678,54158
2006,7212,5147,5625,38442,38191,677,12.141,579,10.384,6878,2165,4713,5.669,18.009,6342,2170,4172,5.682,16.606,536,1.403,33.212,361,363,1213
2006,7213,2087,2156,11915,12082,135,6.166,202,9.226,1592,447,1145,3.7,13.177,1921,639,1282,5.289,15.9,-329,-2.723,26.353,145,145,510
2006,7223,11430,29589,558135,560303,3414,11.602,3088,10.494,102096,35493,66603,6.335,18.222,105844,35126,70718,6.269,18.89,-3748,-0.669,36.443,1521,1537,9978
2006,7224,41536,42131,361124,356661,5418,12.783,5922,13.973,80921,42673,38248,11.965,22.688,71361,31997,39364,8.971,20.008,9560,2.68,40.016,4952,4957,27254
2006,7225,310713,426405,8626119,8458325,59884,14.286,45410,10.833,1595886,850931,744955,10.06,18.868,1261402,453850,807552,5.366,14.913,334484,3.954,29.826,36027,36936,333692
2006,8111,139064,152334,884028,881338,15432,10.115,15907,10.426,152519,62734,89785,7.118,17.305,147447,56536,90911,6.415,16.73,5072,0.575,33.46,12199,12495,43319
2006,8112,10806,12261,127855,129104,1369,11.095,1525,12.359,20465,7443,13022,5.765,15.852,22852,8234,14618,6.378,17.7,-2387,-1.849,31.703,1153,1181,4303
2006,8113,20931,22395,193442,187359,2281,10.217,2142,9.594,35603,10658,24945,5.689,19.003,23407,8141,15266,4.345,12.493,12196,6.509,24.986,1586,1595,5402
2006,8114,19379,20481,96130,99578,2381,11.499,2832,13.677,16529,6306,10223,6.333,16.599,23563,11289,12274,11.337,23.663,-7034,-7.064,33.198,2142,2157,5226
2006,8121,83098,98193,619081,605718,14676,15.127,12323,12.702,123904,66290,57614,10.944,20.456,97680,42654,55026,7.042,16.126,26224,4.329,32.253,10067,10381,36549
2006,8122,14746,20214,135999,136418,977,4.805,1214,5.971,13279,3821,9458,2.801,9.734,14247,4537,9710,3.326,10.444,-968,-0.71,19.468,593,606,1933
2006,8123,31509,37898,358388,363769,4008,10.475,4739,12.385,47203,18275,28928,5.024,12.976,57175,24375,32800,6.701,15.717,-9972,-2.741,25.952,3551,3633,14525
2006,8129,20429,30819,230177,226760,4602,14.898,4743,15.355,48260,21414,26846,9.443,21.282,41335,20295,21040,8.95,18.229,6925,3.054,36.457,2673,2710,10499
2006,8131,165011,165420,1629244,1621619,8654,5.207,10235,6.158,165913,25817,140096,1.592,10.231,150524,26626,123898,1.642,9.282,15389,0.949,18.565,5898,5898,16101
2006,8132,13633,15614,157313,155586,1283,8.28,1047,6.757,18386,4302,14084,2.765,11.817,15029,4468,10561,2.872,9.66,3357,2.158,19.319,634,688,2735
2006,8133,11710,13793,123756,122448,1298,9.505,1023,7.491,18168,4756,13412,3.884,14.837,15570,3483,12087,2.844,12.716,2598,2.122,25.431,579,581,1689
2006,8134,26417,28600,321761,321037,1520,5.2,2787,9.534,35965,7568,28397,2.357,11.203,34605,7937,26668,2.472,10.779,1360,0.424,21.558,2099,2099,5492
2006,8139,58692,60809,542693,535826,3446,5.634,4155,6.793,72144,14544,57600,2.714,13.464,58412,13989,44423,2.611,10.901,13732,2.563,21.803,2879,2887,9341
2007,1131,333,377,2582,2655,49,13.119,42,11.245,277,108,169,4.069,10.435,413,143,270,5.387,15.558,-136,-5.123,20.87,23,23,93
2007,1132,149,206,2143,2085,31,15.578,17,8.543,447,127,320,6.093,21.444,324,135,189,6.476,15.543,123,5.901,31.087,9,9,48
2007,1133,8672,8748,59208,60478,875,9.854,1138,12.816,9196,3544,5652,5.86,15.206,11629,3874,7755,6.406,19.229,-2433,-4.023,30.411,879,880,3117
2007,1141,1201,1210,5266,5382,249,20.846,218,18.25,1056,520,536,9.662,19.621,1304,582,722,10.814,24.229,-248,-4.608,39.242,138,138,270
2007,1142,261,261,1821,1841,30,11.342,37,13.989,185,65,120,3.532,10.052,228,99,129,5.379,12.388,-43,-2.336,20.103,26,26,57
2007,1151,3431,3762,63549,63386,432,11.459,448,11.883,11889,4534,7355,7.153,18.757,11435,3906,7529,6.162,18.04,454,0.716,36.081,285,286,2640
2007,1152,3635,3700,19849,19558,524,14.307,449,12.259,3660,1468,2192,7.506,18.714,3049,1337,1712,6.836,15.59,611,3.124,31.18,357,358,1027
2007,1153,1309,1387,13856,13747,193,14.057,165,12.017,2830,802,2028,5.834,20.586,2606,801,1805,5.827,18.957,224,1.629,37.914,108,108,547
2007,2111,5813,6957,142104,115176,883,12.905,654,9.558,66580,11669,54911,10.131,57.807,12773,7871,4902,6.834,11.09,53807,46.717,22.18,355,358,2014
2007,2121,625,1013,78791,77780,121,11.822,142,13.874,12534,2529,10005,3.251,16.115,10306,3671,6635,4.72,13.25,2228,2.864,26.5,69,72,1818
2007,2122,209,274,35386,31672,56,21.538,28,10.769,8720,1958,6762,6.182,27.532,1215,271,944,0.856,3.836,7505,23.696,7.672,11,11,46
2007,2123,3223,5312,102275,99258,424,7.982,424,7.982,21578,6910,14668,6.962,21.739,15931,3534,12397,3.56,16.05,5647,5.689,32.1,208,208,1425
2007,2131,8829,10629,349020,302314,1903,18.849,837,8.29,125996,35636,90360,11.788,41.677,32169,14747,17422,4.878,10.641,93827,31.036,21.282,519,531,5692
2007,2211,1557,9452,519679,512092,645,6.838,607,6.435,55027,12996,42031,2.538,10.746,40382,10536,29846,2.057,7.886,14645,2.86,15.771,69,76,864
2007,2212,418,2350,84049,84178,100,4.119,256,10.544,8331,1587,6744,1.885,9.897,8478,3475,5003,4.128,10.072,-147,-0.175,19.794,26,26,221
2007,2213,3549,4401,41547,40378,287,6.559,237,5.416,6668,2147,4521,5.317,16.514,4213,1141,3072,2.826,10.434,2455,6.08,20.868,146,151,526
2007,2361,161752,163120,907041,937518,29220,17.929,28941,17.757,199285,87545,111740,9.338,21.257,261065,98208,162857,10.475,27.846,-61780,-6.59,42.513,21857,21860,67323
2007,2362,40466,41665,734975,725641,4781,11.627,3692,8.978,136243,30477,105766,4.2,18.776,117801,25171,92630,3.469,16.234,18442,2.541,32.468,2734,2739,16963
2007,2371,18411,19437,545601,525442,1679,8.622,1753,9.002,119952,18811,101141,3.58,22.829,80020,19890,60130,3.785,15.229,39932,7.6,30.458,1161,1169,11560
2007,2372,10268,10348,73543,73089,1524,14.717,1539,14.862,17197,7482,9715,10.237,23.529,16135,5990,10145,8.195,22.076,1062,1.453,44.152,1246,1247,4728
2007,2373,9862,10624,324173,322832,757,7.095,849,7.957,49601,7669,41932,2.376,15.364,46867,9468,37399,2.933,14.517,2734,0.847,29.035,548,549,4839
2007,2379,4032,4146,69855,71143,587,14.167,582,14.046,14410,3768,10642,5.296,20.255,17234,5214,12020,7.329,24.224,-2824,-3.969,40.51,371,373,2079
2007,2381,98057,98828,1113814,1148665,13066,13.143,14237,14.321,221449,63071,158378,5.491,19.279,292125,70559,221566,6.143,25.432,-70676,-6.153,38.558,10585,10588,54745
2007,2382,165730,169411,1992405,1990555,18829,11.227,15438,9.205,347104,78235,268869,3.93,17.438,343725,79720,264005,4.005,17.268,3379,0.17,34.536,11689,11709,53703
2007,2383,114095,115235,940294,956431,17753,15.475,16720,14.575,198193,62447,135746,6.529,20.722,230939,61726,169213,6.454,24.146,-32746,-3.424,41.444,12659,12666,46990
2007,2389,63912,64610,615767,614583,10131,15.911,8257,12.968,121591,39491,82100,6.426,19.784,119498,32766,86732,5.331,19.444,2093,0.341,38.888,6028,6030,24552
2007,3111,1135,1707,46071,46856,87,5.073,103,6.006,4920,1499,3421,3.199,10.5,6400,1960,4440,4.183,13.659,-1480,-3.159,21.001,55,57,710
2007,3112,430,757,55501,54730,25,3.294,29,3.821,4545,1040,3505,1.9,8.304,3032,572,2460,1.045,5.54,1513,2.765,11.08,17,17,195
2007,3113,1512,1721,72209,72441,142,8.215,157,9.083,8349,916,7433,1.264,11.525,8778,3453,5325,4.767,12.118,-429,-0.592,23.051,114,114,1173
2007,3114,1202,1566,160732,160597,92,5.826,118,7.473,16469,3067,13402,1.91,10.255,16162,5024,11138,3.128,10.064,307,0.191,20.127,66,67,1520
2007,3115,993,1510,131861,132304,93,6.155,95,6.287,11444,2379,9065,1.798,8.65,12110,2839,9271,2.146,9.153,-666,-0.503,17.3,59,61,1178
2007,3116,2937,3556,490030,497426,205,5.725,254,7.094,33372,8620,24752,1.733,6.709,48600,13201,35399,2.654,9.77,-15228,-3.061,13.418,181,182,2868
2007,3117,516,610,32590,33719,46,7.529,48,7.856,3038,634,2404,1.88,9.01,5264,1166,4098,3.458,15.612,-2226,-6.602,18.02,29,29,354
2007,3118,9015,9786,290569,294395,798,8.062,1023,10.335,36260,10328,25932,3.508,12.317,43517,16123,27394,5.477,14.782,-7257,-2.465,24.634,766,777,6032
2007,3119,2648,3088,163106,161860,298,9.748,236,7.72,18449,4875,13574,3.012,11.398,15820,5547,10273,3.427,9.774,2629,1.624,19.548,175,180,2371
2007,3121,2788,3355,135263,134355,392,11.973,230,7.025,14275,3424,10851,2.548,10.625,12743,3405,9338,2.534,9.485,1532,1.14,18.969,149,149,1784
2007,3122,71,102,20107,20629,5,4.651,16,14.884,1185,755,430,3.66,5.744,2395,1195,1200,5.793,11.61,-1210,-5.866,11.489,8,8,47
2007,3131,281,406,42639,45380,23,5.476,51,12.143,2281,371,1910,0.818,5.026,7690,3148,4542,6.937,16.946,-5409,-11.919,10.053,24,25,819
2007,3132,1052,1205,76777,83808,60,4.783,159,12.674,5958,1658,4300,1.978,7.109,20097,11034,9063,13.166,23.98,-14139,-16.871,14.218,102,103,2707
2007,3133,1128,1190,44714,47958,75,6.093,157,12.754,3382,1354,2028,2.823,7.052,9812,4029,5783,8.401,20.46,-6430,-13.408,14.104,116,116,1784
2007,3141,2258,2394,75696,77771,148,6.041,260,10.612,6635,2069,4566,2.66,8.531,10841,2403,8438,3.09,13.94,-4206,-5.408,17.063,212,212,1197
2007,3149,3780,3893,70669,72549,288,7.226,473,11.868,7674,2168,5506,2.988,10.578,11583,4461,7122,6.149,15.966,-3909,-5.388,21.156,378,384,3123
2007,3151,364,394,22331,24035,30,7.168,79,18.877,2066,553,1513,2.301,8.596,5468,2294,3174,9.544,22.75,-3402,-14.154,17.192,54,55,814
2007,3152,6499,6617,138777,143955,991,14.557,1372,20.154,24110,10609,13501,7.37,16.748,34271,18597,15674,12.919,23.807,-10161,-7.058,33.497,1216,1218,14371
2007,3159,681,698,13286,13788,52,7.303,80,11.236,1168,254,914,1.842,8.471,2201,859,1342,6.23,15.964,-1033,-7.492,16.943,64,64,607
2007,3161,219,225,4998,5583,25,11.038,28,12.362,425,238,187,4.263,7.612,1565,833,732,14.92,28.032,-1140,-20.419,15.225,21,21,195
2007,3162,213,236,13002,13585,12,4.969,23,9.524,661,41,620,0.302,4.866,1759,487,1272,3.585,12.949,-1098,-8.083,9.732,17,17,98
2007,3169,755,765,15973,16256,68,8.843,76,9.883,1801,446,1355,2.744,11.079,2393,848,1545,5.217,14.721,-592,-3.642,22.159,61,61,539
2007,3211,3462,3889,109770,112997,262,6.664,347,8.826,8744,3112,5632,2.754,7.738,15110,4970,10140,4.398,13.372,-6366,-5.634,15.477,252,254,2378
2007,3212,1490,1891,109146,116369,106,5.588,118,6.22,6969,1954,5015,1.679,5.989,21444,4210,17234,3.618,18.428,-14475,-12.439,11.977,74,74,1107
2007,3219,9402,10445,318250,334708,916,8.771,912,8.733,28526,9855,18671,2.944,8.523,61700,16388,45312,4.896,18.434,-33174,-9.911,17.045,672,701,10721
2007,3221,231,476,125784,130160,9,1.795,60,11.964,3058,389,2669,0.299,2.349,11810,4764,7046,3.66,9.073,-8752,-6.724,4.699,22,22,571
2007,3222,2967,4395,294195,297770,162,3.648,253,5.698,21658,5337,16321,1.792,7.273,28489,10163,18326,3.413,9.567,-6831,-2.294,14.547,116,119,2572
2007,3231,30494,32121,646628,655470,1920,5.897,2800,8.599,61067,19250,41817,2.937,9.317,78708,29644,49064,4.523,12.008,-17641,-2.691,18.633,2213,2225,14924
2007,3241,1054,2229,101381,100527,154,6.883,171,7.642,9291,2290,7001,2.278,9.242,7799,1835,5964,1.825,7.758,1492,1.484,15.516,51,59,684
2007,3251,1362,2476,158535,158879,199,8.156,127,5.205,10807,2851,7956,1.794,6.802,11270,2741,8529,1.725,7.093,-463,-0.291,13.604,50,52,574
2007,3252,958,1292,100242,100890,56,4.316,67,5.164,6904,1724,5180,1.709,6.843,8256,2216,6040,2.196,8.183,-1352,-1.34,13.686,32,32,808
2007,3253,626,863,29264,29523,53,5.995,95,10.747,3375,869,2506,2.943,11.432,3955,1511,2444,5.118,13.396,-580,-1.965,22.864,52,52,493
2007,3254,1441,1913,244822,246198,152,7.994,129,6.784,28230,7263,20967,2.95,11.466,31890,6171,25719,2.507,12.953,-3660,-1.487,22.933,69,70,2284
2007,3255,1486,1891,65481,65933,113,5.969,117,6.181,6729,2038,4691,3.091,10.206,7625,2290,5335,3.473,11.565,-896,-1.359,20.412,66,66,704
2007,3256,1923,2139,106938,107168,135,6.249,178,8.239,10458,3396,7062,3.169,9.759,10901,3542,7359,3.305,10.172,-443,-0.413,19.517,113,114,1667
2007,3259,2072,2650,100962,105269,203,7.689,183,6.932,9407,2076,7331,1.972,8.936,17710,2536,15174,2.409,16.824,-8303,-7.887,17.872,116,117,1144
2007,3261,9264,11729,700879,717220,585,4.94,813,6.865,58468,11391,47077,1.588,8.152,91439,27591,63848,3.847,12.749,-32971,-4.597,16.304,498,507,10167
2007,3262,1654,2142,149325,154203,82,3.773,145,6.671,8367,1313,7054,0.851,5.426,18281,5459,12822,3.54,11.855,-9914,-6.429,10.852,85,86,1512
2007,3271,1184,1384,50714,51458,95,6.745,144,10.224,4994,875,4119,1.7,9.705,6415,2111,4304,4.102,12.466,-1421,-2.761,19.41,110,110,766
2007,3272,1651,1962,98616,100352,117,5.911,152,7.679,6502,579,5923,0.577,6.479,9913,2560,7353,2.551,9.878,-3411,-3.399,12.958,104,104,549
2007,3273,4880,9786,226611,229797,518,5.273,592,6.027,27776,7780,19996,3.386,12.087,34315,8717,25598,3.793,14.933,-6539,-2.846,24.174,291,308,4388
2007,3274,198,331,17282,17849,19,5.706,23,6.907,920,377,543,2.112,5.154,2120,77,2043,0.431,11.878,-1200,-6.723,10.309,18,18,55
2007,3279,2888,3327,83317,83183,308,9.349,243,7.376,9637,2503,7134,3.009,11.585,9391,2459,6932,2.956,11.29,246,0.296,22.579,169,169,1319
2007,3311,319,440,105270,106895,40,9.091,40,9.091,4953,420,4533,0.393,4.634,8474,3387,5087,3.169,7.927,-3521,-3.294,9.267,34,34,2754
2007,3312,454,599,46323,47498,21,3.448,41,6.732,3317,357,2960,0.752,6.984,5695,1797,3898,3.783,11.99,-2378,-5.007,13.967,22,23,381
2007,3313,411,556,62489,63421,38,6.841,37,6.661,4155,1150,3005,1.813,6.551,5928,2333,3595,3.679,9.347,-1773,-2.796,13.103,23,23,493
2007,3314,754,966,64697,64755,42,4.317,56,5.755,4909,681,4228,1.052,7.581,4983,1473,3510,2.275,7.695,-74,-0.114,15.162,36,36,232
2007,3315,1833,2074,159030,163193,97,4.615,153,7.279,11579,2700,8879,1.654,7.095,20060,6275,13785,3.845,12.292,-8481,-5.197,14.191,108,109,2260
2007,3321,2451,2698,127103,128268,96,3.529,141,5.183,9853,1674,8179,1.305,7.682,12205,3409,8796,2.658,9.515,-2352,-1.834,15.363,88,88,1422
2007,3322,1324,1437,50701,52323,83,5.746,98,6.784,3510,1092,2418,2.087,6.708,6678,2089,4589,3.993,12.763,-3168,-6.055,13.417,63,63,520
2007,3323,12619,13621,413626,413432,927,6.818,877,6.45,50348,11170,39178,2.702,12.178,50091,13300,36791,3.217,12.116,257,0.062,24.232,657,658,8216
2007,3324,1218,1497,93980,90855,70,4.67,74,4.937,12962,1811,11151,1.993,14.267,6552,2289,4263,2.519,7.212,6410,7.055,14.423,41,41,533
2007,3325,669,745,40792,41984,46,6.17,47,6.304,2232,435,1797,1.036,5.316,4691,804,3887,1.915,11.173,-2459,-5.857,10.633,28,28,374
2007,3326,1361,1532,50054,51037,68,4.406,91,5.896,4163,1019,3144,1.997,8.157,6108,1496,4612,2.931,11.968,-1945,-3.811,16.314,58,58,449
2007,3327,23645,24102,398257,395510,1538,6.382,1531,6.353,45579,10659,34920,2.695,11.524,40009,11412,28597,2.885,10.116,5570,1.408,20.232,1153,1156,7449
2007,3328,5439,5984,138702,139218,302,5.019,369,6.132,15644,2918,12726,2.096,11.237,16638,5638,11000,4.05,11.951,-994,-0.714,22.474,267,267,2346
2007,3329,5901,6437,280375,281227,564,8.85,436,6.841,28505,6865,21640,2.441,10.136,30534,9031,21503,3.211,10.857,-2029,-0.721,20.272,311,311,3844
2007,3331,2546,2876,203358,198951,196,6.842,173,6.039,21806,4195,17611,2.109,10.96,12973,4628,8345,2.326,6.521,8833,4.44,13.041,122,122,2190
2007,3332,3578,3769,135073,135940,214,5.655,245,6.474,11934,2813,9121,2.069,8.779,13583,5316,8267,3.911,9.992,-1649,-1.213,17.558,176,178,2773
2007,3333,1954,2098,89152,89696,132,6.235,170,8.03,8552,1490,7062,1.661,9.534,9678,4264,5414,4.754,10.79,-1126,-1.255,19.069,116,117,2175
2007,3334,1475,1779,150515,150771,100,5.62,101,5.676,15764,2005,13759,1.33,10.456,16319,2327,13992,1.543,10.824,-555,-0.368,20.911,70,70,1345
2007,3335,7341,7590,166681,169807,300,3.899,508,6.603,13889,3066,10823,1.806,8.179,20227,6251,13976,3.681,11.912,-6338,-3.732,16.359,378,380,3749
2007,3336,792,965,103696,102465,46,4.799,33,3.443,9103,1200,7903,1.171,8.884,6564,475,6089,0.464,6.406,2539,2.478,12.812,22,22,163
2007,3339,5578,6220,296899,294121,334,5.365,344,5.526,28070,4238,23832,1.441,9.544,22492,6124,16368,2.082,7.647,5578,1.897,15.294,222,222,1895
2007,3341,1112,1170,98471,96789,105,8.906,123,10.433,11209,791,10418,0.817,11.581,8240,2163,6077,2.235,8.513,2969,3.068,17.027,86,86,661
2007,3342,1494,1695,148892,149603,129,7.509,175,10.186,15360,2810,12550,1.878,10.267,16700,5366,11334,3.587,11.163,-1340,-0.896,20.534,109,111,1809
2007,3343,445,460,16406,17024,64,14.254,42,9.354,1628,796,832,4.676,9.563,2827,721,2106,4.235,16.606,-1199,-7.043,19.126,29,29,198
2007,3344,4077,4602,367888,367677,284,6.128,349,7.53,37401,7226,30175,1.965,10.172,37280,13362,23918,3.634,10.139,121,0.033,20.279,221,225,4324
2007,3345,4382,5104,398467,397839,297,5.783,361,7.029,36886,7450,29436,1.873,9.272,35805,14984,20821,3.766,9,1081,0.272,18,200,200,2057
2007,3346,703,741,27262,29733,71,9.404,99,13.113,1764,563,1201,1.894,5.933,6508,3787,2721,12.737,21.889,-4744,-15.956,11.866,71,71,1171
2007,3351,1059,1148,56991,57040,77,6.71,76,6.623,4385,837,3548,1.467,7.688,4659,859,3800,1.506,8.168,-274,-0.48,15.375,54,54,568
2007,3352,265,317,66152,70111,29,9.034,37,11.526,4579,364,4215,0.519,6.531,12556,7383,5173,10.531,17.909,-7977,-11.378,13.062,25,25,2379
2007,3353,1992,2311,138666,138897,95,4.068,144,6.166,12120,1639,10481,1.18,8.726,12756,4586,8170,3.302,9.184,-636,-0.458,17.452,78,78,689
2007,3359,1845,2208,154523,156047,114,5.122,149,6.695,12386,1426,10960,0.914,7.937,15416,6694,8722,4.29,9.879,-3030,-1.942,15.875,82,82,1278
2007,3361,269,333,193820,198885,34,10.241,32,9.639,12365,232,12133,0.117,6.217,23556,6715,16841,3.376,11.844,-11191,-5.627,12.434,18,18,110
2007,3362,1840,2123,152551,156266,159,7.486,161,7.58,13841,3019,10822,1.932,8.857,21137,4914,16223,3.145,13.526,-7296,-4.669,17.715,115,116,2640
2007,3363,4440,5529,605028,624674,325,5.822,431,7.721,53170,13129,40041,2.102,8.512,92809,26189,66620,4.192,14.857,-39639,-6.346,17.023,233,239,6270
2007,3364,1240,1626,412058,405405,123,7.621,99,6.134,36665,11819,24846,2.915,9.044,23673,4254,19419,1.049,5.839,12992,3.205,11.679,65,65,1585
2007,3365,168,230,29481,30286,14,6.048,17,7.343,2377,320,2057,1.057,7.849,4062,883,3179,2.916,13.412,-1685,-5.564,15.697,10,10,112
2007,3366,1522,1655,153399,151425,160,9.598,184,11.038,16114,2744,13370,1.812,10.642,12127,3530,8597,2.331,8.009,3987,2.633,16.017,137,137,1133
2007,3369,864,896,46538,45409,123,13.922,98,11.092,6498,1809,4689,3.984,14.31,4397,1691,2706,3.724,9.683,2101,4.627,19.366,80,80,574
2007,3371,14496,14949,330583,340749,1308,8.708,1451,9.66,31667,8251,23416,2.421,9.293,52078,14531,37547,4.264,15.283,-20411,-5.99,18.587,1133,1135,7891
2007,3372,3998,4175,140275,141924,261,6.216,309,7.359,14354,3213,11141,2.264,10.114,17549,4758,12791,3.352,12.365,-3195,-2.251,20.228,235,236,2413
2007,3379,864,997,43593,45200,69,6.883,80,7.98,3962,1388,2574,3.071,8.765,7190,2038,5152,4.509,15.907,-3228,-7.142,17.531,62,63,1316
2007,3391,10712,11521,311025,308277,767,6.626,875,7.559,34023,6240,27783,2.024,11.037,28379,9571,18808,3.105,9.206,5644,1.831,18.411,644,647,3474
2007,3399,17341,17815,348539,350545,2035,11.557,1621,9.206,41750,14067,27683,4.013,11.91,45847,15731,30116,4.488,13.079,-4097,-1.169,23.82,1269,1277,9594
2007,4231,18024,25227,386879,391612,2080,8.24,2113,8.37,47376,14326,33050,3.658,12.098,56840,17582,39258,4.49,14.514,-9464,-2.417,24.195,1268,1328,7587
2007,4232,11470,13289,171979,173852,1290,9.725,1242,9.363,24009,6897,17112,3.967,13.81,27718,8527,19191,4.905,15.943,-3709,-2.133,27.62,864,887,5122
2007,4233,11545,18440,275294,280078,1808,9.913,1406,7.709,39328,14676,24652,5.24,14.042,48825,13117,35708,4.683,17.433,-9497,-3.391,28.084,799,819,6063
2007,4234,24031,33244,740669,739581,2783,8.279,3525,10.486,121147,31546,89601,4.265,16.381,118129,43819,74310,5.925,15.972,3018,0.408,31.945,1998,2064,11940
2007,4235,7784,10682,164971,163138,709,6.648,674,6.32,22838,5620,17218,3.445,13.999,19145,5981,13164,3.666,11.735,3693,2.264,23.471,328,336,1967
2007,4236,19789,29117,491730,493965,2530,8.663,2708,9.272,73248,21802,51446,4.414,14.829,78023,32465,45558,6.572,15.795,-4775,-0.967,29.657,1178,1251,8629
2007,4237,10961,19864,245053,245167,1466,7.468,1001,5.099,31656,8641,23015,3.525,12.912,32050,8473,23577,3.456,13.073,-394,-0.161,25.824,565,590,3601
2007,4238,41984,57492,724214,719202,3849,6.687,3976,6.908,99841,27878,71963,3.876,13.882,89770,31302,58468,4.352,12.482,10071,1.4,24.964,2166,2243,13680
2007,4239,27755,30603,337839,335734,3330,10.928,3071,10.078,55152,17734,37418,5.282,16.427,50641,17550,33091,5.227,15.084,4511,1.344,30.167,2314,2327,10653
2007,4241,8781,11414,176531,180944,673,5.789,1094,9.411,17887,4497,13390,2.485,9.885,26666,10701,15965,5.914,14.737,-8779,-4.852,19.771,543,606,3927
2007,4242,5575,7819,260453,266508,850,10.923,775,9.96,42792,13233,29559,4.965,16.057,55014,24279,30735,9.11,20.643,-12222,-4.586,32.113,481,482,2943
2007,4243,14015,15301,218838,217545,1860,12.237,1658,10.908,37216,13329,23887,6.127,17.107,34853,11373,23480,5.228,16.021,2363,1.086,32.042,1261,1276,6459
2007,4244,24969,31142,779136,782212,3053,9.789,3147,10.09,100629,35831,64798,4.581,12.865,106803,38101,68702,4.871,13.654,-6174,-0.789,25.729,2064,2096,14600
2007,4245,3722,6290,60336,61021,308,4.842,449,7.059,8693,2020,6673,3.31,14.246,10175,2862,7313,4.69,16.675,-1482,-2.429,28.492,205,212,1335
2007,4246,8549,12749,153562,152459,976,7.646,1008,7.897,22638,6059,16579,3.974,14.849,20683,6308,14375,4.138,13.566,1955,1.282,27.133,480,496,2643
2007,4247,5126,7412,105593,108500,516,6.926,593,7.959,16384,4022,12362,3.707,15.1,22345,6015,16330,5.544,20.594,-5961,-5.494,30.201,275,299,2394
2007,4248,3071,3888,177281,176821,318,8.187,310,7.981,19133,4480,14653,2.534,10.821,18108,5924,12184,3.35,10.241,1025,0.58,20.482,182,187,2600
2007,4249,21863,28060,364472,366416,2807,9.954,3089,10.954,54288,17563,36725,4.793,14.816,58396,21927,36469,5.984,15.937,-4108,-1.121,29.632,2074,2105,10665
2007,4251,37259,39332,277909,282955,4983,12.539,5801,14.597,50625,22098,28527,7.81,17.892,61923,29418,32505,10.397,21.884,-11298,-3.993,35.783,4304,4334,14734
2007,4411,42852,47518,1264089,1271523,4455,9.316,5060,10.581,146487,50251,96236,3.952,11.521,161255,69361,91894,5.455,12.682,-14768,-1.161,23.041,3879,3918,50867
2007,4412,13940,15704,170908,170365,1494,9.515,1489,9.483,25232,8738,16494,5.129,14.811,24051,8591,15460,5.043,14.117,1181,0.693,28.235,1105,1131,6142
2007,4413,30003,56079,483557,481940,3840,6.856,3703,6.611,63967,21602,42365,4.482,13.273,61784,17470,44314,3.625,12.82,2183,0.453,25.64,2430,2524,10551
2007,4421,18109,26994,267482,271695,3417,12.722,3147,11.717,46294,23476,22818,8.641,17.039,54516,19052,35464,7.012,20.065,-8222,-3.026,34.078,2083,2346,13548
2007,4422,24592,34061,317864,305073,3556,10.428,3635,10.66,71540,25298,46242,8.292,23.45,47300,16540,30760,5.422,15.504,24240,7.946,31.009,2278,2514,8962
2007,4431,27727,50658,500716,501352,8638,17.42,6498,13.104,97755,51258,46497,10.224,19.498,96957,40238,56719,8.026,19.339,798,0.159,38.678,3845,4114,20914
2007,4441,44482,67687,1196160,1200726,5514,8.224,4230,6.309,127367,63125,64242,5.257,10.608,137709,28571,109138,2.379,11.469,-10342,-0.861,21.215,2755,2887,15459
2007,4442,15196,18447,163842,165042,1370,7.404,1484,8.02,24441,6911,17530,4.187,14.809,26715,6781,19934,4.109,16.187,-2274,-1.378,29.618,1011,1022,4585
2007,4451,55992,82170,2544990,2564095,9262,11.267,9330,11.35,286214,113361,172853,4.421,11.162,325804,111848,213956,4.362,12.706,-39590,-1.544,22.325,6607,6689,40172
2007,4452,16887,20378,136851,136405,3518,17.438,3111,15.42,33256,16486,16770,12.086,24.38,32472,14797,17675,10.848,23.806,784,0.575,47.611,2324,2332,10632
2007,4453,24695,28182,141006,140452,3018,10.781,2640,9.431,25031,9639,15392,6.863,17.822,24010,8513,15497,6.061,17.095,1021,0.727,34.19,1912,1938,6271
2007,4461,40055,83922,1020729,1046628,7928,9.507,6865,8.232,149635,58888,90747,5.626,14.297,199885,48507,151378,4.635,19.098,-50250,-4.801,28.594,3271,3384,15545
2007,4471,62240,110683,899001,911407,10081,9.058,11296,10.15,152027,64954,87073,7.127,16.68,177829,65837,111992,7.224,19.511,-25802,-2.831,33.361,6612,7068,35602
2007,4481,35489,91779,1270183,1258826,11380,12.575,8816,9.742,262643,102668,159975,8.156,20.864,235369,58021,177348,4.609,18.698,27274,2.167,37.395,4356,4575,18543
2007,4482,6252,26969,209427,207573,2553,9.647,1544,5.834,39941,15743,24198,7.584,19.242,36465,8196,28269,3.948,17.567,3476,1.675,35.135,604,700,2385
2007,4483,17582,27054,160912,165068,2234,8.103,3267,11.85,26171,8853,17318,5.363,15.855,33931,14659,19272,8.881,20.556,-7760,-4.701,31.709,1486,1532,4357
2007,4511,27480,37901,438575,433413,4413,11.665,4276,11.302,81315,37097,44218,8.559,18.762,70760,22848,47912,5.272,16.326,10555,2.435,32.652,2930,3032,11572
2007,4512,5343,10756,148192,147277,803,7.275,1367,12.384,23195,5478,17717,3.72,15.749,21213,7522,13691,5.107,14.404,1982,1.346,28.807,678,788,3271
2007,4522,37,5246,715771,723592,277,5.241,355,6.717,61717,21356,40361,2.951,8.529,78033,27932,50101,3.86,10.784,-16316,-2.255,17.059,39,39,190
2007,4523,7845,39176,2167864,2158003,3378,8.724,2471,6.381,194693,66195,128498,3.067,9.022,175073,15178,159895,0.703,8.113,19620,0.909,16.225,1488,1518,5470
2007,4531,17333,18093,93040,95399,1667,9.049,2324,12.616,15283,5358,9925,5.616,16.02,20091,7287,12804,7.638,21.06,-4808,-5.04,32.04,1866,1895,5524
2007,4532,25573,36766,306533,309681,4274,11.532,4867,13.132,53345,21649,31696,6.991,17.226,58911,23105,35806,7.461,19.023,-5566,-1.797,34.452,3381,3508,12513
2007,4533,11945,16512,133372,133097,1689,10.181,1846,11.127,22167,8772,13395,6.591,16.655,21469,6680,14789,5.019,16.13,698,0.524,32.261,1422,1450,4491
2007,4539,30620,38747,255192,253963,4883,12.457,5788,14.765,52126,21620,30506,8.513,20.525,48140,20028,28112,7.886,18.956,3986,1.57,37.911,3600,3684,12099
2007,4541,17885,19058,342661,335498,3008,16.255,1903,10.283,63393,22965,40428,6.845,18.895,49408,16918,32490,5.043,14.727,13985,4.168,29.454,1464,1474,8489
2007,4542,4138,4660,49188,50458,479,10.176,573,12.173,6484,1634,4850,3.238,12.85,8853,3956,4897,7.84,17.545,-2369,-4.695,25.701,428,438,2156
2007,4543,23344,29338,214582,216293,3041,10.447,2585,8.88,32058,12642,19416,5.845,14.822,35489,10612,24877,4.906,16.408,-3431,-1.586,29.643,1711,1727,5980
2007,4811,518,3011,439290,434468,325,10.884,275,9.21,62342,11349,50993,2.612,14.349,52734,18737,33997,4.313,12.138,9608,2.211,24.275,35,35,268
2007,4812,2022,2236,40294,40354,326,14.728,281,12.695,5106,1266,3840,3.137,12.653,5233,1996,3237,4.946,12.968,-127,-0.315,25.306,200,203,1187
2007,4831,706,1025,55013,54432,97,9.331,126,12.121,8448,1942,6506,3.568,15.52,6879,2218,4661,4.075,12.638,1569,2.883,25.276,66,67,900
2007,4832,463,511,19536,19425,74,14.496,73,14.3,2678,1031,1647,5.308,13.787,2438,1038,1400,5.344,12.551,240,1.236,25.102,36,36,478
2007,4841,48555,57457,979010,984192,9765,17.13,8862,15.546,149294,41233,108061,4.19,15.169,160852,59555,101297,6.051,16.344,-11558,-1.174,30.338,6662,6738,28332
2007,4842,41860,46369,495280,491736,6667,14.447,6224,13.487,93044,33464,59580,6.805,18.922,86490,28000,58490,5.694,17.589,6554,1.333,35.177,4723,4738,19838
2007,4851,569,880,49979,50133,72,8.145,80,9.05,5040,1524,3516,3.04,10.053,5266,2223,3043,4.434,10.504,-226,-0.451,20.107,51,51,963
2007,4852,178,518,17997,16948,78,15.102,75,14.521,4944,2250,2694,13.276,29.172,2753,1207,1546,7.122,16.244,2191,12.928,32.489,19,19,307
2007,4853,6017,6112,71820,70132,1035,17.173,865,14.352,13772,5101,8671,7.273,19.637,10484,3810,6674,5.433,14.949,3288,4.688,29.898,701,701,3285
2007,4854,2886,4401,209527,202393,582,13.656,304,7.133,35340,16908,18432,8.354,17.461,20263,8851,11412,4.373,10.012,15077,7.449,20.023,172,173,2374
2007,4855,1115,1227,31001,30789,107,8.664,123,9.96,4645,1264,3381,4.105,15.087,4271,1164,3107,3.781,13.872,374,1.215,27.744,86,87,618
2007,4859,2637,2890,60034,59783,394,13.614,402,13.891,9710,3012,6698,5.038,16.242,9351,4167,5184,6.97,15.642,359,0.601,31.283,315,321,3048
2007,4861,43,396,6418,6376,81,22.253,17,4.67,1350,306,1044,4.8,21.175,1278,519,759,8.141,20.045,72,1.129,40.091,(D),(D),(D)
2007,4862,119,1489,22976,22756,162,11.13,95,6.527,3988,1192,2796,5.238,17.525,3600,2070,1530,9.097,15.82,388,1.705,31.641,7,7,67
2007,4869,51,601,6263,6356,33,5.323,71,11.452,1003,391,612,6.152,15.78,1246,768,478,12.083,19.604,-243,-3.823,31.561,5,21,219
2007,4871,468,516,9057,8727,82,16.094,69,13.543,1976,675,1301,7.735,22.642,1342,628,714,7.196,15.378,634,7.265,30.755,50,50,290
2007,4872,1199,1237,10946,11037,225,18.503,183,15.049,2075,852,1223,7.72,18.801,2245,644,1601,5.835,20.342,-170,-1.54,37.603,139,139,522
2007,4879,125,133,2135,2213,20,14.981,21,15.73,234,79,155,3.57,10.574,381,136,245,6.146,17.216,-147,-6.643,21.148,14,14,30
2007,4881,3707,5186,171220,169452,693,13.331,718,13.812,27870,10209,17661,6.025,16.447,24197,8981,15216,5.3,14.28,3673,2.168,28.559,293,293,2023
2007,4882,456,987,28524,28566,127,13.012,105,10.758,4588,1208,3380,4.229,16.061,4620,2395,2225,8.384,16.173,-32,-0.112,32.123,39,40,501
2007,4883,1698,2232,85811,84891,192,8.643,171,7.698,10930,2168,8762,2.554,12.875,9165,2087,7078,2.458,10.796,1765,2.079,21.593,98,98,662
2007,4884,8185,8799,74608,72822,1311,15.132,1040,12.004,15241,6861,8380,9.422,20.929,11746,4709,7037,6.466,16.13,3495,4.799,32.26,780,784,3170
2007,4885,13773,20189,242529,234161,2796,14.223,1735,8.826,54136,27342,26794,11.677,23.119,37391,13927,23464,5.948,15.968,16745,7.151,31.936,855,869,4316
2007,4889,1179,1273,16455,16208,229,18.342,180,14.417,3200,1170,2030,7.219,19.743,2732,1028,1704,6.343,16.856,468,2.887,33.712,133,136,698
2007,4921,2989,8149,525158,525063,989,12.258,828,10.262,46913,20295,26618,3.865,8.935,47151,12657,34494,2.411,8.98,-238,-0.045,17.869,331,338,2002
2007,4922,3529,3798,36241,37988,551,14.026,812,20.669,7552,2691,4861,7.084,19.88,11097,6297,4800,16.576,29.212,-3545,-9.332,39.76,489,503,2099
2007,4931,6722,13613,731729,724277,1195,8.739,1318,9.638,116565,35514,81051,4.903,16.094,101006,32303,68703,4.46,13.946,15559,2.148,27.892,346,364,3640
2007,5111,14793,21062,683015,686639,1900,8.958,2197,10.358,79259,21617,57642,3.148,11.543,87349,27170,60179,3.957,12.721,-8090,-1.178,23.086,1230,1252,9570
2007,5112,5441,7777,380086,381401,741,9.218,1264,15.724,54621,13857,40764,3.633,14.321,57724,21754,35970,5.704,15.135,-3103,-0.814,28.642,433,466,7683
2007,5121,12584,15972,319264,318837,2393,15.087,2171,13.688,54671,15184,39487,4.762,17.147,54269,21959,32310,6.887,17.021,402,0.126,34.042,1362,1380,13140
2007,5122,2883,3052,24381,24449,491,16.175,458,15.088,4081,1516,2565,6.201,16.692,4156,1723,2433,7.047,16.999,-75,-0.307,33.384,302,303,842
2007,5151,4220,9156,250943,255638,939,10.036,1339,14.312,34256,13800,20456,5.398,13.4,44855,14100,30755,5.516,17.546,-10599,-4.146,26.8,300,310,3301
2007,5152,416,683,42812,43892,86,12.5,96,13.953,7268,2052,5216,4.675,16.559,9418,2898,6520,6.603,21.457,-2150,-4.898,33.118,28,28,200
2007,5173,4722,44265,1172952,1163758,6790,15.487,5946,13.562,221043,110244,110799,9.473,18.994,199785,105344,94441,9.052,17.167,21258,1.827,34.334,729,841,5952
2007,5174,559,656,9195,9183,164,26.929,70,11.494,3161,823,2338,8.962,34.422,3035,795,2240,8.657,33.05,126,1.372,66.1,39,39,322
2007,5179,4287,4746,64208,66337,937,19.264,1173,24.116,14796,4758,10038,7.173,22.304,18865,7650,11215,11.532,28.438,-4069,-6.134,44.609,848,875,4609
2007,5182,8099,14578,410081,417062,1874,12.26,3290,21.523,92214,31153,61061,7.47,22.11,106165,43347,62818,10.393,25.455,-13951,-3.345,44.221,644,665,6221
2007,5191,5202,6506,122040,119305,1005,15.849,675,10.645,21035,5763,15272,4.83,17.631,15594,4769,10825,3.997,13.071,5441,4.561,26.142,459,461,2256
2007,5211,13,48,19519,19743,(D),(D),6,12,820,(D),801,(D),4.153,1218,75,1143,0.38,6.169,-398,-2.016,8.307,5,5,43
2007,5221,15260,124402,2136279,2149846,12187,9.943,8519,6.95,289599,113829,175770,5.295,13.471,316550,119249,197301,5.547,14.724,-26951,-1.254,26.941,513,622,15073
2007,5222,17401,50921,781374,793633,8580,16.717,9389,18.293,183665,80127,103538,10.096,23.142,208205,92278,115927,11.627,26.234,-24540,-3.092,46.285,2624,3080,21648
2007,5223,26986,46169,349173,352600,8540,18.937,6394,14.179,89390,38250,51140,10.848,25.352,95679,38773,56906,10.996,27.135,-6289,-1.784,50.703,3918,4143,20158
2007,5231,12040,37856,498799,507416,6025,15.819,6487,17.032,106642,38015,68627,7.492,21.017,125866,57981,67885,11.427,24.805,-19224,-3.789,42.033,1055,1109,4441
2007,5232,21,48,8043,7645,8,9.877,74,91.358,2020,415,1605,5.428,26.422,1134,733,401,9.588,14.833,886,11.589,29.666,10,10,544
2007,5239,37037,41581,417330,411433,7039,17.268,5405,13.259,80563,34910,45653,8.485,19.581,68804,27931,40873,6.789,16.723,11759,2.858,33.446,3323,3337,11690
2007,5241,5858,32359,1451783,1454097,4261,13.084,4675,14.355,199933,77372,122561,5.321,13.75,203986,74150,129836,5.099,14.028,-4053,-0.279,27.499,580,587,3301
2007,5242,121905,137403,930793,939732,14002,10.263,12047,8.83,155817,61112,94705,6.503,16.581,174265,70993,103272,7.555,18.544,-18448,-1.963,33.162,7777,7912,28182
2007,5259,440,454,7039,6212,150,32.468,166,35.931,3071,2254,817,36.288,49.441,1473,735,738,11.833,23.714,1598,25.726,47.428,140,141,616
2007,5311,85048,106490,539997,547058,13964,13.187,12775,12.064,106170,52630,53540,9.621,19.407,121451,51692,69759,9.449,22.201,-15281,-2.793,38.815,8219,8307,29347
2007,5312,77491,87448,355490,361125,16158,18.517,15778,18.082,84390,44153,40237,12.227,23.369,96278,38998,57280,10.799,26.661,-11888,-3.292,46.737,11330,11430,25327
2007,5313,63583,73914,643567,638644,10986,15.083,8833,12.127,118628,49810,68818,7.799,18.575,108747,42826,65921,6.706,17.028,9881,1.547,34.056,5994,6047,24482
2007,5321,4096,12174,184873,178107,1400,11.412,1588,12.944,42528,8079,34449,4.536,23.878,29165,12628,16537,7.09,16.375,13363,7.503,32.75,483,512,2372
2007,5322,10738,31370,244233,249284,2161,6.775,3215,10.079,31870,10431,21439,4.184,12.785,41947,16091,25856,6.455,16.827,-10077,-4.042,25.569,1437,1577,6491
2007,5323,2921,4503,29393,29948,327,7.177,434,9.525,4273,1309,2964,4.371,14.268,5389,1956,3433,6.531,17.995,-1116,-3.726,28.536,212,219,986
2007,5324,7360,13016,162222,159159,1522,11.851,1175,9.149,28874,8579,20295,5.39,18.142,23075,8548,14527,5.371,14.498,5799,3.644,28.996,628,638,4159
2007,5331,1928,2023,29739,29639,289,14.378,263,13.085,6511,2412,4099,8.138,21.968,6395,2496,3899,8.421,21.576,116,0.391,43.153,178,178,799
2007,5411,164544,173925,1195452,1204735,15390,8.862,14876,8.566,142184,48737,93447,4.045,11.802,161407,50556,110851,4.196,13.398,-19223,-1.596,23.604,10685,10755,30833
2007,5412,95026,109767,1263901,1285290,10898,9.943,10563,9.638,210793,64795,145998,5.041,16.4,251890,91486,160404,7.118,19.598,-41097,-3.197,32.801,6267,6309,45422
2007,5413,89552,103385,1412522,1393373,11106,10.826,9509,9.269,221829,66923,154906,4.803,15.92,183862,62355,121507,4.475,13.195,37967,2.725,26.391,6022,6113,25263
2007,5414,27322,27565,122592,122217,4341,15.939,3681,13.516,23867,9893,13974,8.095,19.528,23090,9976,13114,8.163,18.893,777,0.636,37.785,2692,2698,6959
2007,5415,84121,98048,1260137,1221518,18751,19.529,14687,15.296,306980,101950,205030,8.346,25.131,233161,95947,137214,7.855,19.088,73819,6.043,38.176,9568,9634,38901
2007,5416,100558,105975,789958,783429,21420,20.624,17194,16.555,178602,74541,104061,9.515,22.797,165519,77631,87888,9.909,21.128,13083,1.67,42.255,12023,12084,42626
2007,5417,10955,14284,664073,669016,2000,14.12,1761,12.432,100288,18627,81661,2.784,14.99,111783,39485,72298,5.902,16.709,-11495,-1.718,29.981,951,967,9288
2007,5418,32142,35481,453542,459313,4521,12.828,4046,11.48,84368,28914,55454,6.295,18.368,97525,30987,66538,6.746,21.233,-13157,-2.864,36.737,2758,2787,12473
2007,5419,53769,63175,578011,571290,7560,12.146,5693,9.147,99236,34580,64656,6.053,17.371,86435,28359,58076,4.964,15.13,12801,2.241,30.26,4000,4022,16685
2007,5511,26444,50110,2864926,2843623,5865,11.73,5643,11.286,572446,178715,393731,6.285,20.131,525580,193249,332331,6.796,18.483,46866,1.648,36.966,882,916,11839
2007,5611,23041,24912,390912,393624,4302,17.66,3197,13.124,82600,37063,45537,9.416,20.985,87875,43609,44266,11.079,22.325,-5275,-1.34,41.969,2285,2305,22395
2007,5612,1694,5693,270710,248518,648,11.676,362,6.523,72351,15647,56704,6.296,29.113,28185,9171,19014,3.69,11.341,44166,17.772,22.683,107,108,1112
2007,5613,27767,47840,4894132,4874462,7264,15.422,5785,12.282,1056272,303420,752852,6.225,21.67,1024137,260422,763715,5.343,21.01,32135,0.659,42.021,2770,2925,156728
2007,5614,26649,33265,799503,813772,4093,12.257,4349,13.024,135724,46247,89477,5.683,16.678,161916,55032,106884,6.763,19.897,-26192,-3.219,33.357,2809,2836,19770
2007,5615,15443,20766,259956,260279,1730,8.166,2570,12.131,38351,9709,28642,3.73,14.735,39161,14716,24445,5.654,15.046,-810,-0.311,29.469,1370,1406,6644
2007,5616,17460,22845,777997,781191,2876,12.699,2481,10.955,131457,36818,94639,4.713,16.828,138818,55117,83701,7.056,17.77,-7361,-0.942,33.656,1540,1565,20785
2007,5617,137112,143375,1679200,1677417,23259,16.393,20282,14.295,332221,115779,216442,6.902,19.806,327192,119998,207194,7.154,19.506,5029,0.3,39.011,14135,14158,68373
2007,5619,16493,18516,313720,324546,1997,10.741,2151,11.569,49093,13837,35256,4.264,15.127,69775,24858,44917,7.659,21.499,-20682,-6.373,30.253,1412,1420,9137
2007,5621,7344,9388,194394,189186,1220,13.264,839,9.122,43180,21855,21325,11.552,22.824,33107,12981,20126,6.862,17.5,10073,5.324,34.999,499,499,2875
2007,5622,1393,2485,58930,61088,254,10.232,249,10.03,7987,3193,4794,5.227,13.075,12122,5250,6872,8.594,19.844,-4135,-6.769,26.149,108,108,898
2007,5629,7316,8232,121633,121663,1030,12.773,694,8.606,26352,9609,16743,7.898,21.66,26825,8094,18731,6.653,22.049,-473,-0.389,43.32,452,459,4180
2007,6111,17651,19980,823436,813891,992,4.983,845,4.245,70169,15922,54247,1.956,8.621,50960,11789,39171,1.448,6.261,19209,2.36,12.523,614,624,8344
2007,6112,436,826,80185,81403,31,3.73,41,4.934,5468,651,4817,0.8,6.717,8115,670,7445,0.823,9.969,-2647,-3.252,13.434,24,26,311
2007,6113,2263,3775,1561201,1544687,234,6.292,122,3.28,89575,8872,80703,0.574,5.799,57424,3840,53584,0.249,3.718,32151,2.081,7.435,72,74,795
2007,6114,6587,7190,68128,67814,1015,14.298,833,11.734,14759,6676,8083,9.845,21.764,14083,5631,8452,8.304,20.767,676,0.997,41.535,545,554,3008
2007,6115,6103,7582,128575,127679,883,11.799,686,9.167,23876,7281,16595,5.703,18.7,22490,5000,17490,3.916,17.615,1386,1.086,35.229,475,477,2372
2007,6116,30557,32867,307599,302360,5030,15.661,3530,10.991,69853,27855,41998,9.213,23.103,59331,19545,39786,6.464,19.623,10522,3.48,39.245,2534,2548,11601
2007,6117,4940,5641,72000,72375,840,15.073,704,12.632,12736,3956,8780,5.466,17.597,13429,3582,9847,4.949,18.555,-693,-0.958,35.195,477,485,1688
2007,6211,176857,203459,2105184,2088850,16307,8.036,15231,7.506,309080,109090,199990,5.222,14.797,279009,93075,185934,4.456,13.357,30071,1.44,26.714,10058,10286,47296
2007,6212,114626,120445,825505,821904,7022,5.867,5501,4.596,109059,35337,73722,4.299,13.269,101882,26290,75592,3.199,12.396,7177,0.873,24.792,4234,4358,20305
2007,6213,100972,112942,612140,604540,13177,11.871,9289,8.369,117446,46977,70469,7.771,19.427,101753,36735,65018,6.077,16.831,15693,2.596,33.663,6125,6208,18971
2007,6214,13475,28480,644110,640696,3510,12.623,2163,7.779,100372,38767,61605,6.051,15.666,93408,32811,60597,5.121,14.579,6964,1.087,29.158,768,843,9098
2007,6215,6998,12073,235274,234317,1892,16.19,1118,9.567,37512,15201,22311,6.487,16.009,35833,17623,18210,7.521,15.293,1679,0.717,30.585,647,695,6104
2007,6216,14109,20779,980251,957929,3599,18.042,1937,9.71,171542,57229,114313,5.974,17.908,126060,34479,91581,3.599,13.16,45482,4.748,26.319,1122,1174,15540
2007,6219,5562,8743,270311,263037,1026,11.922,752,8.738,51099,15798,35301,6.006,19.427,36458,12397,24061,4.713,13.86,14641,5.566,27.721,379,387,4695
2007,6221,3050,5065,5055455,4997251,62,1.22,100,1.967,313183,33502,279681,0.67,6.267,194537,40411,154126,0.809,3.893,118646,2.374,7.786,47,47,15939
2007,6222,421,563,210577,211044,19,3.351,27,4.762,18585,4050,14535,1.919,8.806,19770,2608,17162,1.236,9.368,-1185,-0.561,17.612,9,9,822
2007,6223,360,818,234323,232977,57,6.947,62,7.556,23944,4792,19152,2.057,10.277,21599,6538,15061,2.806,9.271,2345,1.007,18.542,34,36,2550
2007,6231,7962,15518,1583102,1575493,1367,8.849,1226,7.937,163108,73105,90003,4.64,10.353,148375,74586,73789,4.734,9.418,14733,0.935,18.835,572,626,41534
2007,6232,8621,32464,598597,595619,2676,8.3,2228,6.911,85551,26499,59052,4.449,14.363,80496,22297,58199,3.744,13.515,5055,0.849,27.029,361,419,5456
2007,6233,13815,19462,733048,718577,2205,11.466,1742,9.059,101046,47520,53526,6.613,14.062,72079,28961,43118,4.03,10.031,28967,4.031,20.062,1259,1287,19772
2007,6239,3388,5897,151429,151805,453,7.668,475,8.04,20013,5617,14396,3.7,13.183,20791,6091,14700,4.012,13.696,-778,-0.513,26.367,217,228,2819
2007,6241,38289,53860,1177189,1153847,5519,10.406,3873,7.302,182570,47584,134986,4.124,15.823,135212,31856,103356,2.761,11.718,47358,4.104,23.437,2205,2276,16618
2007,6242,9345,13583,165654,165257,715,5.268,692,5.099,22472,4926,17546,2.981,13.598,21547,5389,16158,3.261,13.038,925,0.56,26.077,286,292,2024
2007,6243,4370,7380,321057,322798,431,5.748,667,8.896,44391,5984,38407,1.854,13.752,48247,10282,37965,3.185,14.946,-3856,-1.195,27.504,223,250,1695
2007,6244,53888,68777,859000,858618,7714,11.187,8075,11.71,134616,52426,82190,6.106,15.678,135810,59785,76025,6.963,15.817,-1194,-0.139,31.356,5020,5112,28267
2007,7111,7134,7269,124180,124416,932,12.856,893,12.318,20997,5999,14998,4.822,16.877,21623,5765,15858,4.634,17.38,-626,-0.503,33.753,621,624,3813
2007,7112,3312,3485,122272,120543,556,16.072,505,14.597,21089,5653,15436,4.69,17.495,17452,6327,11125,5.249,14.478,3637,3.017,28.956,361,361,3559
2007,7113,5187,5554,123578,120654,786,14.441,564,10.362,23248,7411,15837,6.142,19.268,17731,3346,14385,2.773,14.696,5517,4.573,29.391,399,400,1894
2007,7114,2729,2806,17855,17300,453,16.395,367,13.283,3856,1384,2472,8,22.289,2780,1224,1556,7.075,16.069,1076,6.22,32.139,271,271,968
2007,7115,13556,13577,43894,45079,2657,19.773,2378,17.697,13339,6793,6546,15.069,29.59,15631,6294,9337,13.962,34.675,-2292,-5.084,59.181,1511,1512,4231
2007,7121,6129,6614,128449,126137,432,6.576,343,5.221,13209,1826,11383,1.448,10.472,8667,1728,6939,1.37,6.871,4542,3.601,13.742,194,196,909
2007,7131,2048,2538,133077,139382,400,15.696,421,16.52,14849,4697,10152,3.37,10.653,27442,5987,21455,4.295,19.688,-12593,-9.035,21.307,282,300,2816
2007,7132,1656,2218,167517,165975,286,12.894,286,12.894,20984,5332,15652,3.213,12.643,17592,7549,10043,4.548,10.599,3392,2.044,21.198,179,179,3021
2007,7139,50867,57166,1169515,1159719,7421,13.068,6662,11.732,177719,62127,115592,5.357,15.324,159049,53204,105845,4.588,13.714,18670,1.61,27.429,5201,5227,37960
2007,7211,37867,47686,1885254,1879313,5593,11.77,5263,11.075,271959,122187,149772,6.502,14.471,259751,129237,130514,6.877,13.822,12208,0.65,27.643,3448,3491,56433
2007,7212,5307,5846,39954,39529,649,11.208,538,9.291,7818,2327,5491,5.887,19.778,6952,2070,4882,5.237,17.587,866,2.191,35.174,346,346,1271
2007,7213,2007,2068,10987,11094,124,5.947,158,7.578,1443,379,1064,3.416,13.008,1656,648,1008,5.841,14.928,-213,-1.92,26.015,110,110,372
2007,7223,11985,32210,608377,598817,7089,22.781,4906,15.766,170448,79965,90483,13.354,28.464,144315,55660,88655,9.295,24.1,26133,4.364,48.2,1443,1463,8727
2007,7224,41521,42195,355230,355531,5133,12.102,5569,13.13,79521,41270,38251,11.608,22.367,79616,33358,46258,9.383,22.394,-95,-0.027,44.734,4672,4676,28290
2007,7225,317197,438609,8714345,8667259,59714,13.805,47572,10.998,1556194,808469,747725,9.328,17.955,1460770,493364,967406,5.692,16.854,95424,1.101,33.708,36747,37644,346912
2007,8111,139604,152687,876164,879434,14575,9.517,15500,10.121,148596,59769,88827,6.796,16.897,154669,56416,98253,6.415,17.587,-6073,-0.691,33.794,11562,11846,42238
2007,8112,10510,11834,124537,125294,1301,10.856,1602,13.367,23719,8928,14791,7.126,18.931,25343,9063,16280,7.233,20.227,-1624,-1.296,37.862,1038,1042,3701
2007,8113,19525,20964,189468,184539,2187,10.469,2041,9.77,36695,13941,22754,7.555,19.885,26241,9987,16254,5.412,14.22,10454,5.665,28.44,1453,1455,5503
2007,8114,17709,18724,78807,81837,2138,11.301,2528,13.362,14054,5120,8934,6.256,17.173,19896,7640,12256,9.336,24.312,-5842,-7.139,34.347,1854,1865,4413
2007,8121,84115,99953,613648,615343,14427,14.582,12400,12.533,117710,59439,58271,9.659,19.129,121503,47979,73524,7.797,19.746,-3793,-0.616,38.258,9714,9856,34718
2007,8122,14727,20293,136826,136399,962,4.757,820,4.055,18566,3942,14624,2.89,13.612,17747,2914,14833,2.136,13.011,819,0.6,26.022,461,469,1607
2007,8123,30889,36723,345954,349426,3808,10.241,4728,12.715,52001,17261,34740,4.94,14.882,58805,24516,34289,7.016,16.829,-6804,-1.947,29.764,3336,3420,14110
2007,8129,20646,31052,239454,233312,5993,19.503,5347,17.401,65268,30171,35097,12.932,27.975,53055,25504,27551,10.931,22.74,12213,5.235,45.48,2507,2558,9413
2007,8131,168994,169309,1678343,1677942,9166,5.443,7341,4.359,163678,28569,135109,1.703,9.755,162520,23454,139066,1.398,9.686,1158,0.069,19.371,4459,4459,13537
2007,8132,13875,15868,188371,181642,1285,8.198,899,5.735,29494,4836,24658,2.662,16.237,15490,3797,11693,2.09,8.528,14004,7.71,17.056,554,557,2524
2007,8133,12426,14701,129576,127294,1432,9.915,916,6.342,19353,4860,14493,3.818,15.203,14722,3193,11529,2.508,11.565,4631,3.638,23.131,517,521,1774
2007,8134,26333,28094,257293,257048,1653,5.888,1611,5.739,33434,6702,26732,2.607,13.007,32968,7226,25742,2.811,12.826,466,0.181,25.651,1068,1072,4119
2007,8139,56105,58270,511270,512968,2947,5.032,3548,6.058,59415,12144,47271,2.367,11.583,62936,14074,48862,2.744,12.269,-3521,-0.686,23.165,2459,2463,9663
2008,1131,324,357,2350,2453,27,7.357,47,12.807,295,101,194,4.117,12.026,502,210,292,8.561,20.465,-207,-8.439,24.052,26,26,151
2008,1132,134,189,2121,2172,20,10.127,37,18.734,493,253,240,11.648,22.698,579,284,295,13.076,26.657,-86,-3.959,45.396,18,18,196
2008,1133,8123,8193,56287,57686,675,7.978,1210,14.302,8281,2096,6185,3.633,14.355,11168,3873,7295,6.714,19.36,-2887,-5.005,28.711,897,898,2969
2008,1141,1131,1137,5389,5345,177,15.038,257,21.835,1078,431,647,8.064,20.17,985,455,530,8.513,18.43,93,1.74,36.86,141,141,230
2008,1142,264,264,1851,1847,32,12.214,28,10.687,217,74,143,4.006,11.749,211,45,166,2.436,11.424,6,0.325,22.848,22,22,37
2008,1151,3400,3738,63538,63459,399,10.647,418,11.154,10730,2847,7883,4.486,16.909,10682,3584,7098,5.648,16.833,48,0.076,33.666,292,294,3198
2008,1152,3646,3744,19933,19915,514,13.747,504,13.48,3442,1307,2135,6.563,17.283,3401,1510,1891,7.582,17.078,41,0.206,34.155,391,391,1011
2008,1153,1265,1366,11554,11815,153,11.019,198,14.26,2155,587,1568,4.968,18.24,2676,691,1985,5.849,22.65,-521,-4.41,36.481,98,98,337
2008,2111,5773,7046,103671,123056,794,11.442,581,8.372,18235,6900,11335,5.607,14.818,56603,7755,48848,6.302,45.998,-38368,-31.179,29.637,373,373,3342
2008,2121,577,975,78983,79272,101,10.228,126,12.759,11303,2076,9227,2.619,14.259,11927,3357,8570,4.235,15.046,-624,-0.787,28.517,75,75,1326
2008,2122,211,269,33103,33975,43,16.288,33,12.5,3773,660,3113,1.943,11.105,5549,174,5375,0.512,16.333,-1776,-5.227,22.211,21,21,101
2008,2123,3135,5198,90386,96771,258,4.896,401,7.61,10862,2702,8160,2.792,11.224,23390,2537,20853,2.622,24.171,-12528,-12.946,22.449,232,236,1446
2008,2131,9005,11071,319450,332207,1562,14.454,1033,9.559,60351,17698,42653,5.327,18.167,86648,14410,72238,4.338,26.083,-26297,-7.916,36.333,709,712,7660
2008,2211,1602,9602,509417,512499,700,7.328,601,6.292,45874,13771,32103,2.687,8.951,51677,13798,37879,2.692,10.083,-5803,-1.132,17.902,53,56,641
2008,2212,432,2244,81005,80661,157,6.989,162,7.211,9845,3896,5949,4.83,12.205,9257,1581,7676,1.96,11.476,588,0.729,22.953,23,23,272
2008,2213,3540,4565,42906,42520,462,10.258,340,7.549,8777,5732,3045,13.481,20.642,8022,3275,4747,7.702,18.866,755,1.776,37.733,145,145,523
2008,2361,154081,155477,801523,851383,24746,15.512,32846,20.59,167868,73257,94611,8.604,19.717,267432,100730,166702,11.831,31.411,-99564,-11.694,39.434,24688,24688,73630
2008,2362,39624,40752,706503,705322,3901,9.511,4427,10.794,129006,27182,101824,3.854,18.29,127793,29059,98734,4.12,18.118,1213,0.172,36.237,3259,3273,18052
2008,2371,17989,19073,545631,542136,1512,7.862,1829,9.51,98097,15855,82242,2.925,18.095,91096,19305,71791,3.561,16.803,7001,1.291,33.606,1267,1267,8165
2008,2372,9679,9821,95076,98666,942,9.155,1879,18.261,14421,3549,10872,3.597,14.616,21572,6153,15419,6.236,21.864,-7151,-7.248,29.232,1571,1572,5016
2008,2373,9392,10189,308269,312670,633,6.129,911,8.821,42467,8998,33469,2.878,13.582,51542,6069,45473,1.941,16.484,-9075,-2.902,27.164,610,610,4419
2008,2379,3924,4062,67487,68203,462,11.266,540,13.168,13648,3525,10123,5.168,20.011,15124,3969,11155,5.819,22.175,-1476,-2.164,40.022,363,363,1912
2008,2381,91401,92217,1016401,1067972,10245,10.732,16744,17.539,188362,45297,143065,4.241,17.637,291775,70631,221144,6.614,27.32,-103413,-9.683,35.275,12193,12194,52282
2008,2382,164632,168441,1991115,1990475,16516,9.779,17407,10.307,338620,70171,268449,3.525,17.012,336529,74850,261679,3.76,16.907,2091,0.105,33.814,13236,13252,57990
2008,2383,108584,109711,880014,909712,14067,12.493,19840,17.62,176246,51773,124473,5.691,19.374,235368,64216,171152,7.059,25.873,-59122,-6.499,38.748,15042,15044,48795
2008,2389,61664,62402,580736,597575,8112,12.757,10481,16.483,104473,32625,71848,5.46,17.483,138065,38062,100003,6.369,23.104,-33592,-5.621,34.966,7605,7608,29093
2008,3111,1122,1707,50399,48119,98,5.739,99,5.798,8497,1265,7232,2.629,17.658,4253,1141,3112,2.371,8.839,4244,8.82,17.677,70,70,693
2008,3112,432,757,55728,55198,41,5.43,37,4.901,4157,787,3370,1.426,7.531,3082,1094,1988,1.982,5.584,1075,1.948,11.167,25,25,447
2008,3113,1449,1602,67985,69580,128,7.975,134,8.349,6395,1431,4964,2.057,9.191,9467,2675,6792,3.844,13.606,-3072,-4.415,18.382,95,95,1312
2008,3114,1177,1545,159761,159403,86,5.527,108,6.941,14203,3568,10635,2.238,8.91,13610,2902,10708,1.821,8.538,593,0.372,17.076,78,78,1481
2008,3115,992,1502,132316,131215,83,5.554,68,4.55,11667,1595,10072,1.216,8.892,9450,2054,7396,1.565,7.202,2217,1.69,14.404,49,49,1252
2008,3116,2854,3464,499117,494053,180,5.164,223,6.398,36500,5674,30826,1.148,7.388,26751,8458,18293,1.712,5.415,9749,1.973,10.829,170,170,4230
2008,3117,508,603,33635,33137,38,6.23,52,8.525,5117,387,4730,1.168,15.442,4073,1195,2878,3.606,12.292,1044,3.151,24.583,37,37,537
2008,3118,8609,9332,280708,283406,804,8.58,881,9.402,27710,7456,20254,2.631,9.778,32679,8972,23707,3.166,11.531,-4969,-1.753,19.555,698,703,5084
2008,3119,2594,3045,164625,164074,234,7.69,230,7.558,17632,4694,12938,2.861,10.746,16643,4281,12362,2.609,10.144,989,0.603,20.287,165,166,2424
2008,3121,2962,3546,136048,135103,471,13.666,272,7.892,16571,5537,11034,4.098,12.266,14536,3575,10961,2.646,10.759,2035,1.506,21.518,191,196,1647
2008,3122,69,97,18803,19433,5,5.102,7,7.143,430,56,374,0.288,2.213,1673,215,1458,1.106,8.609,-1243,-6.397,4.426,(D),(D),(D)
2008,3131,260,374,39377,41521,16,4.134,42,10.853,1831,241,1590,0.58,4.41,6169,2178,3991,5.246,14.858,-4338,-10.448,8.82,24,26,462
2008,3132,1008,1139,66720,71250,64,5.468,127,10.85,4969,1341,3628,1.882,6.974,14164,7085,7079,9.944,19.879,-9195,-12.905,13.948,83,86,3042
2008,3133,1086,1141,41035,42333,87,7.497,126,10.857,4471,847,3624,2.001,10.562,6957,3609,3348,8.525,16.434,-2486,-5.873,21.123,98,99,1487
2008,3141,2097,2232,69879,73089,140,6.174,211,9.305,5889,2232,3657,3.054,8.057,12418,4349,8069,5.95,16.99,-6529,-8.933,16.115,166,166,1286
2008,3149,3898,4020,71096,71264,359,8.954,338,8.43,9254,2369,6885,3.324,12.986,9734,3165,6569,4.441,13.659,-480,-0.674,25.971,262,262,2028
2008,3151,334,353,20134,21929,28,7.457,73,19.441,1751,705,1046,3.215,7.985,5285,3454,1831,15.751,24.101,-3534,-16.116,15.97,54,55,1178
2008,3152,6133,6231,130294,133007,893,13.923,1259,19.629,25293,9622,15671,7.234,19.016,30429,15912,14517,11.963,22.878,-5136,-3.861,38.033,1096,1097,12599
2008,3159,679,697,12933,13329,61,8.502,102,14.216,1052,229,823,1.718,7.893,1863,467,1396,3.504,13.977,-811,-6.084,15.785,89,89,376
2008,3161,204,212,4901,4902,12,5.53,22,10.138,706,135,571,2.754,14.402,685,109,576,2.224,13.974,21,0.428,27.948,18,18,104
2008,3162,220,242,13001,13261,17,6.953,22,8.998,691,77,614,0.581,5.211,1221,425,796,3.205,9.208,-530,-3.997,10.422,16,16,90
2008,3169,753,766,15564,15837,75,9.721,86,11.147,1823,540,1283,3.41,11.511,2298,1409,889,8.897,14.511,-475,-2.999,23.023,61,61,226
2008,3211,3250,3661,101459,104990,228,6.091,393,10.498,8303,3105,5198,2.957,7.908,15336,4922,10414,4.688,14.607,-7033,-6.699,15.817,298,304,2896
2008,3212,1417,1820,93990,101466,122,6.607,175,9.477,7223,2744,4479,2.704,7.119,22397,5845,16552,5.761,22.073,-15174,-14.955,14.237,100,102,1834
2008,3219,9030,10071,292772,304807,707,6.927,978,9.582,28469,9332,19137,3.062,9.34,52727,13008,39719,4.268,17.299,-24258,-7.958,18.68,765,772,8534
2008,3221,238,482,122459,124690,17,3.502,24,4.943,3496,435,3061,0.349,2.804,7739,1749,5990,1.403,6.207,-4243,-3.403,5.608,12,12,274
2008,3222,2872,4268,287080,291034,143,3.31,248,5.74,16631,3989,12642,1.371,5.714,24529,7659,16870,2.632,8.428,-7898,-2.714,11.429,142,143,2276
2008,3231,29229,30787,618370,629069,1649,5.268,2680,8.562,48813,12558,36255,1.996,7.76,70502,23876,46626,3.795,11.207,-21689,-3.448,15.519,2195,2207,14052
2008,3241,1044,2230,103369,101938,164,7.386,145,6.53,9323,1313,8010,1.288,9.146,6408,1686,4722,1.654,6.286,2915,2.86,12.572,62,62,662
2008,3251,1429,2502,162958,161710,156,6.233,158,6.312,12754,3001,9753,1.856,7.887,10240,2172,8068,1.343,6.332,2514,1.555,12.665,65,65,391
2008,3252,959,1292,98908,99464,64,4.977,52,4.044,7149,1882,5267,1.892,7.188,8395,1116,7279,1.122,8.44,-1246,-1.253,14.375,31,31,295
2008,3253,603,844,29677,29673,65,7.743,56,6.671,2597,814,1783,2.743,8.752,2604,820,1784,2.763,8.776,-7,-0.024,17.504,29,29,215
2008,3254,1409,1828,255096,248361,117,6.414,109,5.976,31770,2713,29057,1.092,12.792,17348,5822,11526,2.344,6.985,14422,5.807,13.97,56,56,995
2008,3255,1445,1831,62612,63801,88,4.757,126,6.811,5498,1213,4285,1.901,8.617,7915,2286,5629,3.583,12.406,-2417,-3.788,17.235,77,79,1034
2008,3256,1884,2093,105367,105672,136,6.484,145,6.913,10200,2356,7844,2.23,9.653,10742,3282,7460,3.106,10.165,-542,-0.513,19.305,95,95,1123
2008,3259,1956,2476,93916,95840,139,5.55,196,7.826,8178,2112,6066,2.204,8.533,11899,2619,9280,2.733,12.415,-3721,-3.883,17.066,128,131,1245
2008,3261,8911,11322,668511,683506,457,3.985,750,6.54,52504,9513,42991,1.392,7.682,82578,22863,59715,3.345,12.082,-30074,-4.4,15.363,499,510,11586
2008,3262,1588,2072,146154,147179,101,4.859,114,5.485,11393,2634,8759,1.79,7.741,13450,2812,10638,1.911,9.139,-2057,-1.398,15.482,77,77,722
2008,3271,1135,1330,45302,47382,100,7.421,135,10.019,3441,1282,2159,2.706,7.262,7541,1679,5862,3.544,15.915,-4100,-8.653,14.525,83,83,474
2008,3272,1564,1871,99389,98683,106,5.567,172,9.034,8973,2455,6518,2.488,9.093,7531,2039,5492,2.066,7.632,1442,1.461,15.263,120,120,584
2008,3273,4678,9593,209302,216872,530,5.498,622,6.453,21655,6073,15582,2.8,9.985,37050,7618,29432,3.513,17.084,-15395,-7.099,19.97,289,334,4295
2008,3274,204,342,16407,16675,21,6.122,23,6.706,1229,566,663,3.394,7.37,1785,164,1621,0.984,10.705,-556,-3.334,14.741,17,17,64
2008,3279,2812,3296,79863,81991,282,8.581,263,8.002,7256,2081,5175,2.538,8.85,11440,2898,8542,3.535,13.953,-4184,-5.103,17.7,196,196,1713
2008,3311,585,727,114720,112867,88,12.509,41,5.828,8057,1825,6232,1.617,7.139,4411,764,3647,0.677,3.908,3646,3.23,7.816,25,25,534
2008,3312,534,664,41752,41628,52,7.939,34,5.191,3370,948,2422,2.277,8.096,3149,830,2319,1.994,7.565,221,0.531,15.129,21,21,360
2008,3313,429,568,62405,62793,30,5.254,36,6.305,4662,2714,1948,4.322,7.424,5467,1533,3934,2.441,8.706,-805,-1.282,14.849,18,18,334
2008,3314,738,954,67716,67238,52,5.431,59,6.162,5398,893,4505,1.328,8.028,4523,1360,3163,2.023,6.727,875,1.301,13.454,39,39,287
2008,3315,1768,1994,151187,154744,82,4.063,130,6.442,8957,1471,7486,0.951,5.788,16160,3474,12686,2.245,10.443,-7203,-4.655,11.577,95,97,1916
2008,3321,2406,2656,126273,127124,86,3.209,134,5,9721,1757,7964,1.382,7.647,11405,2974,8431,2.339,8.972,-1684,-1.325,15.294,101,101,1809
2008,3322,1315,1429,49992,50423,79,5.505,91,6.341,3796,625,3171,1.24,7.528,4751,1346,3405,2.669,9.422,-955,-1.894,15.057,73,73,893
2008,3323,12360,13399,400547,403936,800,5.955,871,6.483,40859,9670,31189,2.394,10.115,47973,12244,35729,3.031,11.876,-7114,-1.761,20.23,665,667,7192
2008,3324,1180,1464,93465,92232,75,5.128,72,4.923,13287,6626,6661,7.184,14.406,11490,6563,4927,7.116,12.458,1797,1.948,24.915,54,54,5477
2008,3325,629,704,38189,39116,30,4.187,55,7.676,2278,721,1557,1.843,5.824,4071,1314,2757,3.359,10.408,-1793,-4.584,11.647,43,43,406
2008,3326,1303,1471,49076,50047,42,2.802,98,6.538,4042,862,3180,1.722,8.076,6058,1383,4675,2.763,12.105,-2016,-4.028,16.153,74,74,728
2008,3327,23171,23607,398040,397603,1280,5.396,1510,6.365,41733,8574,33159,2.156,10.496,40861,14515,26346,3.651,10.277,872,0.219,20.554,1172,1174,8543
2008,3328,5318,5847,135736,136686,281,4.766,379,6.428,13081,3261,9820,2.386,9.57,15015,4322,10693,3.162,10.985,-1934,-1.415,19.14,292,298,2801
2008,3329,5572,6117,274684,275478,427,6.985,419,6.854,25062,4962,20100,1.801,9.098,26578,8292,18286,3.01,9.648,-1516,-0.55,18.195,314,316,3793
2008,3331,2526,2845,205135,202515,202,7.148,164,5.803,20824,3173,17651,1.567,10.283,15583,3686,11897,1.82,7.695,5241,2.588,15.389,122,122,2469
2008,3332,3452,3634,127745,130851,169,4.598,252,6.856,11734,2780,8954,2.125,8.967,17655,3704,13951,2.831,13.492,-5921,-4.525,17.935,181,182,1929
2008,3333,1894,2030,86180,86782,131,6.412,157,7.685,7592,1660,5932,1.913,8.748,8867,2998,5869,3.455,10.218,-1275,-1.469,17.497,112,112,953
2008,3334,1465,1764,148236,149591,110,6.266,93,5.298,10927,1647,9280,1.101,7.305,13800,2718,11082,1.817,9.225,-2873,-1.921,14.609,55,55,797
2008,3335,7164,7403,164115,165539,282,3.766,452,6.036,13892,3834,10058,2.316,8.392,16686,5363,11323,3.24,10.08,-2794,-1.688,16.784,348,353,3180
2008,3336,797,974,110161,107963,63,6.512,50,5.168,10926,1435,9491,1.329,10.12,6484,1271,5213,1.177,6.006,4442,4.114,12.012,35,35,178
2008,3339,5368,5983,295127,294319,280,4.647,365,6.058,27406,4719,22687,1.603,9.312,25666,7955,17711,2.703,8.72,1740,0.591,17.441,255,256,3202
2008,3341,1088,1127,89823,92161,103,9.047,126,11.067,7180,2568,4612,2.786,7.791,11839,2900,8939,3.147,12.846,-4659,-5.055,15.581,88,88,1034
2008,3342,1377,1541,129489,128760,92,5.864,148,9.433,16064,1882,14182,1.462,12.476,13997,5046,8951,3.919,10.871,2067,1.605,21.741,106,107,1928
2008,3343,439,455,13965,15089,53,11.713,48,10.608,1334,158,1176,1.047,8.841,3460,572,2888,3.791,22.931,-2126,-14.09,17.682,41,41,408
2008,3344,3925,4418,349414,356717,252,5.665,312,7.014,26337,6388,19949,1.791,7.383,41140,10310,30830,2.89,11.533,-14803,-4.15,14.766,224,224,3695
2008,3345,4245,4922,399709,394752,330,6.683,362,7.331,44111,12636,31475,3.201,11.174,34347,12428,21919,3.148,8.701,9764,2.473,17.402,207,207,2335
2008,3346,662,687,25486,26342,71,10.208,88,12.653,2228,427,1801,1.621,8.458,4039,1253,2786,4.757,15.333,-1811,-6.875,16.916,62,63,604
2008,3351,1015,1110,55048,55979,74,6.604,95,8.478,3619,1058,2561,1.89,6.465,5485,1308,4177,2.337,9.798,-1866,-3.333,12.93,79,79,803
2008,3352,270,320,59750,63131,26,8.05,32,9.907,2093,428,1665,0.678,3.315,8993,1123,7870,1.779,14.245,-6900,-10.93,6.631,22,22,207
2008,3353,1923,2234,138578,137704,109,4.857,129,5.749,15935,5410,10525,3.929,11.572,13993,5284,8709,3.837,10.162,1942,1.41,20.323,87,87,1110
2008,3359,1812,2122,154137,153597,124,5.834,131,6.163,13466,1919,11547,1.249,8.767,12685,4950,7735,3.223,8.259,781,0.508,16.517,81,82,784
2008,3361,282,349,181570,188348,45,13.177,30,8.785,11324,925,10399,0.491,6.012,24711,274,24437,0.145,13.12,-13387,-7.108,12.025,22,22,180
2008,3362,1769,2040,134389,142941,113,5.454,177,8.542,10608,2929,7679,2.049,7.421,27421,4926,22495,3.446,19.183,-16813,-11.762,14.842,134,134,2003
2008,3363,4239,5213,549886,575596,293,5.525,473,8.919,38088,12204,25884,2.12,6.617,88768,28253,60515,4.908,15.422,-50680,-8.805,13.234,283,290,6848
2008,3364,1220,1604,414971,412077,100,6.256,89,5.568,28392,2599,25793,0.631,6.89,22755,3104,19651,0.753,5.522,5637,1.368,11.044,68,68,1907
2008,3365,156,219,30402,30010,13,5.963,11,5.046,2827,142,2685,0.473,9.42,2066,158,1908,0.526,6.884,761,2.536,13.769,9,9,110
2008,3366,1473,1602,156926,154950,137,8.465,170,10.504,18321,1589,16732,1.025,11.824,14210,4433,9777,2.861,9.171,4111,2.653,18.341,120,120,1496
2008,3369,868,896,47085,46907,116,12.932,118,13.155,6403,1017,5386,2.168,13.651,6212,2434,3778,5.189,13.243,191,0.407,26.487,100,100,770
2008,3371,13522,13831,298004,311792,1006,7.101,1677,11.838,24182,7239,16943,2.322,7.756,51518,16360,35158,5.247,16.523,-27336,-8.767,15.512,1338,1346,8789
2008,3372,3881,4081,139203,139830,235,5.71,304,7.387,15251,3421,11830,2.447,10.907,16673,5340,11333,3.819,11.924,-1422,-1.017,21.814,230,231,2944
2008,3379,836,967,41149,42352,51,5.204,77,7.857,3534,329,3205,0.777,8.344,5939,1582,4357,3.735,14.023,-2405,-5.679,16.689,65,65,988
2008,3391,10422,11250,307596,306196,680,6.007,819,7.235,28135,5461,22674,1.783,9.189,25157,6556,18601,2.141,8.216,2978,0.973,16.432,635,637,3868
2008,3399,16233,16695,334723,341040,1357,7.992,1925,11.338,34638,9383,25255,2.751,10.157,47472,15139,32333,4.439,13.92,-12834,-3.763,20.313,1571,1574,8900
2008,4231,17487,24790,390554,390297,1812,7.269,2085,8.365,46507,14695,31812,3.765,11.916,46101,13311,32790,3.41,11.812,406,0.104,23.624,1341,1376,6574
2008,4232,10935,12735,166999,168894,1141,8.889,1343,10.463,23079,8303,14776,4.916,13.665,27099,8380,18719,4.962,16.045,-4020,-2.38,27.33,934,954,4691
2008,4233,11269,18265,254735,265375,1548,8.468,1581,8.648,29852,11284,18568,4.252,11.249,51199,15785,35414,5.948,19.293,-21347,-8.044,22.498,899,944,6697
2008,4234,23044,32497,714491,730812,3494,10.715,3715,11.393,107060,30894,76166,4.227,14.649,141668,41921,99747,5.736,19.385,-34608,-4.736,29.299,1904,1968,11830
2008,4235,7719,10584,168488,168470,617,5.797,737,6.924,19933,4060,15873,2.41,11.832,20052,6063,13989,3.599,11.902,-119,-0.071,23.664,411,441,3287
2008,4236,19008,28552,517304,509912,2426,8.48,2537,8.868,83044,25803,57241,5.06,16.286,69722,22201,47521,4.354,13.673,13322,2.613,27.347,1453,1496,9720
2008,4237,10675,19196,240930,242197,1060,5.454,1536,7.904,30057,6896,23161,2.847,12.41,32916,12869,20047,5.313,13.591,-2859,-1.18,24.82,642,701,4005
2008,4238,40403,56721,736144,726460,4028,7.109,3910,6.901,102681,35241,67440,4.851,14.134,82658,28155,54503,3.876,11.378,20023,2.756,22.756,2385,2493,14368
2008,4239,27457,30369,343701,341811,3182,10.481,3163,10.418,54806,17154,37652,5.019,16.034,51024,17893,33131,5.235,14.928,3782,1.106,29.855,2397,2471,13248
2008,4241,8345,10904,170849,173034,672,6.093,923,8.368,17173,4184,12989,2.418,9.925,21431,8748,12683,5.056,12.385,-4258,-2.461,19.849,622,644,4124
2008,4242,5541,8072,273751,267176,1040,13.116,755,9.521,53640,26100,27540,9.769,20.077,40782,16310,24472,6.105,15.264,12858,4.813,30.528,473,476,3236
2008,4243,13649,14924,208038,211699,1625,10.848,1737,11.595,30292,8293,21999,3.917,14.309,37562,11463,26099,5.415,17.743,-7270,-3.434,28.618,1343,1363,6085
2008,4244,24508,30756,789288,783690,2631,8.529,2815,9.125,93215,21759,71456,2.776,11.894,82174,27051,55123,3.452,10.486,11041,1.409,20.971,2000,2018,14816
2008,4245,3494,6027,60152,60013,328,5.403,416,6.852,8031,1916,6115,3.193,13.382,7764,2599,5165,4.331,12.937,267,0.445,25.874,217,239,1504
2008,4246,8144,12163,148666,149745,811,6.574,1157,9.379,19433,4691,14742,3.133,12.977,21514,8740,12774,5.837,14.367,-2081,-1.39,25.955,552,567,2807
2008,4247,4905,7055,104688,104529,358,4.984,614,8.548,14339,3960,10379,3.788,13.718,14089,4539,9550,4.342,13.479,250,0.239,26.957,290,300,1768
2008,4248,3058,3906,177800,177494,360,9.278,308,7.938,16825,2634,14191,1.484,9.479,16280,6495,9785,3.659,9.172,545,0.307,18.344,201,208,2976
2008,4249,21164,27139,359064,362819,2392,8.696,3125,11.361,49215,13557,35658,3.737,13.565,56527,18972,37555,5.229,15.58,-7312,-2.015,27.129,2068,2238,9348
2008,4251,41922,44077,301433,300186,5189,11.8,4984,11.334,47801,18195,29606,6.061,15.924,44979,21201,23778,7.063,14.984,2822,0.94,29.967,3687,3699,13305
2008,4411,41542,46418,1244804,1253872,3966,8.465,4837,10.324,135509,52619,82890,4.197,10.807,153396,55294,98102,4.41,12.234,-17887,-1.427,21.614,3911,3947,44013
2008,4412,13741,15554,164449,167761,1352,8.652,1496,9.574,20136,7474,12662,4.455,12.003,26706,7641,19065,4.555,15.919,-6570,-3.916,24.006,1148,1180,5476
2008,4413,29079,55251,475978,479690,2853,5.135,3473,6.251,52179,14335,37844,2.988,10.878,58842,15359,43483,3.202,12.267,-6663,-1.389,21.755,2324,2412,8800
2008,4421,17202,26081,251627,260368,2364,8.875,3474,13.042,35207,14383,20824,5.524,13.522,52031,21630,30401,8.307,19.984,-16824,-6.462,27.044,2296,2682,15403
2008,4422,23621,32465,280093,299021,2260,6.8,3798,11.428,34772,9653,25119,3.228,11.629,70884,19800,51084,6.622,23.705,-36112,-12.077,23.257,2417,2657,10707
2008,4431,27041,49535,489993,494560,4507,9.025,5314,10.641,68739,23670,45069,4.786,13.899,78589,27157,51432,5.491,15.891,-9850,-1.992,27.798,3532,3681,14450
2008,4441,43249,66612,1168821,1182516,3703,5.524,4552,6.79,109564,33871,75693,2.864,9.265,137415,26742,110673,2.261,11.621,-27851,-2.355,18.531,2983,3140,14437
2008,4442,14743,18133,161757,163040,1132,6.188,1452,7.937,22375,5976,16399,3.665,13.724,24670,6587,18083,4.04,15.131,-2295,-1.408,27.447,1008,1046,4709
2008,4451,55728,81608,2564956,2553547,8366,10.244,8482,10.386,250963,80849,170114,3.166,9.828,227713,76057,151656,2.978,8.918,23250,0.91,17.835,6271,6381,35885
2008,4452,17460,21377,148410,143863,3389,16.118,2688,12.784,36350,15256,21094,10.605,25.267,27564,11864,15700,8.247,19.16,8786,6.107,38.32,2074,2088,8929
2008,4453,24806,28340,144433,142445,2789,9.897,2472,8.772,25788,8588,17200,6.029,18.104,21693,8306,13387,5.831,15.229,4095,2.875,30.458,1914,1937,6603
2008,4461,39602,84982,1022754,1024504,6912,8.197,5597,6.637,139508,58141,81367,5.675,13.617,144596,37265,107331,3.637,14.114,-5088,-0.497,27.234,3207,3362,16313
2008,4471,61268,108246,892431,896004,8254,7.541,10675,9.753,145634,49429,96205,5.517,16.254,152637,57226,95411,6.387,17.035,-7003,-0.782,32.507,6497,6964,33920
2008,4481,35200,93366,1286842,1278839,9684,10.457,8168,8.82,232087,76001,156086,5.943,18.148,217076,49286,167790,3.854,16.974,15011,1.174,33.949,4462,4689,17369
2008,4482,6134,27148,208072,206281,1893,7.002,1667,6.166,36557,11245,25312,5.451,17.722,33333,8556,24777,4.148,16.159,3224,1.563,32.318,604,610,1804
2008,4483,16955,26132,152347,156536,1730,6.531,2447,9.237,21775,7160,14615,4.574,13.911,30548,10189,20359,6.509,19.515,-8773,-5.604,27.821,1481,1558,4875
2008,4511,26801,37303,429324,433686,3833,10.196,4412,11.736,73344,35031,38313,8.078,16.912,82328,25320,57008,5.838,18.983,-8984,-2.072,33.824,2955,3165,12973
2008,4512,5112,10477,145092,145754,790,7.437,1081,10.177,18738,6645,12093,4.559,12.856,19588,4831,14757,3.315,13.439,-850,-0.583,25.712,668,774,2832
2008,4522,75,5369,706642,711998,172,3.233,74,1.391,44617,15788,28829,2.217,6.266,55370,8945,46425,1.256,7.777,-10753,-1.51,12.533,(D),(D),(D)
2008,4523,7428,38702,2266695,2215559,1896,4.873,2314,5.947,199945,77904,122041,3.516,9.025,100653,15158,85495,0.684,4.543,99292,4.482,9.086,1359,1415,5517
2008,4531,16483,17191,89070,91036,1412,8.014,2267,12.867,15182,5967,9215,6.555,16.677,19116,7224,11892,7.935,20.998,-3934,-4.321,33.354,1848,1858,5685
2008,4532,24269,35465,303661,305148,3373,9.369,4443,12.342,43701,14843,28858,4.864,14.321,46587,17351,29236,5.686,15.267,-2886,-0.946,28.642,3270,3368,11719
2008,4533,11588,16181,135713,134224,1478,9.055,1762,10.795,23817,8542,15275,6.364,17.744,20787,7377,13410,5.496,15.487,3030,2.257,30.974,1300,1315,4330
2008,4539,29959,38105,248755,252789,4027,10.473,4718,12.27,39366,17058,22308,6.748,15.573,47431,16159,31272,6.392,18.763,-8065,-3.19,31.145,3473,3571,11364
2008,4541,18208,19210,325655,328132,2897,15.233,2512,13.209,55204,15569,39635,4.745,16.824,61262,24722,36540,7.534,18.67,-6058,-1.846,33.647,1878,1888,8101
2008,4542,3971,4454,47299,48197,406,8.935,586,12.896,5383,1670,3713,3.465,11.169,7195,3358,3837,6.967,14.928,-1812,-3.76,22.338,422,428,1414
2008,4543,22706,28758,213659,216126,2472,8.519,2990,10.304,29909,8807,21102,4.075,13.839,34844,12072,22772,5.586,16.122,-4935,-2.283,27.677,1991,2011,7545
2008,4811,485,2936,447202,443990,183,6.14,272,9.126,29131,2169,26962,0.489,6.561,22746,4632,18114,1.043,5.123,6385,1.438,10.246,72,96,3193
2008,4812,2021,2218,41442,41355,266,11.891,304,13.59,5656,1740,3916,4.208,13.677,5376,1607,3769,3.886,13,280,0.677,26,206,209,687
2008,4831,714,1014,48220,50531,91,8.939,99,9.725,4698,888,3810,1.757,9.297,9221,2971,6250,5.88,18.248,-4523,-8.951,18.595,56,56,729
2008,4832,476,525,19168,18849,65,12.322,70,13.27,2247,556,1691,2.95,11.921,1630,828,802,4.393,8.648,617,3.273,17.296,44,44,631
2008,4841,47698,56642,941559,952868,8741,15.333,9470,16.612,121844,35251,86593,3.699,12.787,143558,46583,96975,4.889,15.066,-21714,-2.279,25.574,7296,7313,31248
2008,4842,39761,43931,471826,479155,5155,11.473,7158,15.931,70884,23041,47843,4.809,14.794,85691,30000,55691,6.261,17.884,-14807,-3.09,29.587,5138,5153,20281
2008,4851,607,895,52504,53873,73,7.849,143,15.376,5777,1865,3912,3.462,10.723,8959,6312,2647,11.717,16.63,-3182,-5.907,21.447,56,56,396
2008,4852,202,469,15511,16555,38,7.708,86,17.444,2086,148,1938,0.894,12.601,4263,1547,2716,9.345,25.751,-2177,-13.151,25.202,16,16,60
2008,4853,6160,6259,70228,70755,1064,17.27,868,14.089,11180,4428,6752,6.258,15.801,12210,3998,8212,5.65,17.257,-1030,-1.456,31.602,710,710,3143
2008,4854,2815,4302,217770,211935,352,8.115,423,9.752,34927,8850,26077,4.176,16.48,23256,13081,10175,6.172,10.973,11671,5.507,21.946,192,195,2754
2008,4855,1122,1237,30286,30580,123,9.96,119,9.636,3610,874,2736,2.858,11.805,4161,1207,2954,3.947,13.607,-551,-1.802,23.611,92,93,814
2008,4859,2774,3020,61863,59287,505,17.009,403,13.574,12941,4664,8277,7.867,21.828,7829,4041,3788,6.816,13.205,5112,8.623,26.411,297,297,2074
2008,4861,53,376,6278,6326,32,8.333,48,12.5,968,617,351,9.754,15.303,1085,286,799,4.521,17.153,-117,-1.85,30.606,(D),(D),(D)
2008,4862,124,1778,28559,27117,340,20.118,164,9.704,6818,3019,3799,11.133,25.143,3728,1731,1997,6.384,13.748,3090,11.395,27.496,9,9,188
2008,4869,62,743,8011,7240,152,21.997,48,6.946,2309,1525,784,21.065,31.894,700,304,396,4.199,9.669,1609,22.225,19.338,(D),(D),(D)
2008,4871,476,524,9404,9184,76,14.743,59,11.445,1644,527,1117,5.738,17.901,1251,354,897,3.855,13.622,393,4.279,27.243,40,40,168
2008,4872,1171,1214,11282,11093,186,15.233,200,16.38,2133,506,1627,4.561,19.228,1743,461,1282,4.156,15.713,390,3.516,31.425,125,125,280
2008,4879,139,148,1917,1903,26,18.375,13,9.187,490,295,195,15.506,25.756,469,22,447,1.156,24.652,21,1.104,49.304,9,9,16
2008,4881,3696,5268,177140,175318,612,11.749,494,9.484,25603,7733,17870,4.411,14.604,21640,5366,16274,3.061,12.343,3963,2.26,24.687,317,317,2262
2008,4882,438,926,26148,26279,112,12.281,84,9.211,2956,1242,1714,4.726,11.249,3113,1693,1420,6.442,11.846,-157,-0.597,22.497,34,36,359
2008,4883,1661,2226,93535,94113,210,9.453,201,9.048,11617,2395,9222,2.545,12.344,12461,2737,9724,2.908,13.241,-844,-0.897,24.687,126,127,1316
2008,4884,8435,9057,77321,76027,1314,14.719,1055,11.817,15709,7385,8324,9.714,20.663,12987,4886,8101,6.427,17.082,2722,3.58,34.164,759,760,2934
2008,4885,13950,20342,248480,249659,1897,9.304,1991,9.765,37684,10504,27180,4.207,15.094,39978,15087,24891,6.043,16.013,-2294,-0.919,30.188,1049,1063,5498
2008,4889,1231,1343,27902,27380,224,16.95,181,13.697,4288,1155,3133,4.218,15.661,3125,1319,1806,4.817,11.414,1163,4.248,22.827,138,140,841
2008,4921,3171,8745,552772,539155,1417,16.741,855,10.102,60017,15969,44048,2.962,11.132,30898,11767,19131,2.182,5.731,29119,5.401,11.462,353,364,2907
2008,4922,3702,3972,36335,36261,762,19.657,571,14.73,7546,3396,4150,9.366,20.811,7373,2403,4970,6.627,20.333,173,0.477,40.667,480,489,2152
2008,4931,6859,14049,708190,719003,1266,9.027,1216,8.671,96602,29016,67586,4.036,13.436,118658,26383,92275,3.669,16.503,-22056,-3.068,26.871,376,404,4487
2008,5111,14496,20675,662926,668130,1888,9.074,2150,10.334,69969,24436,45533,3.657,10.472,80970,19163,61807,2.868,12.119,-11001,-1.647,20.945,1264,1282,8362
2008,5112,5123,7410,371169,364786,841,11.291,918,12.325,55661,16567,39094,4.542,15.259,43104,21481,21623,5.889,11.816,12557,3.442,23.632,421,448,5438
2008,5121,12797,16163,323976,320634,2432,15.147,2218,13.814,57654,21438,36216,6.686,17.981,52040,24567,27473,7.662,16.23,5614,1.751,32.461,1363,1372,16727
2008,5122,2885,3144,25414,25706,473,15.068,463,14.75,3336,1262,2074,4.909,12.978,3869,1579,2290,6.143,15.051,-533,-2.073,25.955,348,348,1070
2008,5151,4228,8856,243625,244969,984,10.955,1237,13.771,28653,13504,15149,5.513,11.697,31115,12340,18775,5.037,12.702,-2462,-1.005,23.393,278,289,1975
2008,5152,403,624,41617,42370,56,8.596,111,17.038,5203,1925,3278,4.543,12.28,6606,2823,3783,6.663,15.591,-1403,-3.311,24.56,36,36,432
2008,5173,4377,44626,1122006,1124630,6053,13.6,5813,13.061,188751,81578,107173,7.254,16.783,197862,46200,151662,4.108,17.594,-9111,-0.81,33.567,524,536,4486
2008,5174,486,603,10030,10072,142,23.394,150,24.712,2630,1604,1026,15.926,26.113,2826,796,2030,7.903,28.059,-196,-1.946,52.227,104,104,312
2008,5179,4535,5021,59918,62145,965,19.308,919,18.387,12706,5542,7164,8.918,20.446,17096,7550,9546,12.149,27.51,-4390,-7.064,40.892,683,686,4122
2008,5182,8092,14551,406019,408705,1280,8.797,1280,8.797,75514,18723,56791,4.581,18.476,79801,27747,52054,6.789,19.525,-4287,-1.049,36.953,693,704,7949
2008,5191,5496,6887,139998,131825,959,14.124,765,11.267,29034,11921,17113,9.043,22.025,12154,4417,7737,3.351,9.22,16880,12.805,18.44,508,513,2191
2008,5211,13,48,19006,19261,0,0,0,0,319,0,319,0,1.656,839,0,839,0,4.356,-520,-2.7,3.312,0,0,0
2008,5221,14828,128072,2147737,2151074,9640,7.644,5732,4.545,262056,81111,180945,3.771,12.183,268227,66365,201862,3.085,12.469,-6171,-0.287,24.365,493,606,6494
2008,5222,17047,47683,634201,700726,5197,10.459,9212,18.539,109936,42908,67028,6.123,15.689,243395,108040,135355,15.418,34.735,-133459,-19.046,31.378,2980,3869,36988
2008,5223,21281,40035,283036,308717,4256,9.929,9918,23.137,49410,17473,31937,5.66,16.005,99747,45818,53929,14.841,32.31,-50337,-16.305,32.01,7103,7389,35818
2008,5231,12236,40546,529067,517451,5777,14.598,3834,9.688,86349,44416,41933,8.584,16.687,62525,24978,37547,4.827,12.083,23824,4.604,24.167,1047,1067,4799
2008,5232,37,65,5405,6653,17,28.333,7,11.667,760,154,606,2.315,11.424,3290,1323,1967,19.887,49.455,-2530,-38.031,22.849,4,4,91
2008,5239,37185,42133,412391,407982,6404,15.389,5367,12.897,76466,28445,48021,6.972,18.742,68106,30856,37250,7.563,16.693,8360,2.049,33.387,3777,3795,15125
2008,5241,5950,32979,1493302,1471693,5632,17.166,5293,16.133,237540,115374,122166,7.84,16.141,192216,69259,122957,4.706,13.061,45324,3.08,26.122,611,648,4530
2008,5242,120991,135924,901255,909269,11835,8.674,12887,9.444,142464,54935,87529,6.042,15.668,158498,69467,89031,7.64,17.431,-16034,-1.763,31.336,8322,8429,26717
2008,5259,671,692,7825,7605,192,28.635,149,22.222,2588,1167,1421,15.346,34.032,2195,1824,371,23.986,28.864,393,5.168,57.729,124,124,1643
2008,5311,83860,105473,543082,546257,11713,11.049,12779,12.055,101516,47352,54164,8.668,18.584,107493,50273,57220,9.203,19.678,-5977,-1.094,37.168,8240,8360,30319
2008,5312,69748,80313,335764,348142,11446,13.578,19416,23.033,69791,28294,41497,8.127,20.047,94981,44315,50666,12.729,27.282,-25190,-7.236,40.093,13579,13661,29644
2008,5313,61614,72551,636593,635621,9823,13.494,10312,14.166,109204,40571,68633,6.383,17.181,107333,41652,65681,6.553,16.886,1871,0.294,33.773,7065,7107,25954
2008,5321,4072,13047,188897,186458,2133,16.852,1353,10.69,31626,18277,13349,9.802,16.962,26570,9099,17471,4.88,14.25,5056,2.712,28.5,524,552,1925
2008,5322,10149,30821,243289,248105,2358,7.464,3902,12.351,37721,9394,28327,3.786,15.204,47276,21288,25988,8.58,19.055,-9555,-3.851,30.407,1447,1511,6821
2008,5323,2797,3524,23103,23769,192,5.329,350,9.714,2944,732,2212,3.08,12.386,4224,1468,2756,6.176,17.771,-1280,-5.385,24.772,227,257,1090
2008,5324,7417,13166,169206,167204,1190,9.079,1073,8.186,28309,8602,19707,5.145,16.931,24666,8648,16018,5.172,14.752,3643,2.179,29.504,657,662,3285
2008,5331,1959,2062,31541,31143,274,13.382,245,11.966,6183,1677,4506,5.385,19.854,5456,1434,4022,4.605,17.519,727,2.334,35.038,182,185,1237
2008,5411,162544,171802,1184640,1189071,13477,7.802,15364,8.894,135123,42251,92872,3.553,11.364,144281,45132,99149,3.796,12.134,-9158,-0.77,22.727,11215,11313,32007
2008,5412,95757,110596,1292055,1278662,10099,9.153,9579,8.682,195157,55414,139743,4.334,15.263,169221,60154,109067,4.704,13.234,25936,2.028,26.468,6429,6469,44394
2008,5413,88370,103362,1456409,1436785,10416,10.085,10247,9.922,226563,64289,162274,4.475,15.769,186416,56244,130172,3.915,12.975,40147,2.794,25.949,6863,6930,26860
2008,5414,28049,28315,132683,130282,4194,14.874,3958,14.037,27032,10205,16827,7.833,20.749,22342,9588,12754,7.359,17.149,4690,3.6,34.298,3051,3053,7463
2008,5415,87023,99463,1335316,1324556,17828,17.952,17525,17.646,311901,127712,184189,9.642,23.548,286907,139933,146974,10.565,21.661,24994,1.887,43.321,10061,10130,38098
2008,5416,102684,108915,845353,829180,20424,18.966,17974,16.691,190569,74964,115605,9.041,22.983,157594,63433,94161,7.65,19.006,32975,3.977,38.012,13088,13140,41422
2008,5417,11482,14186,579896,584836,1999,14.273,1638,11.695,79227,22959,56268,3.926,13.547,87648,23023,64625,3.937,14.987,-8421,-1.44,27.094,984,1007,8565
2008,5418,32274,35917,469561,461812,4218,11.78,3995,11.158,79853,22772,57081,4.931,17.291,63733,21644,42089,4.687,13.801,16120,3.491,27.601,2960,2970,13290
2008,5419,54287,63582,620697,613482,6324,9.928,6559,10.297,100586,28863,71723,4.705,16.396,85564,30070,55494,4.902,13.947,15022,2.449,27.895,4208,4283,16694
2008,5511,26405,50095,2922359,2974048,4461,8.878,4771,9.495,472770,143699,329071,4.832,15.897,576847,148736,428111,5.001,19.396,-104077,-3.5,31.793,1021,1065,16157
2008,5611,23232,25417,409324,403322,3848,15.328,3224,12.842,79723,30751,48972,7.624,19.767,67581,27900,39681,6.918,16.756,12142,3.01,33.512,2508,2516,20286
2008,5612,1751,5800,274514,280637,785,13.606,724,12.549,36028,13269,22759,4.728,12.838,47374,15938,31436,5.679,16.881,-11346,-4.043,25.676,114,136,1648
2008,5613,27085,48537,4724475,4782655,7814,16.286,6698,13.96,994258,293041,701217,6.127,20.789,1124814,330388,794426,6.908,23.519,-130556,-2.73,41.578,3202,3316,153546
2008,5614,26166,32871,820806,803747,3848,11.661,4101,12.428,175498,73484,102014,9.143,21.835,140585,44879,95706,5.584,17.491,34913,4.344,34.982,2757,2849,22815
2008,5615,15035,20194,255922,256963,1875,9.187,2305,11.294,34349,8748,25601,3.404,13.367,36643,11340,25303,4.413,14.26,-2294,-0.893,26.735,1298,1352,5593
2008,5616,17573,23223,820917,797118,2791,12.118,2407,10.451,174452,56842,117610,7.131,21.885,126114,45757,80357,5.74,15.821,48338,6.064,31.643,1640,1698,20553
2008,5617,136752,143422,1688469,1681112,21364,14.915,21005,14.664,298777,114911,183866,6.835,17.773,287125,88380,198745,5.257,17.079,11652,0.693,34.159,14859,14874,59668
2008,5619,16408,18340,301895,293328,2107,11.574,1837,10.091,61771,15738,46033,5.365,21.059,44432,18015,26417,6.142,15.148,17339,5.911,30.295,1345,1355,12543
2008,5621,7367,9458,196058,195056,895,9.494,834,8.846,24179,7098,17081,3.639,12.396,22235,8396,13839,4.304,11.399,1944,0.997,22.799,580,589,4185
2008,5622,1346,2464,49064,50215,175,7.065,201,8.115,5638,1656,3982,3.298,11.228,7920,3428,4492,6.827,15.772,-2282,-4.545,22.456,109,111,752
2008,5629,7399,8349,122747,122337,889,10.743,741,8.955,21354,6642,14712,5.429,17.455,20655,4928,15727,4.028,16.884,699,0.571,33.768,509,510,3210
2008,6111,17828,20140,840408,832669,963,4.78,973,4.83,68557,13906,54651,1.67,8.233,53179,15451,37728,1.856,6.387,15378,1.847,12.773,696,704,11138
2008,6112,441,834,82448,80880,40,4.802,38,4.562,8283,630,7653,0.779,10.241,5128,1721,3407,2.128,6.34,3155,3.901,12.681,17,18,733
2008,6113,2338,4033,1613169,1592575,302,7.666,115,2.919,93299,5532,87767,0.347,5.858,51870,5137,46733,0.323,3.257,41429,2.601,6.514,56,56,3575
2008,6114,6376,6960,71860,71875,800,11.349,978,13.874,11648,3415,8233,4.751,16.206,11676,4711,6965,6.554,16.245,-28,-0.039,32.412,676,729,3763
2008,6115,6109,7563,121413,119162,759,10.048,741,9.809,20543,5155,15388,4.326,17.24,16196,5344,10852,4.485,13.592,4347,3.648,27.183,529,536,3364
2008,6116,31623,34012,314623,309752,4887,14.62,3716,11.117,65106,23003,42103,7.426,21.019,55666,18810,36856,6.073,17.971,9440,3.048,35.942,2744,2762,12572
2008,6117,5077,5856,82178,78350,892,15.588,625,10.922,18226,6660,11566,8.5,23.262,10300,3668,6632,4.682,13.146,7926,10.116,26.292,456,456,2175
2008,6211,175693,203555,2153037,2128249,15394,7.572,14886,7.322,305362,94071,211291,4.42,14.348,255570,85257,170313,4.006,12.008,49792,2.34,24.017,10420,10640,51442
2008,6212,115422,121660,832866,829096,6763,5.591,5378,4.446,101934,33379,68555,4.026,12.295,94495,25585,68910,3.086,11.397,7439,0.897,22.795,4208,4262,20248
2008,6213,103083,114635,641908,632623,11473,10.079,9871,8.671,119240,42388,76852,6.7,18.849,101042,34276,66766,5.418,15.972,18198,2.877,31.944,6151,6231,19170
2008,6214,14011,29735,684058,669070,2865,9.827,1703,5.841,106782,34696,72086,5.186,15.96,76849,23950,52899,3.58,11.486,29933,4.474,22.972,743,776,8090
2008,6215,7220,12626,243878,241545,1330,10.67,1008,8.087,33217,9484,23733,3.926,13.752,29001,8661,20340,3.586,12.006,4216,1.745,24.013,601,634,4673
2008,6216,15108,22105,1038740,1009065,3367,15.725,1980,9.247,182137,47009,135128,4.659,18.05,122864,39251,83613,3.89,12.176,59273,5.874,24.352,1126,1153,16503
2008,6219,5737,9109,281044,280307,892,9.867,755,8.351,39473,10224,29249,3.647,14.082,38244,10491,27753,3.743,13.644,1229,0.438,27.287,390,408,4197
2008,6221,3038,5255,5126037,5086412,206,3.978,53,1.023,230808,29787,201021,0.586,4.538,155756,18978,136778,0.373,3.062,75052,1.476,6.124,22,22,8176
2008,6222,449,602,209220,209033,42,7.161,11,1.876,9823,2806,7017,1.342,4.699,9398,5911,3487,2.828,4.496,425,0.203,8.992,5,5,3472
2008,6223,410,855,234574,232470,81,9.695,42,5.027,18117,4322,13795,1.859,7.793,14217,6320,7897,2.719,6.116,3900,1.678,12.231,9,9,1176
2008,6231,7832,15541,1574566,1575888,1163,7.524,997,6.45,139420,54977,84443,3.489,8.847,141999,64210,77789,4.075,9.011,-2579,-0.164,17.694,515,579,38542
2008,6232,8629,32710,608364,597772,2508,7.727,2000,6.162,93915,23560,70355,3.941,15.711,72526,19201,53325,3.212,12.133,21389,3.578,24.265,374,400,4195
2008,6233,13927,19827,776964,761362,1988,10.057,1869,9.455,109168,32333,76835,4.247,14.339,78881,41949,36932,5.51,10.361,30287,3.978,20.721,1230,1261,21737
2008,6239,3404,5814,152210,151347,386,6.594,466,7.96,19699,4311,15388,2.848,13.016,17879,5704,12175,3.769,11.813,1820,1.203,23.627,213,223,2479
2008,6241,39277,54994,1208850,1182702,5273,9.706,3945,7.261,182091,41604,140487,3.518,15.396,129830,34497,95333,2.917,10.977,52261,4.419,21.955,2278,2319,16052
2008,6242,10056,13608,168913,167301,658,4.835,658,4.835,22848,4514,18334,2.698,13.657,19456,4108,15348,2.455,11.629,3392,2.027,23.259,302,322,1731
2008,6243,4238,7266,324015,321097,497,6.801,580,7.937,50047,8990,41057,2.8,15.586,44428,12010,32418,3.74,13.836,5619,1.75,27.673,202,233,2392
2008,6244,54605,69269,882309,872262,7807,11.329,7091,10.29,144670,59109,85561,6.777,16.586,124409,47493,76916,5.445,14.263,20261,2.323,28.526,4740,4821,29121
2008,7111,7363,7497,133905,132062,867,11.567,864,11.527,23127,5893,17234,4.462,17.512,19465,4763,14702,3.607,14.739,3662,2.773,29.479,595,595,3548
2008,7112,3424,3605,125543,123977,523,14.492,531,14.713,20266,4508,15758,3.636,16.347,17214,5231,11983,4.219,13.885,3052,2.462,27.77,416,417,3573
2008,7113,5260,5574,127965,124217,690,12.438,637,11.483,25236,5124,20112,4.125,20.316,17738,4700,13038,3.784,14.28,7498,6.036,28.56,445,445,2621
2008,7114,2756,2834,19037,18946,417,14.699,423,14.91,3402,1464,1938,7.727,17.956,3214,1158,2056,6.112,16.964,188,0.992,33.928,295,296,894
2008,7115,13380,13411,43003,42854,2512,18.657,2618,19.444,12286,5565,6721,12.986,28.669,11970,5722,6248,13.352,27.932,316,0.737,55.864,1613,1613,3535
2008,7121,6264,6755,133014,130872,395,5.88,320,4.764,12708,1672,11036,1.278,9.71,8516,1048,7468,0.801,6.507,4192,3.203,13.014,180,180,554
2008,7131,2125,2583,140205,136248,418,16.233,402,15.612,20179,6617,13562,4.857,14.81,12354,6203,6151,4.553,9.067,7825,5.743,18.135,294,296,3714
2008,7132,1805,2438,178913,174853,293,12.257,198,8.283,21090,8845,12245,5.059,12.062,12889,3281,9608,1.876,7.371,8201,4.69,14.743,136,137,2360
2008,7139,50053,56326,1163995,1162478,6574,11.618,7090,12.53,164041,54597,109444,4.697,14.111,159684,61291,98393,5.272,13.737,4357,0.375,27.473,5455,5510,39607
2008,7211,38070,48143,1916974,1904665,5372,11.21,4930,10.288,249141,124083,125058,6.515,13.081,225245,95914,129331,5.036,11.826,23896,1.255,23.652,3429,3494,60759
2008,7212,5272,5791,38761,38920,510,8.751,584,10.021,6672,1700,4972,4.368,17.143,6965,1917,5048,4.925,17.896,-293,-0.753,34.286,357,360,1138
2008,7213,1991,2076,11025,11206,123,5.894,145,6.948,1410,422,988,3.766,12.583,1771,442,1329,3.944,15.804,-361,-3.221,25.165,104,104,268
2008,7223,12159,34713,657917,631466,6482,19.403,3872,11.59,170340,62450,107890,9.89,26.975,120284,32456,87828,5.14,19.048,50056,7.927,38.097,1579,1589,9919
2008,7224,40689,41341,357156,359271,4522,10.804,5549,13.258,72937,36874,36063,10.264,20.301,77168,31574,45594,8.788,21.479,-4231,-1.178,40.603,4523,4535,26716
2008,7225,321328,444329,8908575,8817051,55055,12.465,49776,11.269,1573993,746986,827007,8.472,17.852,1396505,523960,872545,5.943,15.839,177488,2.013,31.677,38334,39195,361798
2008,8111,137340,150076,866154,874102,12917,8.531,15582,10.291,135055,49778,85277,5.695,15.451,150955,55338,95617,6.331,17.27,-15900,-1.819,30.901,11657,11939,42203
2008,8112,10181,11484,122612,121669,1050,9.021,1362,11.701,20545,5165,15380,4.245,16.886,18648,7134,11514,5.863,15.327,1897,1.559,30.654,996,1003,3399
2008,8113,19783,21308,202419,199874,1847,8.628,2045,9.553,33033,8370,24663,4.188,16.527,28174,10215,17959,5.111,14.096,4859,2.431,28.192,1470,1479,5642
2008,8114,18060,19025,82803,83168,2051,10.678,2415,12.574,12553,4542,8011,5.461,15.094,13266,5483,7783,6.593,15.951,-713,-0.857,30.187,1782,1787,3933
2008,8121,85106,101282,632568,621888,13947,13.862,12610,12.533,141178,64843,76335,10.427,22.702,118700,50864,67836,8.179,19.087,22478,3.614,38.174,9389,9590,35281
2008,8122,14657,19859,135043,135870,835,4.158,1277,6.36,15061,3800,11261,2.797,11.085,17005,5237,11768,3.854,12.516,-1944,-1.431,22.17,535,623,2221
2008,8123,30298,36133,329021,337757,3775,10.366,4346,11.933,47310,19638,27672,5.814,14.007,63540,23268,40272,6.889,18.812,-16230,-4.805,28.014,3182,3318,14361
2008,8129,21566,32776,266077,253262,5721,17.889,4131,12.917,78249,27610,50639,10.902,30.897,52872,22022,30850,8.695,20.876,25377,10.02,41.753,2421,2452,10997
2008,8131,171012,171313,1693809,1688283,8507,4.981,7466,4.371,165614,24604,141010,1.457,9.81,154355,23947,130408,1.418,9.143,11259,0.667,18.285,4724,4724,16118
2008,8132,14058,16020,190383,187173,1271,8.012,960,6.051,18844,3818,15026,2.04,10.068,12424,3490,8934,1.865,6.638,6420,3.43,13.275,638,651,2128
2008,8133,12410,14723,142997,137790,1262,8.652,989,6.78,23680,4325,19355,3.139,17.186,13175,3612,9563,2.621,9.562,10505,7.624,19.123,574,577,1800
2008,8134,24753,26617,260513,259362,1135,4.221,1676,6.233,33785,5193,28592,2.002,13.026,31334,7633,23701,2.943,12.081,2451,0.945,24.162,1127,1144,5315
2008,8139,56024,58142,519844,515160,2843,4.887,2898,4.982,63058,10763,52295,2.089,12.24,53456,11684,41772,2.268,10.377,9602,1.864,20.753,1917,1927,8706
2009,1131,307,321,2131,2154,37,11.437,42,12.983,360,238,122,11.049,16.713,439,187,252,8.682,20.381,-79,-3.668,33.426,28,28,55
2009,1132,117,137,1558,1707,15,10.453,28,19.512,271,56,215,3.281,15.876,585,242,343,14.177,34.271,-314,-18.395,31.752,15,15,110
2009,1133,7481,7601,49239,52983,589,7.424,1255,15.818,5746,1747,3999,3.297,10.845,13153,3817,9336,7.204,24.825,-7407,-13.98,21.69,852,852,2753
2009,1141,1134,1144,5420,5445,203,17.722,206,17.983,1129,482,647,8.853,20.737,1175,530,645,9.735,21.581,-46,-0.845,41.473,124,124,385
2009,1142,253,253,1772,1806,27,10.506,35,13.619,171,67,104,3.711,9.471,239,105,134,5.816,13.237,-68,-3.766,18.942,25,25,44
2009,1151,3351,3674,59134,61014,340,9.183,397,10.722,7460,1896,5564,3.108,12.227,11095,3671,7424,6.017,18.185,-3635,-5.958,24.454,253,253,2505
2009,1152,3609,3705,19522,19725,436,11.706,475,12.753,2953,1336,1617,6.773,14.971,3355,1339,2016,6.788,17.009,-402,-2.038,29.942,380,380,1082
2009,1153,1226,1324,10621,11036,143,10.628,186,13.824,1926,580,1346,5.256,17.453,2731,594,2137,5.383,24.747,-805,-7.295,34.906,117,117,365
2009,2111,5784,7112,106995,105843,747,10.578,647,9.162,17687,6317,11370,5.968,16.711,15471,6813,8658,6.437,14.617,2216,2.094,29.234,368,373,2410
2009,2121,617,1037,83680,81433,148,14.675,91,9.023,14508,4903,9605,6.021,17.816,9826,2715,7111,3.334,12.066,4682,5.75,24.133,50,50,835
2009,2122,203,264,34530,34059,27,10.019,38,14.1,4070,353,3717,1.036,11.95,3028,553,2475,1.624,8.89,1042,3.059,17.781,25,25,372
2009,2123,2976,5026,81953,86104,305,5.971,469,9.182,8677,3114,5563,3.617,10.077,16978,3185,13793,3.699,19.718,-8301,-9.641,20.155,256,261,1964
2009,2131,9250,11361,295921,308813,1367,12.136,1173,10.414,43705,13676,30029,4.429,14.153,69887,18016,51871,5.834,22.631,-26182,-8.478,28.305,744,762,8295
2009,2211,1561,9927,517022,512020,798,8.191,428,4.393,51893,17271,34622,3.373,10.135,42278,11085,31193,2.165,8.257,9615,1.878,16.514,66,107,3217
2009,2212,421,2301,83566,84172,118,5.073,168,7.223,7449,3023,4426,3.591,8.85,8744,3064,5680,3.64,10.388,-1295,-1.539,17.7,27,69,1430
2009,2213,3434,4618,43981,43370,382,8.368,276,6.046,7041,2986,4055,6.885,16.235,5858,1338,4520,3.085,13.507,1183,2.728,27.014,143,146,590
2009,2361,135738,137115,639083,724033,19857,13.481,40225,27.308,121086,53646,67440,7.409,16.724,291521,112803,178718,15.58,40.264,-170435,-23.54,33.448,27818,27831,78546
2009,2362,37559,38847,637237,686726,3023,7.556,5340,13.348,81906,18027,63879,2.625,11.927,180680,31864,148816,4.64,26.31,-98774,-14.383,23.854,3855,3861,21683
2009,2371,17290,18462,505645,528170,1322,6.99,2223,11.754,74740,22597,52143,4.278,14.151,119078,19598,99480,3.711,22.545,-44338,-8.395,28.301,1517,1526,11791
2009,2372,7693,7761,49638,57075,571,6.663,2189,25.543,5307,1828,3479,3.203,9.298,20138,7416,12722,12.994,35.284,-14831,-25.985,18.597,1821,1824,6255
2009,2373,9132,9930,280546,297458,544,5.347,1030,10.125,30032,5611,24421,1.886,10.096,63744,10956,52788,3.683,21.43,-33712,-11.333,20.192,641,643,6721
2009,2379,3703,3862,63374,66052,388,9.773,604,15.214,12049,2595,9454,3.929,18.242,17218,3245,13973,4.913,26.068,-5169,-7.826,36.484,394,395,2336
2009,2381,79966,80774,805617,911807,8079,9.333,19650,22.701,123410,35822,87588,3.929,13.535,335938,80604,255334,8.84,36.843,-212528,-23.308,27.069,13001,13003,57056
2009,2382,156816,160626,1773955,1887036,12922,7.845,21090,12.804,221906,60700,161206,3.217,11.76,447795,90648,357147,4.804,23.73,-225889,-11.971,23.519,14997,15020,63171
2009,2383,96449,97514,715281,798103,10834,10.442,23318,22.474,112802,34446,78356,4.316,14.134,278906,78817,200089,9.876,34.946,-166104,-20.812,28.268,16002,16004,55602
2009,2389,54981,55749,476616,528157,6205,10.546,12380,21.041,73341,27011,46330,5.114,13.886,176456,46712,129744,8.844,33.41,-103115,-19.524,27.772,8304,8307,34129
2009,3111,1079,1657,50403,50523,77,4.594,115,6.862,4552,754,3798,1.492,9.01,4847,852,3995,1.686,9.594,-295,-0.584,18.02,76,76,488
2009,3112,435,762,55841,55213,37,4.897,24,3.177,4361,1222,3139,2.213,7.899,3095,906,2189,1.641,5.606,1266,2.293,11.211,12,14,459
2009,3113,1428,1575,64965,66278,113,7.105,144,9.054,4766,713,4053,1.076,7.191,7598,1284,6314,1.937,11.464,-2832,-4.273,14.382,110,110,773
2009,3114,1172,1539,159335,160281,104,6.749,108,7.008,13233,3298,9935,2.058,8.256,15141,2501,12640,1.56,9.447,-1908,-1.19,16.512,63,63,748
2009,3115,971,1477,138259,136670,95,6.374,122,8.185,12874,2693,10181,1.97,9.42,9713,3149,6564,2.304,7.107,3161,2.313,14.214,74,74,742
2009,3116,2801,3427,498756,501212,176,5.102,221,6.407,28961,5417,23544,1.081,5.778,34260,7851,26409,1.566,6.835,-5299,-1.057,11.556,159,161,4062
2009,3117,484,576,30918,32022,37,6.346,51,8.748,2536,706,1830,2.205,7.92,4693,1283,3410,4.007,14.656,-2157,-6.736,15.839,39,39,849
2009,3118,8532,9251,271571,275530,833,8.954,937,10.072,24189,7588,16601,2.754,8.779,31833,9811,22022,3.561,11.553,-7644,-2.774,17.558,746,756,5278
2009,3119,2524,2959,162172,162782,227,7.603,280,9.379,16522,4297,12225,2.64,10.15,17727,3860,13867,2.371,10.89,-1205,-0.74,20.3,200,201,1647
2009,3121,3081,3656,126520,131045,406,11.309,274,7.632,11497,3790,7707,2.892,8.773,20541,4990,15551,3.808,15.675,-9044,-6.901,17.547,176,177,1194
2009,3122,67,95,17145,18083,4,4.167,6,6.25,388,66,322,0.365,2.146,2249,43,2206,0.238,12.437,-1861,-10.291,4.291,3,3,36
2009,3131,251,349,32110,35674,19,5.263,43,11.911,1120,419,701,1.175,3.14,8133,3152,4981,8.836,22.798,-7013,-19.659,6.279,26,26,464
2009,3132,934,1055,55361,60604,50,4.593,117,10.749,3979,1638,2341,2.703,6.566,14044,3085,10959,5.09,23.173,-10065,-16.608,13.131,83,83,1037
2009,3133,1055,1104,33855,37440,81,7.213,119,10.597,2785,1303,1482,3.48,7.439,9920,2210,7710,5.903,26.496,-7135,-19.057,14.877,89,89,1290
2009,3141,1930,2050,57482,63330,107,5.005,283,13.237,2450,819,1631,1.293,3.869,14197,2811,11386,4.439,22.417,-11747,-18.549,7.737,212,212,1161
2009,3149,3973,4085,61095,66719,372,9.001,468,11.323,4822,1875,2947,2.81,7.227,16134,3495,12639,5.238,24.182,-11312,-16.955,14.455,332,336,2265
2009,3151,299,318,15897,18035,26,7.82,55,16.541,1235,519,716,2.878,6.848,5548,1688,3860,9.36,30.763,-4313,-23.915,13.696,44,44,758
2009,3152,5367,5446,103524,113821,728,12.706,1295,22.602,15637,7644,7993,6.716,13.738,36290,14239,22051,12.51,31.884,-20653,-18.145,27.477,1097,1098,11607
2009,3159,627,642,10831,11812,50,7.564,88,13.313,750,170,580,1.439,6.35,2704,591,2113,5.004,22.893,-1954,-16.543,12.699,65,65,350
2009,3161,194,198,3500,4105,11,5.405,22,10.811,292,133,159,3.24,7.114,1469,458,1011,11.158,35.79,-1177,-28.676,14.228,16,16,112
2009,3162,199,220,11841,12210,21,9.417,27,12.108,711,168,543,1.376,5.823,1430,241,1189,1.974,11.712,-719,-5.889,11.647,21,21,230
2009,3169,714,726,14071,14672,64,8.596,101,13.566,1710,741,969,5.05,11.655,2986,987,1999,6.727,20.352,-1276,-8.697,23.31,80,80,654
2009,3211,3043,3462,83572,92705,199,5.572,418,11.704,5516,2806,2710,3.027,5.95,23867,6296,17571,6.791,25.745,-18351,-19.795,11.9,282,286,2968
2009,3212,1332,1683,71589,83005,81,4.615,225,12.821,4719,1977,2742,2.382,5.685,27937,5238,22699,6.31,33.657,-23218,-27.972,11.37,129,133,2315
2009,3219,8453,9444,232090,263675,521,5.327,1192,12.189,14790,4677,10113,1.774,5.609,77651,15487,62164,5.874,29.45,-62861,-23.84,11.218,849,855,7486
2009,3221,237,461,116311,119546,12,2.542,34,7.203,3998,1400,2598,1.171,3.344,10642,4621,6021,3.865,8.902,-6644,-5.558,6.689,9,10,1619
2009,3222,2761,4125,264639,276638,120,2.857,269,6.406,14438,4078,10360,1.474,5.219,38353,8308,30045,3.003,13.864,-23915,-8.645,10.438,166,174,3149
2009,3231,27672,29100,548268,582812,1392,4.645,3132,10.45,35681,11850,23831,2.033,6.122,105031,29382,75649,5.041,18.021,-69350,-11.899,12.244,2517,2529,17059
2009,3241,994,2159,100427,101855,143,6.551,191,8.749,5555,997,4558,0.979,5.454,8411,2297,6114,2.255,8.258,-2856,-2.804,10.908,75,75,624
2009,3251,1372,2414,150510,152499,152,6.241,195,8.007,10922,3251,7671,2.132,7.162,14886,3650,11236,2.393,9.761,-3964,-2.599,14.324,87,89,458
2009,3252,973,1295,89034,94389,63,4.831,81,6.212,5546,1807,3739,1.914,5.876,16070,4929,11141,5.222,17.025,-10524,-11.15,11.751,37,38,866
2009,3253,611,839,29512,29573,61,7.284,58,6.925,2446,467,1979,1.579,8.271,2504,409,2095,1.383,8.467,-58,-0.196,16.542,39,40,220
2009,3254,1422,1844,241910,247572,138,7.512,124,6.75,17021,3199,13822,1.292,6.875,28655,6208,22447,2.508,11.574,-11634,-4.699,13.75,71,71,1146
2009,3255,1377,1744,55973,59359,63,3.536,138,7.746,2828,529,2299,0.891,4.764,9580,2311,7269,3.893,16.139,-6752,-11.375,9.529,84,86,991
2009,3256,1849,2045,95640,100409,112,5.386,181,8.704,7980,2694,5286,2.683,7.947,17677,4586,13091,4.567,17.605,-9697,-9.658,15.895,121,121,1608
2009,3259,1894,2469,93369,94785,197,7.948,216,8.715,12608,7242,5366,7.64,13.302,14864,3804,11060,4.013,15.682,-2256,-2.38,26.604,155,156,1418
2009,3261,8554,10887,561017,613078,391,3.515,864,7.767,28918,8714,20204,1.421,4.717,133789,30843,102946,5.031,21.823,-104871,-17.106,9.434,545,564,12377
2009,3262,1530,2000,125760,136020,70,3.441,138,6.785,4200,1255,2945,0.923,3.088,24692,4565,20127,3.356,18.153,-20492,-15.065,6.176,78,82,1893
2009,3271,1076,1269,35556,40403,82,6.296,149,11.44,1866,604,1262,1.495,4.619,11549,2319,9230,5.74,28.585,-9683,-23.966,9.237,95,96,938
2009,3272,1478,1776,89137,94873,106,5.789,216,11.797,4919,1221,3698,1.287,5.185,16246,4286,11960,4.518,17.124,-11327,-11.939,10.37,155,155,966
2009,3273,4482,9168,173601,190932,429,4.586,801,8.563,17335,6540,10795,3.425,9.079,52166,8773,43393,4.595,27.322,-34831,-18.243,18.158,278,288,2815
2009,3274,179,315,14140,15413,16,4.848,46,13.939,781,385,396,2.498,5.067,3403,646,2757,4.191,22.079,-2622,-17.012,10.134,26,26,169
2009,3279,2657,3122,67121,72795,200,6.25,356,11.125,5173,2240,2933,3.077,7.106,16559,3320,13239,4.561,22.747,-11386,-15.641,14.213,266,266,2244
2009,3311,372,505,102494,104915,65,12.833,68,13.425,5906,3052,2854,2.909,5.629,10822,1642,9180,1.565,10.315,-4916,-4.686,11.259,53,53,455
2009,3312,471,612,38898,41664,34,5.511,44,7.131,2210,440,1770,1.056,5.304,7714,689,7025,1.654,18.515,-5504,-13.211,10.609,32,32,320
2009,3313,423,555,51199,56654,32,5.694,46,8.185,1547,790,757,1.394,2.731,12364,1970,10394,3.477,21.824,-10817,-19.093,5.461,26,26,933
2009,3314,722,925,59362,62329,53,5.693,65,6.982,3835,881,2954,1.413,6.153,9776,3009,6767,4.828,15.685,-5941,-9.532,12.306,33,35,1187
2009,3315,1714,1938,126066,138739,68,3.461,121,6.159,4700,1604,3096,1.156,3.388,30172,2896,27276,2.087,21.747,-25472,-18.36,6.775,85,86,1303
2009,3321,2379,2632,110625,119325,99,3.734,138,5.205,5815,2088,3727,1.75,4.873,23220,3036,20184,2.544,19.46,-17405,-14.586,9.747,92,92,1221
2009,3322,1251,1353,42502,45981,55,3.957,129,9.281,2123,505,1618,1.098,4.617,9000,2615,6385,5.687,19.574,-6877,-14.956,9.234,85,85,393
2009,3323,11981,13034,352731,377328,604,4.562,1015,7.666,25683,8224,17459,2.18,6.807,74774,12119,62655,3.212,19.817,-49091,-13.01,13.613,713,720,6720
2009,3324,1156,1443,86573,90753,58,3.978,88,6.036,5595,1847,3748,2.035,6.165,14076,2549,11527,2.809,15.51,-8481,-9.345,12.33,50,50,999
2009,3325,597,667,31528,34542,27,3.965,55,8.076,1097,251,846,0.727,3.176,7130,1571,5559,4.548,20.642,-6033,-17.466,6.352,38,38,594
2009,3326,1247,1412,41048,44899,45,3.122,104,7.215,2490,709,1781,1.579,5.546,10177,1923,8254,4.283,22.666,-7687,-17.121,11.092,68,69,1267
2009,3327,22480,22926,352735,374318,1005,4.313,1754,7.528,26695,7719,18976,2.062,7.132,69851,11948,57903,3.192,18.661,-43156,-11.529,14.263,1299,1303,8376
2009,3328,5205,5710,118871,127368,264,4.556,432,7.456,9257,3063,6194,2.405,7.268,26228,6027,20201,4.732,20.592,-16971,-13.324,14.536,300,302,3317
2009,3329,5789,6351,262780,273753,412,6.455,476,7.457,19294,6655,12639,2.431,7.048,41321,7008,34313,2.56,15.094,-22027,-8.046,14.096,322,322,2596
2009,3331,2477,2832,200497,205662,160,5.595,215,7.519,17651,5149,12502,2.504,8.583,27932,3805,24127,1.85,13.582,-10281,-4.999,17.165,150,150,2257
2009,3332,3301,3477,112316,119620,155,4.379,280,7.911,8377,2679,5698,2.24,7.003,23189,4590,18599,3.837,19.386,-14812,-12.383,14.006,194,196,2064
2009,3333,1825,1964,77352,81410,108,5.405,176,8.809,4920,1779,3141,2.185,6.043,12974,3157,9817,3.878,15.937,-8054,-9.893,12.087,124,124,1288
2009,3334,1448,1729,132117,139978,106,6.073,139,7.963,8037,2338,5699,1.67,5.742,24057,5594,18463,3.996,17.186,-16020,-11.445,11.483,76,79,2000
2009,3335,6867,7087,142049,152522,227,3.129,562,7.747,8275,1290,6985,0.846,5.425,29087,5668,23419,3.716,19.071,-20812,-13.645,10.851,410,412,2983
2009,3336,817,1007,104791,108695,57,5.7,43,4.3,7615,2280,5335,2.098,7.006,15754,3542,12212,3.259,14.494,-8139,-7.488,14.012,28,28,413
2009,3339,5282,5897,269748,282482,288,4.837,403,6.768,18065,5171,12894,1.831,6.395,43570,7505,36065,2.657,15.424,-25505,-9.029,12.79,270,274,3408
2009,3341,999,1078,84974,87430,113,10.367,137,12.569,7576,4026,3550,4.605,8.665,12383,2757,9626,3.153,14.163,-4807,-5.498,17.331,103,103,1366
2009,3342,1282,1425,141066,132765,90,6.2,143,9.852,28223,2477,25746,1.866,21.258,13387,3677,9710,2.77,10.083,14836,11.175,20.167,90,90,1902
2009,3343,413,427,13009,13471,28,6.371,53,12.059,826,139,687,1.032,6.132,1763,362,1401,2.687,13.087,-937,-6.956,12.263,45,45,333
2009,3344,3780,4258,300820,325173,193,4.446,359,8.27,15498,5087,10411,1.564,4.766,64671,15664,49007,4.817,19.888,-49173,-15.122,9.532,234,237,4553
2009,3345,4283,4981,397473,402779,280,5.58,354,7.055,28920,5571,23349,1.383,7.18,39141,8711,30430,2.163,9.718,-10221,-2.538,14.36,216,217,2419
2009,3346,578,598,21473,23323,44,6.973,110,17.433,2145,387,1758,1.659,9.197,5792,3212,2580,13.772,24.834,-3647,-15.637,18.394,77,77,907
2009,3351,988,1088,49331,52349,52,4.745,68,6.204,2819,684,2135,1.307,5.385,8800,1451,7349,2.772,16.81,-5981,-11.425,10.77,48,48,313
2009,3352,236,280,48329,53382,22,7.47,51,17.317,1057,61,996,0.114,1.98,11060,2246,8814,4.207,20.719,-10003,-18.739,3.96,38,38,690
2009,3353,1896,2205,125434,131864,94,4.22,139,6.24,8492,1630,6862,1.236,6.44,21465,6608,14857,5.011,16.278,-12973,-9.838,12.88,79,80,1324
2009,3359,1783,2089,139914,146752,115,5.474,139,6.616,10303,2975,7328,2.027,7.021,23807,4106,19701,2.798,16.223,-13504,-9.202,14.041,82,82,1101
2009,3361,265,332,135918,156889,37,11.061,42,12.556,6526,1565,4961,0.998,4.16,49007,11630,37377,7.413,31.237,-42481,-27.077,8.319,32,32,805
2009,3362,1662,1920,94077,113494,112,5.658,231,11.67,5491,2735,2756,2.41,4.838,44181,6591,37590,5.807,38.928,-38690,-34.09,9.676,164,165,3287
2009,3363,4154,5095,430031,489427,282,5.449,442,8.541,21962,9538,12424,1.949,4.487,140224,21708,118516,4.435,28.651,-118262,-24.163,8.975,259,262,4661
2009,3364,1241,1639,400721,409323,96,5.866,91,5.561,30967,3912,27055,0.956,7.565,47074,4077,42997,0.996,11.5,-16107,-3.935,15.131,61,65,2498
2009,3365,153,229,27619,28508,22,9.821,12,5.357,1565,388,1177,1.361,5.49,3305,846,2459,2.968,11.593,-1740,-6.104,10.98,6,7,264
2009,3366,1368,1489,136683,147213,124,8.023,237,15.335,10442,1529,8913,1.039,7.093,32002,4731,27271,3.214,21.739,-21560,-14.645,14.186,167,167,2038
2009,3369,771,800,44078,46100,80,9.633,141,16.978,3233,851,2382,1.846,7.013,7319,1160,6159,2.516,15.876,-4086,-8.863,14.026,118,118,768
2009,3371,12284,12553,236757,267067,733,5.543,2077,15.705,14019,5624,8395,2.106,5.249,74639,20023,54616,7.497,27.948,-60620,-22.698,10.499,1590,1595,9642
2009,3372,3676,3881,115087,127388,179,4.497,378,9.496,7367,2290,5077,1.798,5.783,31783,6674,25109,5.239,24.95,-24416,-19.167,11.566,295,295,3274
2009,3379,789,905,34265,37684,41,4.39,99,10.6,2151,412,1739,1.093,5.708,9113,2183,6930,5.793,24.183,-6962,-18.475,11.416,61,61,779
2009,3391,10328,11164,302466,305821,686,6.103,839,7.464,25526,4755,20771,1.555,8.347,32696,7631,25065,2.495,10.691,-7170,-2.345,16.693,627,629,3740
2009,3399,15416,15865,292552,312472,1104,6.78,1938,11.903,22677,8076,14601,2.585,7.257,62817,13783,49034,4.411,20.103,-40140,-12.846,14.515,1499,1502,8578
2009,4231,16820,24113,361392,376454,1437,5.853,2313,9.421,31952,11978,19974,3.182,8.488,62072,15449,46623,4.104,16.489,-30120,-8.001,16.975,1496,1550,7968
2009,4232,10424,12116,146648,157830,810,6.482,1569,12.557,13229,4028,9201,2.552,8.382,35619,10208,25411,6.468,22.568,-22390,-14.186,16.764,1130,1190,7386
2009,4233,10910,17704,213682,234791,1103,6.091,1915,10.574,17933,6801,11132,2.897,7.638,60472,16371,44101,6.973,25.756,-42539,-18.118,15.276,1018,1042,6008
2009,4234,22757,32568,699353,709463,3143,9.597,3506,10.706,90148,26186,63962,3.691,12.707,110620,36625,73995,5.162,15.592,-20472,-2.886,25.413,1898,1937,11641
2009,4235,7612,10522,153528,161787,590,5.557,781,7.356,12687,3827,8860,2.365,7.842,29366,6605,22761,4.083,18.151,-16679,-10.309,15.684,496,508,4336
2009,4236,18621,28106,535770,534681,1857,6.52,2607,9.153,88684,19252,69432,3.601,16.586,85088,29479,55609,5.513,15.914,3596,0.673,31.828,1448,1507,9586
2009,4237,10600,19302,221899,232586,1142,5.902,1236,6.388,18374,6695,11679,2.879,7.9,39432,8384,31048,3.605,16.954,-21058,-9.054,15.8,586,626,4052
2009,4238,39852,56421,705397,724547,3034,5.336,3907,6.872,66551,22974,43577,3.171,9.185,104839,27432,77407,3.786,14.47,-38288,-5.284,18.37,2355,2499,14282
2009,4239,26615,29646,316130,331334,2747,9.122,3684,12.233,35939,12462,23477,3.761,10.847,66382,19927,46455,6.014,20.035,-30443,-9.188,21.694,2692,2728,12053
2009,4241,8027,10648,155585,162853,568,5.244,933,8.615,10926,3961,6965,2.432,6.709,25292,6618,18674,4.064,15.531,-14366,-8.821,13.418,588,602,3740
2009,4242,5590,8358,274742,274314,955,11.559,763,9.235,46418,8845,37573,3.224,16.921,44394,11717,32677,4.271,16.184,2024,0.738,32.367,488,502,4024
2009,4243,13200,14380,186592,198467,1448,9.838,2124,14.431,21366,7185,14181,3.62,10.766,44864,15690,29174,7.906,22.605,-23498,-11.84,21.531,1613,1649,8091
2009,4244,24164,30870,765059,780377,2737,8.861,2776,8.987,73887,22371,51516,2.867,9.468,105192,22943,82249,2.94,13.48,-31305,-4.012,18.936,1933,1961,13445
2009,4245,3396,5964,60226,60541,271,4.509,363,6.04,7090,1399,5691,2.311,11.711,7680,2226,5454,3.677,12.686,-590,-0.975,23.422,191,206,1437
2009,4246,7964,11955,144931,147192,786,6.481,1130,9.318,15814,5868,9946,3.987,10.744,20629,7076,13553,4.807,14.015,-4815,-3.271,21.488,512,542,2783
2009,4247,4836,7106,103279,104399,300,4.203,363,5.086,9760,2668,7092,2.556,9.349,11904,2959,8945,2.834,11.402,-2144,-2.054,18.697,253,257,2393
2009,4248,3047,3929,177441,179033,322,8.175,342,8.682,17234,6891,10343,3.849,9.626,20148,7288,12860,4.071,11.254,-2914,-1.628,19.252,256,270,4558
2009,4249,20539,26599,335735,346416,2206,8.192,2864,10.636,35677,10689,24988,3.086,10.299,57096,16616,40480,4.797,16.482,-21419,-6.183,20.598,2034,2069,9841
2009,4251,39935,42062,289068,293063,4558,10.631,6182,14.419,41474,16892,24582,5.764,14.152,49438,20138,29300,6.872,16.869,-7964,-2.718,28.304,4559,4579,14099
2009,4411,39320,44100,1047228,1148052,3193,7.044,5658,12.481,62936,29265,33671,2.549,5.482,264301,70883,193418,6.174,23.022,-201365,-17.54,10.964,4504,4556,55746
2009,4412,12895,14653,136054,150097,1019,6.765,1838,12.202,11991,5472,6519,3.646,7.989,39930,9845,30085,6.559,26.603,-27939,-18.614,15.978,1342,1367,6981
2009,4413,28008,54711,463966,470352,2882,5.237,3527,6.409,43333,15964,27369,3.394,9.213,56495,15111,41384,3.213,12.011,-13162,-2.798,18.426,2359,2418,9070
2009,4421,15962,24608,216886,234746,1683,6.624,3285,12.928,20735,11221,9514,4.78,8.833,56559,17357,39202,7.394,24.094,-35824,-15.261,17.666,2207,2565,13648
2009,4422,21771,29736,229342,255048,1818,5.838,4624,14.85,24669,9130,15539,3.58,9.672,77353,34192,43161,13.406,30.329,-52684,-20.657,19.345,2752,3387,25975
2009,4431,25861,48009,465846,478177,4340,8.909,5757,11.817,56789,25501,31288,5.333,11.876,82012,36245,45767,7.58,17.151,-25223,-5.275,23.752,3553,4206,18702
2009,4441,41309,64446,1069121,1118657,2975,4.537,5227,7.971,70529,31353,39176,2.803,6.305,170816,32826,137990,2.934,15.27,-100287,-8.965,12.61,3439,3598,18257
2009,4442,14152,17584,149468,155574,891,4.987,1454,8.139,15197,4065,11132,2.613,9.768,26976,7167,19809,4.607,17.34,-11779,-7.571,19.537,1058,1071,5531
2009,4451,56294,82266,2558645,2561860,8711,10.64,7912,9.665,252359,121158,131201,4.729,9.851,260050,85306,174744,3.33,10.151,-7691,-0.3,19.701,5775,5825,33096
2009,4452,16887,20895,142934,145579,2476,11.72,2937,13.903,27300,11550,15750,7.934,18.753,32558,12563,19995,8.63,22.365,-5258,-3.612,37.506,2284,2295,9565
2009,4453,25264,28973,147193,146237,2685,9.33,2298,7.985,24946,9383,15563,6.416,17.059,22938,7314,15624,5.001,15.686,2008,1.373,31.371,1739,1769,5910
2009,4461,39069,85698,985094,1004029,6173,7.23,5545,6.494,94243,37335,56908,3.719,9.386,132546,29170,103376,2.905,13.201,-38303,-3.815,18.773,3246,3375,14479
2009,4471,61081,107871,855753,875610,7930,7.316,8985,8.289,109781,42873,66908,4.896,12.538,149199,48654,100545,5.557,17.039,-39418,-4.502,25.075,6092,6338,30606
2009,4481,33928,91725,1201834,1246971,7996,8.633,9795,10.575,153047,76709,76338,6.152,12.274,239384,70438,168946,5.649,19.197,-86337,-6.924,24.547,4836,5099,18839
2009,4482,5908,26114,195555,202286,1660,6.209,2901,10.851,26746,13418,13328,6.633,13.222,39684,11839,27845,5.853,19.618,-12938,-6.396,26.444,692,764,2988
2009,4483,16317,24377,137193,144672,1726,6.835,3474,13.758,19089,8132,10957,5.621,13.195,33986,14670,19316,10.14,23.492,-14897,-10.297,26.389,1486,2164,7444
2009,4511,25967,36045,399716,415219,2997,8.157,4393,11.956,47346,20573,26773,4.955,11.403,79341,22493,56848,5.417,19.108,-31995,-7.706,22.805,2920,3002,11526
2009,4512,4800,10095,136209,140899,659,6.404,1051,10.213,10106,4994,5112,3.544,7.173,19310,5996,13314,4.256,13.705,-9204,-6.532,14.345,651,666,2729
2009,4522,81,5151,615093,660070,148,2.817,355,6.756,21232,12099,9133,1.833,3.217,109181,39184,69997,5.936,16.541,-87949,-13.324,6.433,16,192,27453
2009,4523,7053,38495,2295710,2281760,1919,4.97,2157,5.586,166412,38651,127761,1.694,7.293,140693,22243,118450,0.975,6.166,25719,1.127,12.332,1229,1274,6678
2009,4531,15309,16023,75405,82356,1079,6.485,2312,13.895,7891,2955,4936,3.588,9.582,21699,6562,15137,7.968,26.348,-13808,-16.766,19.163,1950,1956,5549
2009,4532,22660,33675,276783,290048,2450,7.08,4306,12.444,25496,9827,15669,3.388,8.79,52618,16532,36086,5.7,18.141,-27122,-9.351,17.581,3274,3327,10985
2009,4533,11361,16150,140848,138586,1462,9,1652,10.169,21364,8129,13235,5.866,15.416,16834,5214,11620,3.762,12.147,4530,3.269,24.294,1280,1298,3661
2009,4539,28794,37533,238276,243442,3947,10.43,4567,12.068,35425,16372,19053,6.725,14.552,45044,15151,29893,6.224,18.503,-9619,-3.951,29.104,3483,3557,11694
2009,4541,18665,19734,325212,328702,2791,14.179,2691,13.671,52054,21923,30131,6.67,15.836,59033,17520,41513,5.33,17.959,-6979,-2.123,31.673,2117,2129,10512
2009,4542,3776,4240,38438,43093,377,8.644,620,14.215,3801,1193,2608,2.768,8.821,12869,3581,9288,8.31,29.864,-9068,-21.043,17.641,466,475,1809
2009,4543,21517,27516,198515,205523,2009,7.156,3123,11.125,23478,8159,15319,3.97,11.424,37770,13535,24235,6.586,18.378,-14292,-6.954,22.847,2275,2315,8813
2009,4811,452,2813,402989,423085,179,6.257,275,9.612,12118,2544,9574,0.601,2.864,51889,4309,47580,1.018,12.264,-39771,-9.4,5.728,51,61,1572
2009,4812,1967,2150,35487,37728,290,13.352,334,15.378,4426,1520,2906,4.029,11.731,8843,4334,4509,11.488,23.439,-4417,-11.708,23.463,235,241,3467
2009,4831,699,1018,48116,48138,111,11.034,87,8.648,5230,1687,3543,3.505,10.865,5372,705,4667,1.465,11.16,-142,-0.295,21.729,64,64,572
2009,4832,475,524,19345,19895,66,12.607,65,12.416,1698,601,1097,3.021,8.535,2792,939,1853,4.72,14.034,-1094,-5.499,17.07,45,45,554
2009,4841,45276,54543,880057,917334,8238,14.819,10333,18.588,105714,47619,58095,5.191,11.524,180816,60294,120522,6.573,19.711,-75102,-8.187,23.048,7526,7626,35392
2009,4842,37614,41810,442487,460515,4222,9.775,6988,16.179,60003,21393,38610,4.645,13.03,96790,32200,64590,6.992,21.018,-36787,-7.988,26.059,4860,4901,21410
2009,4851,571,817,48016,48123,70,8.516,80,9.732,5130,1392,3738,2.893,10.66,5382,2767,2615,5.75,11.184,-252,-0.524,21.321,47,47,1489
2009,4852,205,406,13091,14387,65,14.84,129,29.452,2026,1034,992,7.187,14.082,4755,2202,2553,15.305,33.051,-2729,-18.969,28.164,19,19,104
2009,4853,6059,6169,64744,67590,946,15.183,1069,17.158,8965,4048,4917,5.989,13.264,14664,4074,10590,6.028,21.696,-5699,-8.432,26.528,830,830,3009
2009,4854,2802,4389,214409,217256,347,7.958,290,6.651,23484,9572,13912,4.406,10.809,29961,6754,23207,3.109,13.791,-6477,-2.981,21.619,167,169,3384
2009,4855,1128,1241,29081,29837,108,8.657,121,9.699,2915,707,2208,2.37,9.77,4451,1409,3042,4.722,14.918,-1536,-5.148,19.54,84,85,866
2009,4859,2899,3218,67797,66565,531,16.938,365,11.643,12456,4303,8153,6.464,18.713,9987,4169,5818,6.263,15.003,2469,3.709,30.007,300,300,2732
2009,4861,49,390,7659,6962,33,8.571,23,5.974,1670,833,837,11.966,23.989,356,86,270,1.235,5.114,1314,18.875,10.228,4,4,12
2009,4862,114,1677,25537,25722,98,5.804,121,7.166,2771,1253,1518,4.871,10.773,3094,1120,1974,4.354,12.029,-323,-1.256,21.546,14,14,82
2009,4869,59,732,8232,8242,45,6.127,50,6.807,770,179,591,2.172,9.343,801,236,565,2.864,9.719,-31,-0.376,18.686,4,4,9
2009,4871,470,513,8690,9074,52,9.83,84,15.879,1110,245,865,2.7,12.233,1867,522,1345,5.753,20.575,-757,-8.343,24.466,66,68,478
2009,4872,1154,1195,10389,10921,152,12.428,208,17.007,1251,400,851,3.663,11.455,2322,679,1643,6.217,21.262,-1071,-9.807,22.91,141,141,433
2009,4879,136,150,2207,2214,26,17.333,26,17.333,638,422,216,19.065,28.823,612,87,525,3.93,27.649,26,1.175,55.297,15,15,66
2009,4881,3743,5384,164840,172997,580,10.833,520,9.712,24048,9817,14231,5.675,13.901,40569,12532,28037,7.244,23.451,-16521,-9.55,27.802,299,307,8937
2009,4882,459,1051,24945,26408,138,13.477,84,8.203,3313,2172,1141,8.225,12.546,6288,2013,4275,7.623,23.811,-2975,-11.266,25.091,27,27,817
2009,4883,1636,2219,85127,88800,177,7.932,202,9.052,9396,1942,7454,2.187,10.581,16573,2092,14481,2.356,18.663,-7177,-8.082,21.162,117,121,1302
2009,4884,8423,9135,75998,76999,1209,13.269,1162,12.753,13819,5950,7869,7.727,17.947,15597,6117,9480,7.944,20.256,-1778,-2.309,35.894,839,892,4012
2009,4885,13441,19450,225756,231687,1565,7.908,2244,11.339,29298,8135,21163,3.511,12.646,40834,14375,26459,6.204,17.625,-11536,-4.979,25.291,1215,1304,6611
2009,4889,1197,1313,24855,26221,202,15.479,186,14.253,2806,1086,1720,4.142,10.702,5682,980,4702,3.738,21.67,-2876,-10.969,21.403,147,147,728
2009,4921,3259,8700,517307,538868,806,9.186,955,10.884,24981,10126,14855,1.879,4.636,70269,6728,63541,1.249,13.04,-45288,-8.404,9.272,406,413,2481
2009,4922,3757,4011,31011,33231,655,16.395,623,15.594,5380,2580,2800,7.764,16.19,9968,3321,6647,9.994,29.996,-4588,-13.806,32.379,506,508,2457
2009,4931,6878,14129,684057,699653,1321,9.342,1343,9.498,86038,37011,49027,5.29,12.297,117658,39458,78200,5.64,16.817,-31620,-4.519,24.594,423,468,7988
2009,5111,13915,20112,589537,632888,1607,7.854,2305,11.265,42690,18166,24524,2.87,6.745,129165,29968,99197,4.735,20.409,-86475,-13.664,13.491,1343,1387,13297
2009,5112,5147,7511,377288,383964,773,10.174,947,12.464,47978,15038,32940,3.917,12.495,61846,25962,35884,6.762,16.107,-13868,-3.612,24.991,401,430,9738
2009,5121,12589,15977,315291,321302,2070,12.819,2411,14.931,40325,16205,24120,5.044,12.55,51731,14657,37074,4.562,16.1,-11406,-3.55,25.101,1536,1575,6776
2009,5122,2801,3050,23719,24171,441,14.295,511,16.564,3197,1591,1606,6.582,13.227,4123,1256,2867,5.196,17.058,-926,-3.831,26.454,370,370,848
2009,5151,4156,8720,229814,238753,835,9.471,1028,11.66,18213,8371,9842,3.506,7.628,36082,10286,25796,4.308,15.113,-17869,-7.484,15.257,279,293,2265
2009,5152,397,671,42030,41917,118,18.337,63,9.79,5137,2510,2627,5.988,12.255,4860,1231,3629,2.937,11.594,277,0.661,23.189,28,28,427
2009,5173,4307,44792,1116042,1123797,6874,15.31,7087,15.784,164343,75897,88446,6.754,14.624,181975,69135,112840,6.152,16.193,-17632,-1.569,29.248,475,563,7355
2009,5174,401,511,8220,8420,67,12.63,106,19.981,1247,288,959,3.421,14.811,1629,713,916,8.468,19.348,-382,-4.537,29.622,75,75,473
2009,5179,4294,4763,57551,59513,788,16.151,1020,20.906,10800,4238,6562,7.121,18.147,14672,6027,8645,10.127,24.653,-3872,-6.506,36.295,767,775,3198
2009,5182,7954,11912,398583,398741,1844,13.93,4495,33.957,69019,33334,35685,8.36,17.309,69091,28401,40690,7.123,17.327,-72,-0.018,34.618,818,831,8333
2009,5191,5985,7400,139320,140012,1187,16.403,860,11.884,25186,10997,14189,7.854,17.988,26327,7561,18766,5.4,18.803,-1141,-0.815,35.977,540,548,3420
2009,5211,13,48,18775,18894,(D),(D),(D),(D),994,(D),972,(D),5.261,1164,(D),1034,(D),6.161,-170,-0.9,10.522,0,0,0
2009,5221,14448,127030,2036441,2068001,6489,5.098,6989,5.491,203724,79953,123771,3.866,9.851,267086,70306,196780,3.4,12.915,-63362,-3.064,19.703,475,748,11499
2009,5222,14721,41258,557367,597024,4086,9.222,10184,22.985,96017,32452,63565,5.436,16.083,175213,68796,106417,11.523,29.348,-79196,-13.265,32.165,2712,3077,16151
2009,5223,16456,34200,268711,283544,3122,8.351,9488,25.381,50282,18965,31317,6.689,17.733,79592,36260,43332,12.788,28.07,-29310,-10.337,35.467,6499,7213,25372
2009,5231,11638,42161,487534,506694,7118,17.255,5301,12.85,83408,46024,37384,9.083,16.461,120282,22556,97726,4.452,23.739,-36874,-7.277,32.922,1161,1180,4887
2009,5232,29,83,5430,5924,58,95.082,14,22.951,417,238,179,4.018,7.04,1398,170,1228,2.87,23.601,-981,-16.561,14.08,8,8,38
2009,5239,37268,42627,429467,431188,5573,13.036,5822,13.618,71261,32336,38925,7.499,16.527,75527,24371,51156,5.652,17.516,-4266,-0.989,33.053,3851,3885,14423
2009,5241,5535,32790,1485536,1489774,3702,11.252,3921,11.918,154762,64614,90148,4.337,10.388,163240,46974,116266,3.153,10.957,-8478,-0.569,20.777,631,667,5012
2009,5242,119520,134308,875170,881726,10844,8.014,12869,9.51,118314,43122,75192,4.891,13.418,131887,52890,78997,5.998,14.958,-13573,-1.539,26.837,8694,8808,29207
2009,5259,658,674,7703,8294,178,26.827,157,23.662,2233,1779,454,21.451,26.925,3352,1064,2288,12.829,40.417,-1119,-13.492,53.849,123,124,731
2009,5311,82718,104418,519096,530449,9154,8.707,10589,10.072,77706,33055,44651,6.232,14.649,100573,40328,60245,7.603,18.96,-22867,-4.311,29.298,7312,7389,27054
2009,5312,60776,70641,291360,315550,9861,13.052,19681,26.05,56211,27689,28522,8.775,17.814,104405,50029,54376,15.855,33.087,-48194,-15.273,35.627,12202,12350,25888
2009,5313,59605,72009,620615,629233,9227,12.744,10019,13.837,98688,44501,54187,7.072,15.684,115735,44847,70888,7.127,18.393,-17047,-2.709,31.368,6693,6719,27456
2009,5321,3835,12770,168580,178415,1205,9.366,1395,10.843,15807,7229,8578,4.052,8.86,35216,12155,23061,6.813,19.738,-19409,-10.879,17.719,554,573,3001
2009,5322,9363,28156,207480,221972,1336,4.591,3229,11.095,21781,8065,13716,3.633,9.812,51675,14510,37165,6.537,23.28,-29894,-13.467,19.625,1287,1348,5933
2009,5323,2673,4107,25753,26795,171,4.099,300,7.192,2676,650,2026,2.426,9.987,4661,1133,3528,4.228,17.395,-1985,-7.408,19.974,221,231,873
2009,5324,7278,13038,154164,159075,1107,8.443,1254,9.564,19554,6164,13390,3.875,12.292,29398,8951,20447,5.627,18.481,-9844,-6.188,24.585,647,716,4523
2009,5331,1984,2090,33121,32891,262,12.479,281,13.384,5192,2307,2885,7.014,15.786,4712,2059,2653,6.26,14.326,480,1.459,28.653,198,198,1000
2009,5411,160543,170018,1169182,1180257,12825,7.487,15371,8.974,125194,40738,84456,3.452,10.607,147447,46846,100601,3.969,12.493,-22253,-1.885,21.215,11099,11174,34433
2009,5412,96093,111383,1283896,1298071,10514,9.46,10031,9.025,198650,61474,137176,4.736,15.303,226101,74089,152012,5.708,17.418,-27451,-2.115,30.607,6212,6261,42811
2009,5413,83748,99906,1362097,1409197,9124,8.973,12679,12.469,175674,62507,113167,4.436,12.466,268959,70204,198755,4.982,19.086,-93285,-6.62,24.932,7928,8023,31232
2009,5414,26002,26267,114113,123002,3114,11.442,5013,18.419,16713,7444,9269,6.052,13.588,34489,11714,22775,9.523,28.039,-17776,-14.452,27.175,3582,3583,8520
2009,5415,86189,101296,1361550,1333355,18126,18.071,16139,16.09,279786,143562,136224,10.767,20.984,227160,80883,146277,6.066,17.037,52626,3.947,34.073,10440,10526,43206
2009,5416,102488,109734,853606,860556,19684,17.909,20034,18.228,178271,80798,97473,9.389,20.716,190770,73559,117211,8.548,22.168,-12499,-1.452,41.432,14136,14243,46933
2009,5417,11676,14429,641991,632799,1769,12.329,1607,11.2,93018,23034,69984,3.64,14.699,74114,20465,53649,3.234,11.712,18904,2.987,23.424,980,996,9777
2009,5418,31049,34539,430770,450132,3527,10,4986,14.137,56690,23011,33679,5.112,12.594,95661,29561,66100,6.567,21.252,-38971,-8.658,25.188,3563,3592,17064
2009,5419,52436,61945,604028,610298,5603,8.987,6402,10.269,80183,28114,52069,4.607,13.138,92747,29129,63618,4.773,15.197,-12564,-2.059,26.277,4512,4563,20616
2009,5511,26711,50488,2828675,2865818,4370,8.639,4559,9.013,409868,141013,268855,4.921,14.302,484223,129388,354835,4.515,16.897,-74355,-2.595,28.604,995,1126,18520
2009,5611,22974,25060,402971,399890,3322,13.245,3363,13.409,78194,30413,47781,7.605,19.554,71623,27852,43771,6.965,17.911,6571,1.643,35.821,2488,2516,20327
2009,5612,1689,4944,233160,244704,569,10.644,1372,25.666,43917,12510,31407,5.112,17.947,69109,22043,47066,9.008,28.242,-25192,-10.295,35.894,119,126,2820
2009,5613,26031,46926,3890287,4325516,5838,12.164,7976,16.618,613125,194406,418719,4.494,14.175,1492543,321237,1171306,7.427,34.506,-879418,-20.331,28.349,3561,3700,160586
2009,5614,25805,32542,817719,825774,3374,10.249,4131,12.548,160441,74958,85483,9.077,19.429,176918,47778,129140,5.786,21.425,-16477,-1.995,38.858,2844,2899,23716
2009,5615,14083,19890,232812,243769,2379,11.853,2740,13.652,27193,13672,13521,5.609,11.155,49575,15627,33948,6.411,20.337,-22382,-9.182,22.311,1589,1611,7438
2009,5616,17538,23577,795448,811116,2732,11.616,2615,11.119,101926,35721,66205,4.404,12.566,133205,34741,98464,4.283,16.422,-31279,-3.856,25.132,1685,1757,21408
2009,5617,134876,141769,1620030,1661362,19357,13.53,21964,15.352,246117,87846,158271,5.288,14.814,328216,107454,220762,6.468,19.756,-82099,-4.942,29.628,14608,14640,64987
2009,5619,16125,18176,279166,291832,1699,9.256,2060,11.222,45493,12616,32877,4.323,15.589,69891,19279,50612,6.606,23.949,-24398,-8.36,31.178,1462,1465,11727
2009,5621,7190,9332,187499,191365,736,7.826,880,9.358,17147,6245,10902,3.263,8.96,24873,7220,17653,3.773,12.998,-7726,-4.037,17.921,609,623,4900
2009,5622,1322,2434,47029,48271,142,5.794,176,7.181,5766,2385,3381,4.941,11.945,8295,1843,6452,3.818,17.184,-2529,-5.239,23.89,108,109,951
2009,5629,7415,8502,116902,120218,786,9.233,808,9.491,19827,7019,12808,5.839,16.493,26229,5820,20409,4.841,21.818,-6402,-5.325,32.985,543,546,3120
2009,6111,17983,20318,853365,847047,977,4.83,795,3.93,64690,13906,50784,1.642,7.637,51880,10792,41088,1.274,6.125,12810,1.512,12.25,587,597,8270
2009,6112,457,880,87762,85351,53,6.106,29,3.341,10383,1406,8977,1.647,12.165,5576,468,5108,0.548,6.533,4807,5.632,13.066,13,19,342
2009,6113,2351,4131,1664372,1638781,209,5.119,112,2.743,96409,4213,92196,0.257,5.883,46706,2914,43792,0.178,2.85,49703,3.033,5.7,63,63,1190
2009,6114,6253,6776,63502,64968,719,10.468,904,13.162,9575,3086,6489,4.75,14.738,12469,5033,7436,7.747,19.193,-2894,-4.455,29.476,601,612,3504
2009,6115,6019,7426,117953,119366,803,10.746,896,11.991,18939,6945,11994,5.818,15.866,21609,9276,12333,7.771,18.103,-2670,-2.237,31.733,603,621,6440
2009,6116,32469,34979,324173,319285,4688,13.555,3898,11.271,67304,21997,45307,6.889,21.08,57032,19872,37160,6.224,17.862,10272,3.217,35.725,2881,2896,15068
2009,6117,5128,5909,77160,76655,790,13.424,742,12.608,13255,4058,9197,5.294,17.292,12408,5197,7211,6.78,16.187,847,1.105,32.374,530,531,2567
2009,6211,175281,205036,2203608,2184580,15392,7.522,14549,7.11,306051,103917,202134,4.757,14.01,267553,92079,175474,4.215,12.247,38498,1.762,24.495,10354,10578,58235
2009,6212,116600,123195,840120,837028,6381,5.207,5098,4.16,95926,31820,64106,3.802,11.46,89890,23269,66621,2.78,10.739,6036,0.721,21.478,4174,4216,19546
2009,6213,105747,117768,653542,643603,11629,9.994,8806,7.568,112259,38052,74207,5.912,17.442,92432,31103,61329,4.833,14.362,19827,3.081,28.723,5886,5963,19654
2009,6214,14298,31262,698062,689185,2979,9.732,1678,5.482,91365,34885,56480,5.062,13.257,72960,25648,47312,3.721,10.586,18405,2.671,21.173,823,902,12265
2009,6215,7161,12507,246687,244256,1408,11.249,1428,11.408,34303,13139,21164,5.379,14.044,29435,9800,19635,4.012,12.051,4868,1.993,24.102,632,668,5928
2009,6216,16009,23411,1107470,1073670,3343,14.679,2070,9.089,199170,57679,141491,5.372,18.55,131795,42653,89142,3.973,12.275,67375,6.275,24.55,1293,1363,20131
2009,6219,5726,9057,284756,281062,957,10.612,880,9.758,40354,14199,26155,5.052,14.358,33094,11288,21806,4.016,11.775,7260,2.583,23.549,416,487,5921
2009,6221,3123,5309,5161420,5138763,217,4.119,136,2.581,226392,34330,192062,0.668,4.406,180063,53267,126796,1.037,3.504,46329,0.902,7.008,61,64,28557
2009,6222,465,627,215155,214166,33,5.344,14,2.267,7504,2645,4859,1.235,3.504,5460,1367,4093,0.638,2.549,2044,0.954,5.099,5,5,284
2009,6223,465,938,250857,246196,88,9.607,44,4.803,21259,6723,14536,2.731,8.635,11775,4758,7017,1.933,4.783,9484,3.852,9.566,10,10,1007
2009,6231,7906,15634,1601383,1590296,827,5.297,782,5.009,133962,47171,86791,2.966,8.424,110734,41707,69027,2.623,6.963,23228,1.461,13.926,409,446,26651
2009,6232,8713,32972,633818,626345,1747,5.296,1775,5.381,82337,16912,65425,2.7,13.146,67650,22708,44942,3.625,10.801,14687,2.345,21.602,401,450,10482
2009,6233,14363,20290,792835,783780,1737,8.633,1397,6.943,80943,23766,57177,3.032,10.327,61227,24785,36442,3.162,7.812,19716,2.516,15.624,1004,1029,18031
2009,6239,3485,5879,147920,149461,416,7.093,388,6.616,15320,3906,11414,2.613,10.25,18509,6647,11862,4.447,12.384,-3189,-2.134,20.5,207,222,4349
2009,6241,40672,56755,1278304,1259352,4912,8.745,3746,6.669,171326,37081,134245,2.944,13.604,133598,38375,95223,3.047,10.608,37728,2.996,21.217,2426,2465,28715
2009,6242,10182,13691,172460,170742,652,4.773,593,4.341,19937,4505,15432,2.638,11.677,16411,3870,12541,2.267,9.612,3526,2.065,19.223,281,310,2039
2009,6243,4238,7449,327508,327966,411,5.509,435,5.83,43254,9156,34098,2.792,13.189,43731,7405,36326,2.258,13.334,-477,-0.145,26.377,183,196,2766
2009,6244,55478,70476,870959,877575,7487,10.699,6497,9.284,114627,47652,66975,5.43,13.062,127235,44589,82646,5.081,14.498,-12608,-1.437,26.124,4836,4897,31727
2009,7111,7086,7217,119770,124144,763,10.471,902,12.379,16704,4270,12434,3.44,13.455,25614,7041,18573,5.672,20.632,-8910,-7.177,26.911,635,638,5196
2009,7112,3289,3470,123388,124319,470,13.318,588,16.662,15296,4040,11256,3.25,12.304,17179,4250,12929,3.419,13.818,-1883,-1.515,24.608,454,456,3184
2009,7113,5275,5604,126192,128898,592,10.525,633,11.254,15956,4268,11688,3.311,12.379,21510,3607,17903,2.798,16.688,-5554,-4.309,24.758,461,466,2713
2009,7114,2731,2827,18578,18677,438,15.463,449,15.852,3361,1466,1895,7.849,17.995,3540,1215,2325,6.505,18.954,-179,-0.958,35.991,323,323,978
2009,7115,13241,13275,41646,42725,2445,18.252,2686,20.052,11482,5340,6142,12.499,26.875,13675,5693,7982,13.325,32.007,-2193,-5.133,53.749,1613,1615,3656
2009,7121,6295,6784,128656,131114,330,4.86,341,5.022,8627,1687,6940,1.287,6.58,13315,1311,12004,1,10.155,-4688,-3.576,13.16,219,220,938
2009,7131,2098,2528,138957,140625,385,15.11,425,16.68,14755,4505,10250,3.204,10.492,18226,4171,14055,2.966,12.961,-3471,-2.468,20.985,319,321,3262
2009,7132,1703,2397,172368,171894,274,11.573,215,9.081,19304,5701,13603,3.317,11.23,18198,3188,15010,1.855,10.587,1106,0.643,21.174,163,164,1963
2009,7139,49473,56036,1141749,1159384,5759,10.196,6658,11.787,139101,51075,88026,4.405,11.998,175429,52207,123222,4.503,15.131,-36328,-3.133,23.996,5200,5241,40641
2009,7211,38332,48869,1796168,1863717,4810,9.893,4309,8.863,172031,93456,78575,5.014,9.231,307959,71034,236925,3.811,16.524,-135928,-7.293,18.461,3035,3077,43579
2009,7212,5158,5708,37634,38478,443,7.69,549,9.53,5214,1416,3798,3.68,13.551,6968,1752,5216,4.553,18.109,-1754,-4.558,27.101,323,326,1206
2009,7213,1905,1978,10389,10578,119,5.929,177,8.819,1374,389,985,3.677,12.989,1762,706,1056,6.674,16.657,-388,-3.668,25.978,126,132,604
2009,7223,11947,35079,642797,650397,4866,13.926,4592,13.142,143637,59841,83796,9.201,22.085,158241,55520,102721,8.536,24.33,-14604,-2.245,44.169,1693,1713,10635
2009,7224,39898,40586,347184,352278,4183,10.176,5223,12.706,65306,31823,33483,9.034,18.538,75844,30816,45028,8.748,21.53,-10538,-2.991,37.076,4300,4307,26078
2009,7225,323006,447685,8609375,8769643,51447,11.515,49633,11.109,1226003,661511,564492,7.543,13.98,1545381,521139,1024242,5.943,17.622,-319378,-3.642,27.96,39226,40366,381666
2009,8111,134202,146867,804816,835428,11640,7.817,15705,10.547,102404,41310,61094,4.945,12.258,163888,52488,111400,6.283,19.617,-61484,-7.36,24.515,11369,11592,39027
2009,8112,10104,11456,117930,121512,1189,10.258,1460,12.595,16679,6107,10572,5.026,13.726,23988,8852,15136,7.285,19.741,-7309,-6.015,27.452,961,972,3892
2009,8113,18956,20516,192169,197364,1538,7.37,2240,10.735,24108,8319,15789,4.215,12.215,34528,9251,25277,4.687,17.495,-10420,-5.28,24.43,1581,1584,5889
2009,8114,17069,17869,73946,78278,1812,9.888,2726,14.875,11403,4531,6872,5.788,14.567,19900,7671,12229,9.8,25.422,-8497,-10.855,29.135,1872,1874,4343
2009,8121,85781,101956,619114,628137,12455,12.226,12294,12.068,94025,46510,47515,7.404,14.969,111422,45601,65821,7.26,17.738,-17397,-2.77,29.938,9763,9944,37830
2009,8122,14551,19893,134515,134954,765,3.844,784,3.939,14443,3241,11202,2.402,10.702,15237,2673,12564,1.981,11.291,-794,-0.588,21.404,483,495,1820
2009,8123,29794,35240,315736,322982,3112,8.693,4233,11.824,43256,15667,27589,4.851,13.393,58261,20722,37539,6.416,18.038,-15005,-4.646,26.785,2959,3353,16048
2009,8129,21407,31858,246060,253514,3963,12.333,4511,14.039,46237,18236,28001,7.193,18.238,60081,28021,32060,11.053,23.699,-13844,-5.461,36.477,2446,2545,10118
2009,8131,173003,173350,1690739,1696787,8322,4.815,7305,4.226,144965,24130,120835,1.422,8.544,156795,20655,136140,1.217,9.241,-11830,-0.697,17.087,4751,4752,13661
2009,8132,14498,16498,169961,181131,1228,7.512,928,5.677,18713,3699,15014,2.042,10.331,42564,2913,39651,1.608,23.499,-23851,-13.168,20.662,655,657,2051
2009,8133,12751,15108,139752,138788,1245,8.324,942,6.298,19039,4164,14875,3,13.718,17262,3211,14051,2.314,12.438,1777,1.28,24.875,557,560,2279
2009,8134,24440,26268,244778,248123,1231,4.671,1402,5.32,27454,5994,21460,2.416,11.065,34167,7081,27086,2.854,13.77,-6713,-2.706,22.129,941,949,5106
2009,8139,55754,57959,507130,512752,2703,4.649,3061,5.265,53345,10561,42784,2.06,10.404,64725,13617,51108,2.656,12.623,-11380,-2.219,20.807,2142,2143,10052
2010,1131,313,325,2061,2095,36,11.18,30,9.317,189,98,91,4.679,9.024,263,72,191,3.438,12.557,-74,-3.533,18.047,16,16,37
2010,1132,120,137,1482,1541,16,11.765,14,10.294,356,49,307,3.18,23.102,460,137,323,8.89,29.851,-104,-6.749,46.204,6,6,66
2010,1133,7230,7328,49970,49477,680,9.116,943,12.642,8645,2208,6437,4.463,17.473,7687,2733,4954,5.524,15.537,958,1.936,31.073,629,632,1928
2010,1141,1179,1190,6038,5761,203,17.306,169,14.408,1471,549,922,9.53,25.534,939,511,428,8.87,16.299,532,9.235,32.599,94,94,232
2010,1142,235,235,1499,1480,22,9.11,35,14.493,279,56,223,3.784,18.851,244,108,136,7.297,16.486,35,2.365,32.973,25,25,82
2010,1151,3323,3671,61055,59695,393,10.71,390,10.628,11526,3163,8363,5.299,19.308,8761,2974,5787,4.982,14.676,2765,4.632,29.353,259,259,2438
2010,1152,3646,3740,18853,19062,447,12.037,394,10.61,2438,1089,1349,5.713,12.79,2891,922,1969,4.837,15.167,-453,-2.377,25.58,290,290,691
2010,1153,1205,1300,10442,10510,153,11.662,177,13.491,1994,578,1416,5.5,18.973,2145,474,1671,4.51,20.41,-151,-1.437,37.947,90,90,252
2010,2111,5748,7037,108241,107839,591,8.378,626,8.874,13991,5079,8912,4.71,12.974,13305,4732,8573,4.388,12.338,686,0.636,24.676,400,404,2050
2010,2121,556,972,81107,82154,80,7.964,145,14.435,11457,2939,8518,3.577,13.946,13691,3962,9729,4.823,16.665,-2234,-2.719,27.892,90,95,1741
2010,2122,207,269,32068,33193,46,17.358,38,14.34,2244,785,1459,2.365,6.761,4612,193,4419,0.581,13.895,-2368,-7.134,13.521,27,27,116
2010,2123,2916,4956,79377,81063,322,6.432,423,8.449,10132,3129,7003,3.86,12.499,13365,3062,10303,3.777,16.487,-3233,-3.988,24.998,184,184,874
2010,2131,9127,11400,286474,292979,1287,11.242,1383,12.081,49782,20321,29461,6.936,16.992,62714,14885,47829,5.081,21.406,-12932,-4.414,33.983,875,877,7379
2010,2211,1626,10192,513559,513534,690,6.882,359,3.581,31907,10584,21323,2.061,6.213,31571,7271,24300,1.416,6.148,336,0.065,12.296,49,51,569
2010,2212,429,2426,84874,85192,164,6.891,72,3.025,5873,2559,3314,3.004,6.894,6544,1744,4800,2.047,7.682,-671,-0.788,13.788,16,16,144
2010,2213,3434,4605,41980,42180,261,5.694,219,4.777,3681,1702,1979,4.035,8.727,4156,878,3278,2.082,9.853,-475,-1.126,17.454,115,115,556
2010,2361,125221,126529,575825,605356,21755,16.511,32214,24.449,135665,63637,72028,10.512,22.411,194843,85954,108889,14.199,32.187,-59178,-9.776,44.822,20764,20795,57088
2010,2362,35658,37179,570162,606750,3552,9.309,5507,14.433,87721,30697,57024,5.059,14.458,161667,27655,134012,4.558,26.645,-73946,-12.187,28.915,3638,3642,18535
2010,2371,16587,17824,470225,488772,1391,7.638,2168,11.904,71702,20178,51524,4.128,14.67,109282,18667,90615,3.819,22.359,-37580,-7.689,29.34,1350,1358,9491
2010,2372,6538,6617,39817,44842,576,8.054,1646,23.015,6020,2231,3789,4.975,13.425,16330,7151,9179,15.947,36.417,-10310,-22.992,26.85,1308,1315,5963
2010,2373,8868,9697,269434,274789,663,6.746,926,9.422,36799,6197,30602,2.255,13.392,47542,6415,41127,2.335,17.301,-10743,-3.91,26.784,597,597,4251
2010,2379,3635,3792,62148,63370,442,11.472,564,14.638,12650,3630,9020,5.728,19.962,15306,2294,13012,3.62,24.153,-2656,-4.191,39.924,334,335,1410
2010,2381,73602,74449,690119,749124,9583,12.357,15786,20.356,131909,41344,90565,5.519,17.608,250034,65038,184996,8.682,33.377,-118125,-15.768,35.217,9686,9701,41345
2010,2382,150246,154178,1611317,1691069,13319,8.466,19609,12.464,217898,57611,160287,3.407,12.885,377754,79270,298484,4.688,22.338,-159856,-9.453,25.77,13136,13151,54498
2010,2383,89201,90196,625622,670388,11848,12.61,19367,20.613,118119,39168,78951,5.843,17.619,207633,59710,147923,8.907,30.972,-89514,-13.353,35.239,12498,12510,41456
2010,2389,50621,51333,436596,452009,6561,12.377,9910,18.695,84677,24743,59934,5.474,18.733,115761,35906,79855,7.944,25.61,-31084,-6.877,37.467,6223,6238,23222
2010,3111,1084,1668,50028,50246,79,4.75,69,4.149,3609,597,3012,1.188,7.183,3983,1073,2910,2.135,7.927,-374,-0.744,14.365,38,38,386
2010,3112,428,767,54771,55091,40,5.229,36,4.706,2754,430,2324,0.781,4.999,3402,649,2753,1.178,6.175,-648,-1.176,9.998,18,18,227
2010,3113,1437,1576,66175,65591,128,8.122,128,8.122,6251,1252,4999,1.909,9.53,5114,1649,3465,2.514,7.797,1137,1.733,15.594,87,87,469
2010,3114,1224,1585,158776,159307,119,7.594,83,5.297,11832,3156,8676,1.981,7.427,12824,2241,10583,1.407,8.05,-992,-0.623,14.854,52,52,758
2010,3115,985,1487,136965,137607,87,5.87,77,5.196,8885,1349,7536,0.98,6.457,10240,4121,6119,2.995,7.442,-1355,-0.985,12.914,47,47,587
2010,3116,2817,3411,491913,495002,174,5.095,182,5.329,23497,3480,20017,0.703,4.747,29184,10901,18283,2.202,5.896,-5687,-1.149,9.494,109,110,1436
2010,3117,471,562,31515,31192,35,6.157,48,8.443,4121,952,3169,3.052,13.212,3513,1147,2366,3.677,11.263,608,1.949,22.525,32,32,552
2010,3118,8522,9241,274387,273142,831,9.02,775,8.412,26588,7950,18638,2.911,9.734,23819,6041,17778,2.212,8.72,2769,1.014,17.441,597,600,3348
2010,3119,2514,2959,163269,162582,227,7.698,207,7.019,14036,2631,11405,1.618,8.633,12643,3735,8908,2.297,7.776,1393,0.857,15.553,149,149,1859
2010,3121,3232,3805,125456,125955,418,11.238,247,6.641,10239,2799,7440,2.222,8.129,11318,2201,9117,1.747,8.986,-1079,-0.857,16.258,172,172,1037
2010,3122,77,102,14073,15601,14,14.286,6,6.122,459,73,386,0.468,2.942,3473,1836,1637,11.768,22.261,-3014,-19.319,5.884,(D),(D),(D)
2010,3131,238,314,27541,29047,11,3.349,40,12.177,1441,281,1160,0.967,4.961,4298,2453,1845,8.445,14.797,-2857,-9.836,9.922,17,17,244
2010,3132,891,997,51536,54156,55,5.358,114,11.106,3656,803,2853,1.483,6.751,8925,2612,6313,4.823,16.48,-5269,-9.729,13.502,82,85,919
2010,3133,1009,1054,30519,31765,87,8.135,118,11.033,3385,1063,2322,3.346,10.656,5705,2195,3510,6.91,17.96,-2320,-7.304,21.313,84,84,755
2010,3141,1792,1907,54363,56491,110,5.564,250,12.645,4404,825,3579,1.46,7.796,8507,1980,6527,3.505,15.059,-4103,-7.263,15.592,179,179,726
2010,3149,3816,3924,57670,58648,343,8.563,506,12.633,6994,2154,4840,3.673,11.925,8943,2496,6447,4.256,15.249,-1949,-3.323,23.851,382,382,1559
2010,3151,273,289,14210,14846,19,6.355,39,13.043,1235,294,941,1.98,8.319,2439,943,1496,6.352,16.429,-1204,-8.11,16.637,31,32,468
2010,3152,5005,5065,94203,97014,759,14.544,1066,20.427,18284,6308,11976,6.502,18.847,23928,10310,13618,10.627,24.664,-5644,-5.818,37.694,914,918,8396
2010,3159,586,601,9641,10172,47,7.624,78,12.652,865,178,687,1.75,8.504,1926,533,1393,5.24,18.935,-1061,-10.431,17.008,58,58,305
2010,3161,176,181,3498,3504,10,5.291,26,13.757,275,27,248,0.771,7.849,297,88,209,2.512,8.477,-22,-0.628,15.699,21,21,77
2010,3162,180,202,11068,11565,11,5.288,23,11.058,467,44,423,0.38,4.038,1435,88,1347,0.761,12.409,-968,-8.37,8.076,15,15,56
2010,3169,684,692,12259,12950,59,8.441,73,10.443,1013,170,843,1.313,7.823,2334,610,1724,4.711,18.024,-1321,-10.201,15.645,52,52,276
2010,3211,2901,3312,78356,80640,208,6.137,363,10.71,7426,2091,5335,2.593,9.209,12061,4295,7766,5.326,14.957,-4635,-5.748,18.418,237,237,1904
2010,3212,1224,1537,64452,68305,56,3.489,192,11.963,6526,1553,4973,2.274,9.554,14078,3998,10080,5.853,20.61,-7552,-11.056,19.108,123,125,1938
2010,3219,7932,8856,209658,220195,542,5.925,1126,12.309,21182,6163,15019,2.799,9.62,42093,12937,29156,5.875,19.116,-20911,-9.497,19.239,740,746,5893
2010,3221,232,446,111350,113746,25,5.543,35,7.761,3269,1159,2110,1.019,2.874,8140,2924,5216,2.571,7.156,-4871,-4.282,5.748,18,18,219
2010,3222,2706,4045,254793,259492,138,3.376,223,5.456,14978,2531,12447,0.975,5.772,24522,6650,17872,2.563,9.45,-9544,-3.678,11.544,136,136,1609
2010,3231,26324,27682,499901,525574,1389,4.886,2885,10.148,33108,10565,22543,2.01,6.299,84697,27215,57482,5.178,16.115,-51589,-9.816,12.599,2304,2310,15921
2010,3241,996,2164,99685,101253,162,7.505,151,6.996,6165,2631,3534,2.598,6.089,9491,2907,6584,2.871,9.374,-3326,-3.285,12.177,53,54,338
2010,3251,1333,2378,147801,149371,116,4.855,139,5.817,9335,2466,6869,1.651,6.25,12399,2217,10182,1.484,8.301,-3064,-2.051,12.499,79,79,1115
2010,3252,975,1281,86025,87196,55,4.272,68,5.282,6628,1628,5000,1.867,7.601,8970,1331,7639,1.526,10.287,-2342,-2.686,15.203,37,40,667
2010,3253,602,831,28706,28958,49,5.886,52,6.246,2372,431,1941,1.488,8.191,2966,733,2233,2.531,10.243,-594,-2.051,16.383,35,35,220
2010,3254,1441,1854,232367,234466,135,7.284,134,7.23,16178,4786,11392,2.041,6.9,20263,3538,16725,1.509,8.642,-4085,-1.742,13.8,75,75,917
2010,3255,1333,1678,51833,53538,72,4.212,135,7.897,3386,761,2625,1.421,6.325,6817,1665,5152,3.11,12.733,-3431,-6.409,12.649,84,84,422
2010,3256,1873,2066,91922,93647,142,6.893,130,6.311,9070,3895,5175,4.159,9.685,12252,3609,8643,3.854,13.083,-3182,-3.398,19.371,88,88,1111
2010,3259,1849,2379,85725,88107,133,5.524,190,7.892,6381,1290,5091,1.464,7.242,11164,3039,8125,3.449,12.671,-4783,-5.429,14.485,124,127,1220
2010,3261,8321,10607,549078,556040,435,4.04,757,7.03,49124,11238,37886,2.021,8.835,63348,20098,43250,3.614,11.393,-14224,-2.558,17.669,479,485,7464
2010,3262,1495,1927,118282,122034,79,4.029,147,7.496,8080,1759,6321,1.441,6.621,15621,5775,9846,4.732,12.801,-7541,-6.179,13.242,77,79,888
2010,3271,1035,1223,33948,34668,85,6.803,138,11.044,2929,729,2200,2.103,8.449,4294,857,3437,2.472,12.386,-1365,-3.937,16.897,98,98,411
2010,3272,1420,1696,80127,85482,111,6.388,194,11.165,3711,577,3134,0.675,4.341,14831,4193,10638,4.905,17.35,-11120,-13.009,8.683,128,128,881
2010,3273,4372,8941,154257,163840,372,4.101,634,6.989,14885,3794,11091,2.316,9.085,33945,6747,27198,4.118,20.718,-19060,-11.633,18.17,229,234,2302
2010,3274,179,309,13029,13484,20,6.452,22,7.097,1068,527,541,3.908,7.92,1979,381,1598,2.826,14.677,-911,-6.756,15.841,12,12,45
2010,3279,2557,2997,62745,65308,170,5.515,341,11.062,5133,1348,3785,2.064,7.86,10363,2735,7628,4.188,15.868,-5230,-8.008,15.719,238,240,1312
2010,3311,368,498,97671,100471,47,9.325,59,11.706,4486,1217,3269,1.211,4.465,10103,1244,8859,1.238,10.056,-5617,-5.591,8.93,45,45,252
2010,3312,472,600,35784,36919,34,5.592,50,8.224,2550,384,2166,1.04,6.907,4768,961,3807,2.603,12.915,-2218,-6.008,13.814,29,29,467
2010,3313,402,525,49550,50872,17,3.145,48,8.881,3607,555,3052,1.091,7.09,6303,1214,5089,2.386,12.39,-2696,-5.3,14.181,29,29,360
2010,3314,723,918,55947,57368,60,6.508,68,7.375,3940,839,3101,1.463,6.868,6837,1642,5195,2.862,11.918,-2897,-5.05,13.736,42,42,612
2010,3315,1640,1846,111042,118354,56,2.965,142,7.517,6679,969,5710,0.819,5.643,21154,5145,16009,4.347,17.873,-14475,-12.23,11.286,86,87,2369
2010,3321,2271,2512,102750,106487,66,2.575,168,6.555,7524,1450,6074,1.362,7.066,15018,3484,11534,3.272,14.103,-7494,-7.037,14.131,105,106,1498
2010,3322,1203,1301,39067,40545,65,4.917,107,8.094,3494,764,2730,1.884,8.618,6442,1179,5263,2.908,15.889,-2948,-7.271,17.235,63,63,418
2010,3323,11444,12448,310065,331780,539,4.213,1229,9.607,22824,5120,17704,1.543,6.879,66268,13947,52321,4.204,19.974,-43444,-13.094,13.759,822,827,6480
2010,3324,1128,1428,81427,84316,69,4.785,97,6.727,6266,2920,3346,3.463,7.432,11998,2622,9376,3.11,14.23,-5732,-6.798,14.863,67,67,646
2010,3325,568,632,27380,29295,29,4.482,59,9.119,1032,136,896,0.464,3.523,4854,1064,3790,3.632,16.569,-3822,-13.047,7.046,39,39,208
2010,3326,1191,1348,38929,39921,50,3.64,101,7.353,3183,752,2431,1.884,7.973,5268,955,4313,2.392,13.196,-2085,-5.223,15.946,70,71,456
2010,3327,21537,21950,325914,339547,917,4.078,1986,8.833,27909,6014,21895,1.771,8.219,55214,12449,42765,3.666,16.261,-27305,-8.042,16.439,1303,1305,7383
2010,3328,5005,5490,109627,114123,203,3.627,418,7.468,9103,1824,7279,1.598,7.977,18067,4323,13744,3.788,15.831,-8964,-7.855,15.953,303,304,2644
2010,3329,5570,6113,244956,253419,314,5.045,535,8.596,18075,3751,14324,1.48,7.132,35158,7240,27918,2.857,13.873,-17083,-6.741,14.265,369,369,3474
2010,3331,2402,2726,173133,186008,138,4.986,222,8.02,8073,2386,5687,1.283,4.34,33823,6269,27554,3.37,18.184,-25750,-13.843,8.68,158,159,1879
2010,3332,3144,3313,98525,104728,161,4.758,303,8.954,7246,1867,5379,1.783,6.919,19563,4197,15366,4.008,18.68,-12317,-11.761,13.838,211,211,2165
2010,3333,1782,1914,73487,76139,107,5.506,166,8.541,5224,1226,3998,1.61,6.861,10467,2714,7753,3.565,13.747,-5243,-6.886,13.722,105,105,617
2010,3334,1463,1729,118321,125320,96,5.516,119,6.837,10196,3372,6824,2.691,8.136,23791,5559,18232,4.436,18.984,-13595,-10.848,16.272,68,69,2033
2010,3335,6519,6723,129948,136515,253,3.668,602,8.728,10497,2810,7687,2.058,7.689,23721,4939,18782,3.618,17.376,-13224,-9.687,15.379,420,421,3046
2010,3336,806,985,91157,96819,46,4.649,55,5.558,4875,1737,3138,1.794,5.035,15999,2017,13982,2.083,16.525,-11124,-11.489,10.07,30,30,343
2010,3339,5122,5761,246410,257237,267,4.581,402,6.897,13756,3327,10429,1.293,5.348,35193,4167,31026,1.62,13.681,-21437,-8.334,10.695,261,262,2034
2010,3341,970,1019,69664,75499,90,8.708,119,11.514,6503,1647,4856,2.181,8.613,18845,4924,13921,6.522,24.961,-12342,-16.347,17.227,84,85,745
2010,3342,1261,1403,113259,126880,89,6.268,123,8.662,5544,2249,3295,1.773,4.37,31507,3340,28167,2.632,24.832,-25963,-20.463,8.739,75,75,960
2010,3343,423,427,8288,9991,51,11.888,55,12.821,599,292,307,2.923,5.995,4042,1881,2161,18.827,40.456,-3443,-34.461,11.991,32,33,273
2010,3344,3683,4146,280284,289662,228,5.436,324,7.725,23702,5132,18570,1.772,8.183,42373,11767,30606,4.062,14.628,-18671,-6.446,16.365,217,217,3164
2010,3345,4261,4942,386314,392713,305,6.133,368,7.399,27303,4892,22411,1.246,6.952,39701,9313,30388,2.371,10.109,-12398,-3.157,13.905,219,220,1732
2010,3346,540,560,19153,20130,57,9.879,91,15.771,1482,711,771,3.532,7.362,3396,1144,2252,5.683,16.871,-1914,-9.508,14.725,71,73,605
2010,3351,981,1066,45070,47491,73,6.772,97,8.998,2590,729,1861,1.535,5.454,7495,1115,6380,2.348,15.782,-4905,-10.328,10.907,69,69,511
2010,3352,227,269,44805,46540,21,7.623,34,12.341,2104,338,1766,0.726,4.521,5597,1823,3774,3.917,12.026,-3493,-7.505,9.042,22,22,138
2010,3353,1858,2158,111827,117982,80,3.651,146,6.664,5434,939,4495,0.796,4.606,17793,3933,13860,3.334,15.081,-12359,-10.475,9.212,82,82,479
2010,3359,1773,2061,125129,130816,126,6.075,152,7.329,8349,2110,6239,1.613,6.382,19755,6755,13000,5.164,15.101,-11406,-8.719,12.765,86,92,1233
2010,3361,270,332,131442,133764,43,12.991,41,12.387,15633,3125,12508,2.336,11.687,20008,4738,15270,3.542,14.958,-4375,-3.271,23.374,21,21,188
2010,3362,1580,1825,94147,94572,120,6.434,200,10.724,14555,3035,11520,3.209,15.39,15800,5908,9892,6.247,16.707,-1245,-1.316,30.781,133,135,2959
2010,3363,4018,4929,401963,416557,270,5.384,441,8.794,41980,10140,31840,2.434,10.078,71117,22268,48849,5.346,17.073,-29137,-6.995,20.156,268,278,6713
2010,3364,1210,1651,389452,395555,127,7.692,127,7.692,25913,3641,22272,0.92,6.551,39104,5137,33967,1.299,9.886,-13191,-3.335,13.102,78,79,1697
2010,3365,147,217,23913,25817,13,5.963,15,6.881,1767,770,997,2.983,6.844,5612,732,4880,2.835,21.738,-3845,-14.894,13.689,8,8,146
2010,3366,1330,1441,129534,133118,127,8.66,178,12.138,8214,2511,5703,1.886,6.17,15616,2858,12758,2.147,11.731,-7402,-5.561,12.341,135,136,1272
2010,3369,745,775,38455,41494,88,11.16,115,14.585,2358,540,1818,1.301,5.683,8417,1253,7164,3.02,20.285,-6059,-14.602,11.366,83,83,322
2010,3371,11322,11573,211139,223075,778,6.431,1828,15.11,17609,5130,12479,2.3,7.894,41517,13911,27606,6.236,18.611,-23908,-10.717,15.788,1315,1316,7426
2010,3372,3472,3654,100876,108212,173,4.588,406,10.768,7906,1455,6451,1.345,7.306,22449,4967,17482,4.59,20.745,-14543,-13.439,14.612,301,304,2702
2010,3379,761,861,32311,33471,63,7.107,114,12.86,3092,664,2428,1.984,9.238,5430,2535,2895,7.574,16.223,-2338,-6.985,18.476,80,80,1061
2010,3391,10171,11049,285175,292364,685,6.157,839,7.541,22025,4765,17260,1.63,7.533,36534,12541,23993,4.29,12.496,-14509,-4.963,15.067,582,582,3593
2010,3399,14887,15302,271890,281567,1142,7.329,1700,10.911,22392,5613,16779,1.993,7.953,41699,11425,30274,4.058,14.81,-19307,-6.857,15.905,1297,1302,6980
2010,4231,16478,23893,349663,354849,1693,7.056,1895,7.898,33457,12025,21432,3.389,9.429,44184,13499,30685,3.804,12.451,-10727,-3.023,18.857,1239,1323,7355
2010,4232,9968,11651,135742,141194,850,7.146,1336,11.233,13727,4100,9627,2.904,9.722,24677,7740,16937,5.482,17.477,-10950,-7.755,19.444,997,1047,5561
2010,4233,10312,16841,196355,205537,1046,6.05,1940,11.222,20446,7030,13416,3.42,9.948,39036,12247,26789,5.959,18.992,-18590,-9.045,19.895,1062,1122,6013
2010,4234,22314,32387,670180,683501,2837,8.727,3076,9.463,86539,31406,55133,4.595,12.661,112785,28996,83789,4.242,16.501,-26246,-3.84,25.322,1708,1799,9874
2010,4235,7410,10263,139495,145768,528,5.08,790,7.601,10487,3197,7290,2.193,7.194,23034,5610,17424,3.849,15.802,-12547,-8.608,14.389,445,484,3163
2010,4236,17778,27557,495124,504849,2335,8.461,2417,8.758,53382,17307,36075,3.428,10.574,73056,21022,52034,4.164,14.471,-19674,-3.897,21.148,1431,1482,9476
2010,4237,9854,18379,202667,209504,894,4.81,1311,7.053,17287,5722,11565,2.731,8.251,31045,8257,22788,3.941,14.818,-13758,-6.567,16.503,611,651,3058
2010,4238,38964,55577,654048,679119,3166,5.645,4185,7.462,55634,19676,35958,2.897,8.192,105219,25954,79265,3.822,15.493,-49585,-7.301,16.384,2309,2406,12060
2010,4239,26397,29558,309824,313708,3101,10.481,3158,10.674,42892,14360,28532,4.578,13.673,50549,15979,34570,5.094,16.113,-7657,-2.441,27.345,2346,2379,11191
2010,4241,7789,10402,149681,152518,655,6.231,874,8.315,12663,4969,7694,3.258,8.303,18563,4856,13707,3.184,12.171,-5900,-3.868,16.605,538,559,2292
2010,4242,5598,8650,269440,271695,940,11.013,711,8.33,33734,11054,22680,4.069,12.416,39175,14992,24183,5.518,14.419,-5441,-2.003,24.832,460,469,2563
2010,4243,13021,14184,180579,184746,1624,11.361,1845,12.907,23564,7359,16205,3.983,12.755,32180,9444,22736,5.112,17.419,-8616,-4.664,25.51,1430,1462,6715
2010,4244,24107,30849,759020,762171,2453,7.944,2510,8.129,78446,18686,59760,2.452,10.292,83457,24890,58567,3.266,10.95,-5011,-0.657,20.585,1772,1790,13995
2010,4245,3348,5988,62778,61498,363,6.084,319,5.347,8797,2801,5996,4.555,14.305,6330,1770,4560,2.878,10.293,2467,4.012,20.586,161,174,973
2010,4246,7845,11896,138216,141099,752,6.299,835,6.995,12314,3672,8642,2.602,8.727,18103,4861,13242,3.445,12.83,-5789,-4.103,17.454,424,439,1962
2010,4247,4743,7037,106350,108969,327,4.621,406,5.737,8836,2007,6829,1.842,8.109,14252,2756,11496,2.529,13.079,-5416,-4.97,16.217,223,236,1297
2010,4248,3046,3981,175492,176161,340,8.598,287,7.258,12925,4136,8789,2.348,7.337,14451,4300,10151,2.441,8.203,-1526,-0.866,14.674,201,205,2702
2010,4249,20184,26199,323887,329224,2349,8.898,2749,10.413,39183,12266,26917,3.726,11.902,49173,15584,33589,4.734,14.936,-9990,-3.034,23.803,1869,1907,8282
2010,4251,39137,41350,297457,294174,4784,11.439,5729,13.698,66237,32322,33915,10.987,22.516,58057,21843,36214,7.425,19.736,8180,2.781,39.471,4156,4187,15493
2010,4411,37731,42467,1036187,1041697,3257,7.532,4804,11.11,111438,34117,77321,3.275,10.698,122222,53656,68566,5.151,11.733,-10784,-1.035,21.395,3745,3817,43040
2010,4412,12260,13813,121727,129266,977,6.874,1775,12.489,12349,4380,7969,3.388,9.553,27768,8569,19199,6.629,21.481,-15419,-11.928,19.106,1216,1271,6013
2010,4413,27520,54715,471442,467711,2899,5.298,2912,5.321,51990,16788,35202,3.589,11.116,45169,15124,30045,3.234,9.657,6821,1.458,19.315,1872,1952,6913
2010,4421,15039,23574,204660,210747,1614,6.699,2652,11.007,23080,9412,13668,4.466,10.952,35396,12572,22824,5.965,16.796,-12316,-5.844,21.903,1773,1969,9221
2010,4422,20282,28071,222013,226171,1723,5.958,3422,11.832,27922,8193,19729,3.622,12.346,36033,12585,23448,5.564,15.932,-8111,-3.586,24.691,2334,2498,8084
2010,4431,25362,46302,426525,446321,5292,11.231,6931,14.709,66395,28726,37669,6.436,14.876,102116,69015,33101,15.463,22.88,-35721,-8.003,29.752,3060,4451,58092
2010,4441,39654,62395,1061523,1065615,2546,4.014,4615,7.276,84380,17246,67134,1.618,7.918,94400,24571,69829,2.306,8.859,-10020,-0.94,15.837,2918,3040,12604
2010,4442,13767,17263,145463,147528,955,5.476,1309,7.506,16739,4971,11768,3.37,11.346,21000,5006,15994,3.393,14.235,-4261,-2.888,22.693,818,842,2891
2010,4451,57426,83452,2526387,2541688,8564,10.36,6986,8.451,203344,82337,121007,3.239,8,234173,56221,177952,2.212,9.213,-30829,-1.213,16.001,5147,5230,26787
2010,4452,16806,20732,142247,142273,2362,11.375,2426,11.684,25181,10750,14431,7.556,17.699,25169,9985,15184,7.018,17.691,12,0.008,35.381,1774,1804,6962
2010,4453,25641,29410,147611,147352,2545,8.718,2111,7.231,21164,8346,12818,5.664,14.363,20728,6584,14144,4.468,14.067,436,0.296,28.134,1620,1648,5193
2010,4461,39070,86088,991435,987046,5726,6.667,5311,6.184,97437,29776,67661,3.017,9.872,88050,26440,61610,2.679,8.921,9387,0.951,17.841,2868,3028,13540
2010,4471,61826,107791,853749,854726,7483,6.931,7818,7.242,115987,41798,74189,4.89,13.57,118023,42812,75211,5.009,13.808,-2036,-0.238,27.14,4861,5170,23753
2010,4481,32990,90920,1206674,1204522,7376,8.077,8184,8.961,176416,68699,107717,5.703,14.646,170615,57535,113080,4.777,14.165,5801,0.482,28.329,4368,5226,25433
2010,4482,5708,25469,196856,196198,1050,4.081,1567,6.091,23108,6766,16342,3.449,11.778,21628,6706,14922,3.418,11.024,1480,0.754,22.047,601,775,2187
2010,4483,16018,23167,127461,132305,1526,6.427,2680,11.287,16252,5268,10984,3.982,12.284,25832,12964,12868,9.799,19.525,-9580,-7.241,24.567,1276,1422,5382
2010,4511,25450,35364,402970,401139,2812,7.873,3521,9.858,52372,14654,37718,3.653,13.056,48215,14757,33458,3.679,12.02,4157,1.036,24.039,2495,2781,10491
2010,4512,4571,9572,121186,128652,567,5.763,1099,11.171,14584,3724,10860,2.895,11.336,29256,6520,22736,5.068,22.74,-14672,-11.404,22.672,561,585,2036
2010,4522,35,5079,606003,610375,83,1.629,113,2.218,28617,8469,20148,1.388,4.688,38214,6819,31395,1.117,6.261,-9597,-1.572,9.377,12,12,60
2010,4523,7078,39346,2184893,2240319,2285,5.87,1449,3.722,90369,34360,56009,1.534,4.034,198543,8803,189740,0.393,8.862,-108174,-4.829,8.068,907,944,3082
2010,4531,14376,15044,70342,72824,1033,6.653,1998,12.868,9636,3931,5705,5.398,13.232,14701,5217,9484,7.164,20.187,-5065,-6.955,26.464,1605,1641,4332
2010,4532,21373,32062,269297,273257,2276,6.928,3853,11.729,30554,8751,21803,3.202,11.181,38509,14085,24424,5.154,14.093,-7955,-2.911,22.363,2739,2949,9536
2010,4533,11550,16567,147404,144248,1729,10.554,1359,8.296,22206,9761,12445,6.767,15.394,16154,4179,11975,2.897,11.199,6052,4.196,22.398,1030,1050,2946
2010,4539,28115,36944,231105,234821,3663,9.827,4326,11.605,32271,14693,17578,6.257,13.743,39753,13324,26429,5.674,16.929,-7482,-3.186,27.486,3042,3153,9556
2010,4541,19154,20229,316614,317095,3090,15.484,2544,12.748,46884,17060,29824,5.38,14.785,48335,13864,34471,4.372,15.243,-1451,-0.458,29.571,1980,1994,9140
2010,4542,3587,4064,36588,37501,378,9.112,547,13.185,4408,2121,2287,5.656,11.754,6276,1812,4464,4.832,16.736,-1868,-4.981,23.509,399,423,1289
2010,4543,20986,26912,190788,194941,2003,7.369,2542,9.352,20545,6779,13766,3.477,10.539,28783,9994,18789,5.127,14.765,-8238,-4.226,21.078,1825,1859,7008
2010,4811,423,2631,384448,394600,219,8.056,394,14.493,40406,5156,35250,1.307,10.24,60946,31805,29141,8.06,15.445,-20540,-5.205,20.479,54,56,377
2010,4812,1924,2101,32552,33613,262,12.435,274,13.004,4203,2201,2002,6.548,12.504,6371,2427,3944,7.221,18.954,-2168,-6.45,25.009,200,206,859
2010,4831,671,1035,46230,47218,104,10.082,97,9.404,4484,1580,2904,3.346,9.496,6613,921,5692,1.951,14.005,-2129,-4.509,18.993,67,68,675
2010,4832,434,494,17196,18010,45,8.964,61,12.151,762,219,543,1.216,4.231,2417,564,1853,3.132,13.42,-1655,-9.189,8.462,42,42,404
2010,4841,43761,52882,843017,862262,7256,13.526,8784,16.374,105632,33902,71730,3.932,12.251,142380,43968,98412,5.099,16.512,-36748,-4.262,24.501,6182,6240,24603
2010,4842,36278,40408,420610,431182,4331,10.523,5829,14.163,59206,20393,38813,4.73,13.731,80072,24261,55811,5.627,18.57,-20866,-4.839,27.462,3910,3943,16039
2010,4851,550,787,47929,48044,67,8.407,87,10.916,5177,3111,2066,6.475,10.776,5430,2014,3416,4.192,11.302,-253,-0.527,21.551,58,58,356
2010,4852,192,375,12687,12157,35,9.198,46,12.089,3139,390,2749,3.208,25.822,1968,896,1072,7.371,16.189,1171,9.633,32.378,18,18,218
2010,4853,6020,6148,63823,64157,969,15.761,969,15.761,9573,4590,4983,7.154,14.921,10341,3830,6511,5.97,16.118,-768,-1.197,29.843,749,749,3094
2010,4854,2747,4319,212030,212761,274,6.302,332,7.636,20758,7521,13237,3.535,9.757,22504,6756,15748,3.175,10.577,-1746,-0.821,19.513,150,151,2245
2010,4855,1135,1250,29841,29644,125,9.988,128,10.228,3993,1151,2842,3.883,13.47,3590,964,2626,3.252,12.11,403,1.359,24.221,98,98,760
2010,4859,3086,3497,73247,71453,562,16.554,358,10.545,11923,4809,7114,6.73,16.687,8409,3245,5164,4.541,11.769,3514,4.918,23.537,272,276,2263
2010,4861,53,429,7913,7837,57,13.768,27,6.522,1354,420,934,5.36,17.278,1192,571,621,7.286,15.211,162,2.067,30.422,(D),(D),(D)
2010,4862,117,1844,29617,29252,138,7.624,70,3.867,5612,641,4971,2.191,19.185,4913,499,4414,1.706,16.795,699,2.39,33.591,8,8,51
2010,4869,57,718,7768,8066,29,3.984,49,6.731,1423,127,1296,1.575,17.642,1981,328,1653,4.066,24.56,-558,-6.918,35.284,4,4,49
2010,4871,472,510,8732,8822,73,14.3,74,14.496,1220,325,895,3.684,13.83,1417,623,794,7.062,16.063,-197,-2.233,27.66,52,52,368
2010,4872,1111,1155,9978,10189,153,12.994,198,16.815,1595,499,1096,4.898,15.655,2052,586,1466,5.752,20.14,-457,-4.485,31.31,120,120,368
2010,4879,141,153,1939,2070,23,15.333,17,11.333,305,105,200,5.072,14.734,587,429,158,20.725,28.357,-282,-13.623,29.469,8,8,359
2010,4881,3740,5409,161044,163668,572,10.597,550,10.189,23149,11668,11481,7.129,14.144,28274,8230,20044,5.028,17.275,-5125,-3.131,28.288,294,306,2482
2010,4882,467,1123,26070,26194,142,12.921,94,8.553,3882,2142,1740,8.178,14.82,4226,1179,3047,4.501,16.134,-344,-1.313,29.641,37,38,324
2010,4883,1644,2191,84189,84382,175,8,168,7.68,9684,2275,7409,2.696,11.476,10068,1501,8567,1.779,11.932,-384,-0.455,22.953,109,110,667
2010,4884,8415,9241,73205,74344,1173,12.787,1038,11.315,12512,5407,7105,7.273,16.83,14881,6226,8655,8.375,20.017,-2369,-3.187,33.66,772,776,4200
2010,4885,13170,19298,216265,222168,1860,9.574,2121,10.917,28227,9978,18249,4.491,12.705,40098,11823,28275,5.322,18.049,-11871,-5.343,25.411,1176,1251,5968
2010,4889,1174,1296,23935,24333,152,11.625,175,13.384,2408,989,1419,4.065,9.896,3221,1080,2141,4.439,13.237,-813,-3.341,19.792,135,135,598
2010,4921,3154,8192,487085,501078,687,8.135,1192,14.116,22461,5937,16524,1.185,4.483,50053,16258,33795,3.245,9.989,-27592,-5.507,8.965,440,465,3067
2010,4922,3676,3940,30124,30873,502,12.604,588,14.763,5481,2302,3179,7.456,17.753,7001,2351,4650,7.615,22.677,-1520,-4.923,35.507,470,479,2007
2010,4931,6851,14140,669252,676583,1101,7.763,1188,8.376,75757,25873,49884,3.824,11.197,89560,23504,66056,3.474,13.237,-13803,-2.04,22.394,416,450,5619
2010,5111,13412,19399,536974,560978,1295,6.553,2022,10.231,40995,13424,27571,2.393,7.308,88789,19065,69724,3.399,15.828,-47794,-8.52,14.616,1193,1217,7368
2010,5112,5059,7347,374919,376474,640,8.6,829,11.14,41982,20776,21206,5.519,11.151,45423,17463,27960,4.639,12.065,-3441,-0.914,22.303,367,393,5024
2010,5121,12377,15767,294555,299651,2117,13.33,2346,14.772,36465,13663,22802,4.56,12.169,46751,12862,33889,4.292,15.602,-10286,-3.433,24.338,1452,1481,6597
2010,5122,2781,3072,23191,23439,429,14.01,409,13.357,4112,2562,1550,10.931,17.544,4736,1355,3381,5.781,20.206,-624,-2.662,35.088,281,282,903
2010,5151,4103,8960,219832,224660,699,7.911,451,5.104,16147,6150,9997,2.737,7.187,25215,6768,18447,3.013,11.224,-9068,-4.036,14.375,253,256,3434
2010,5152,400,691,42828,42633,75,10.909,68,9.891,6399,2969,3430,6.964,15.009,5861,1148,4713,2.693,13.748,538,1.262,27.495,35,35,218
2010,5173,4221,45154,1092608,1104482,4503,10.013,4140,9.206,108008,47644,60364,4.314,9.779,132684,31822,100862,2.881,12.013,-24676,-2.234,19.558,386,404,3162
2010,5174,389,507,7621,7892,87,17.245,82,16.254,1305,769,536,9.744,16.536,1840,1100,740,13.938,23.315,-535,-6.779,33.071,53,53,334
2010,5179,3924,4376,52428,53954,624,13.939,825,18.43,8771,3078,5693,5.705,16.257,11866,4015,7851,7.442,21.993,-3095,-5.736,32.513,659,668,2711
2010,5182,7914,12056,394586,397729,1491,12.405,1418,11.797,76918,26215,50703,6.591,19.339,82747,25003,57744,6.286,20.805,-5829,-1.466,38.679,690,709,6800
2010,5191,6242,7819,138281,140178,1308,17.136,936,12.263,29008,15110,13898,10.779,20.694,32673,6739,25934,4.807,23.308,-3665,-2.615,41.387,639,640,2813
2010,5211,12,47,18192,18484,(D),(D),(D),(D),343,(D),338,(D),1.856,933,(D),874,(D),5.048,-590,-3.192,3.711,(D),(D),(D)
2010,5221,14005,125058,1988102,2012886,5323,4.225,7208,5.721,208169,48651,159518,2.417,10.342,255747,73143,182604,3.634,12.705,-47578,-2.364,20.684,378,730,10304
2010,5222,13969,39872,523146,540979,4618,11.377,6052,14.91,104994,50790,54204,9.389,19.408,139732,47247,92485,8.734,25.829,-34738,-6.421,38.816,1827,2124,12084
2010,5223,14023,30954,258854,266779,2697,8.274,5984,18.357,39569,15191,24378,5.694,14.832,55472,24266,31206,9.096,20.793,-15903,-5.961,29.664,3615,3901,15589
2010,5231,11581,42711,445827,466706,6055,14.296,5340,12.608,77129,26484,50645,5.675,16.526,117052,23936,93116,5.129,25.08,-39923,-8.554,33.052,972,1021,3601
2010,5232,16,75,4957,5193,(D),(D),16,20.645,172,(D),104,(D),3.312,628,45,583,0.867,12.094,-456,-8.782,6.625,8,8,16
2010,5239,37639,43387,439931,436167,5945,13.814,5241,12.178,84720,45540,39180,10.441,19.424,76611,28332,48279,6.496,17.565,8109,1.859,35.129,3572,3616,13591
2010,5241,5460,31557,1428527,1456124,4347,13.506,5604,17.412,152350,65196,87154,4.477,10.463,208194,60222,147972,4.136,14.298,-55844,-3.835,20.925,462,525,2998
2010,5242,118807,133384,853541,864250,10599,7.923,11368,8.498,107377,39866,67511,4.613,12.424,129605,45966,83639,5.319,14.996,-22228,-2.572,24.849,7683,7761,21700
2010,5259,614,629,6326,6127,134,20.889,159,24.786,1389,888,501,14.494,22.672,968,518,450,8.455,15.8,421,6.872,31.6,125,125,349
2010,5311,82580,105252,513979,513957,9521,9.09,8495,8.111,78982,39222,39760,7.631,15.367,78936,27982,50954,5.444,15.358,46,0.009,30.717,6045,6116,18162
2010,5312,59414,69753,274690,282741,11500,16.373,12466,17.749,57418,30631,26787,10.834,20.308,72747,34939,37808,12.357,25.729,-15329,-5.422,40.615,7805,7975,16608
2010,5313,59375,73206,609747,614579,9545,13.142,8395,11.558,91716,42977,48739,6.993,14.923,100775,38867,61908,6.324,16.397,-9059,-1.474,29.847,5353,5413,20995
2010,5321,3665,10449,147864,157332,1135,9.8,3400,29.357,17395,9022,8373,5.734,11.056,37143,26258,10885,16.69,23.608,-19748,-12.552,22.113,448,466,1726
2010,5322,8746,25935,193613,200667,1352,5.007,3491,12.927,23893,6610,17283,3.294,11.907,38146,18472,19674,9.205,19.01,-14253,-7.103,23.814,1207,1300,5675
2010,5323,2582,3993,24608,25156,176,4.357,269,6.659,2067,709,1358,2.818,8.217,3139,964,2175,3.832,12.478,-1072,-4.261,16.433,162,166,529
2010,5324,7089,12720,142710,148580,961,7.449,1324,10.262,16800,5841,10959,3.931,11.307,28742,7499,21243,5.047,19.345,-11942,-8.037,22.614,641,651,3248
2010,5331,1983,2067,28617,30259,236,11.379,250,12.054,4091,1554,2537,5.136,13.52,7233,3985,3248,13.17,23.904,-3142,-10.384,27.04,175,175,1511
2010,5411,161051,170942,1149014,1159521,13835,8.114,12957,7.599,120883,46202,74681,3.985,10.425,142624,37175,105449,3.206,12.3,-21741,-1.875,20.851,9304,9385,26192
2010,5412,97362,112894,1271185,1279093,11604,10.342,10228,9.115,204392,83390,121002,6.519,15.979,220965,68481,152484,5.354,17.275,-16573,-1.296,31.959,5915,5970,33872
2010,5413,80349,96740,1287080,1319080,9299,9.476,12091,12.321,162984,58871,104113,4.463,12.356,226533,57040,169493,4.324,17.174,-63549,-4.818,24.712,7079,7191,26019
2010,5414,24495,24757,104583,109771,3120,12.209,4714,18.447,15014,6952,8062,6.333,13.678,25316,10678,14638,9.728,23.063,-10302,-9.385,27.355,3254,3258,7692
2010,5415,86081,103143,1424843,1402459,17749,17.325,16362,15.971,286664,108059,178605,7.705,20.44,240103,99008,141095,7.06,17.12,46561,3.32,34.24,9886,10043,36963
2010,5416,103543,111217,865684,860228,20521,18.552,19319,17.465,177841,78250,99591,9.096,20.674,167522,66923,100599,7.78,19.474,10319,1.2,38.948,13320,13373,39483
2010,5417,11828,14727,642250,646639,1889,12.923,1669,11.418,78664,22595,56069,3.494,12.165,87423,27970,59453,4.325,13.52,-8759,-1.355,24.33,1039,1053,7349
2010,5418,29908,33406,412293,420814,3606,10.603,4814,14.155,57763,25786,31977,6.128,13.727,75583,27481,48102,6.53,17.961,-17820,-4.235,27.453,3441,3483,20122
2010,5419,51810,61246,589964,594460,5540,9.012,5995,9.752,75968,24723,51245,4.159,12.779,84637,25088,59549,4.22,14.238,-8669,-1.458,25.559,3991,4046,16532
2010,5511,26894,50329,2852467,2855853,4129,8.164,4621,9.137,397045,126732,270313,4.438,13.903,402898,110894,292004,3.883,14.108,-5853,-0.205,27.806,912,985,15507
2010,5611,22836,24919,402570,399052,3238,13.019,3143,12.637,69847,25700,44147,6.44,17.503,62171,22854,39317,5.727,15.58,7676,1.924,31.159,2302,2308,15713
2010,5612,1691,5485,240919,236445,1267,24.286,731,14.012,55398,28387,27011,12.006,23.43,44678,16482,28196,6.971,18.896,10720,4.534,37.791,106,106,1418
2010,5613,24368,43519,3988702,3946026,4930,10.926,8134,18.027,910004,193986,716018,4.916,23.061,822810,251683,571127,6.378,20.852,87194,2.21,41.703,3571,3830,112965
2010,5614,25363,32146,768906,794816,3233,9.99,3665,11.325,111214,42367,68847,5.33,13.992,164863,48320,116543,6.079,20.742,-53649,-6.75,27.985,2635,2672,22896
2010,5615,13421,18876,227645,230738,1921,9.915,2919,15.066,32473,9726,22747,4.215,14.074,38441,14058,24383,6.093,16.66,-5968,-2.586,28.147,1380,1436,5597
2010,5616,17386,23478,781198,788525,2549,10.83,2667,11.331,107653,34721,72932,4.403,13.652,122045,34874,87171,4.423,15.478,-14392,-1.825,27.305,1610,1754,12736
2010,5617,134973,142120,1619176,1621136,19573,13.768,19661,13.83,268540,96686,171854,5.964,16.565,273517,85251,188266,5.259,16.872,-4977,-0.307,33.13,12831,12850,57429
2010,5619,15816,17844,256805,266688,1730,9.595,2103,11.664,33264,9892,23372,3.709,12.473,53742,20212,33530,7.579,20.152,-20478,-7.679,24.946,1394,1403,14724
2010,5621,7144,9502,188214,189058,921,9.76,790,8.372,20150,9475,10675,5.012,10.658,21743,6762,14981,3.577,11.501,-1593,-0.843,21.316,534,538,3635
2010,5622,1331,2478,51660,52882,205,8.347,161,6.555,6017,2617,3400,4.949,11.378,8795,2983,5812,5.641,16.632,-2778,-5.253,22.757,85,85,517
2010,5629,7539,8646,116818,118256,782,9.025,819,9.452,20480,6136,14344,5.189,17.318,23424,8097,15327,6.847,19.808,-2944,-2.49,34.637,499,520,4561
2010,6111,17913,20259,851443,853030,860,4.242,885,4.366,59882,13243,46639,1.552,7.02,62960,13817,49143,1.62,7.381,-3078,-0.361,14.04,645,659,8931
2010,6112,453,905,86311,81467,67,7.575,26,2.94,12924,3117,9807,3.826,15.864,3386,623,2763,0.765,4.156,9538,11.708,8.313,19,19,221
2010,6113,2144,3983,1717252,1693831,185,4.656,165,4.153,97026,5510,91516,0.325,5.728,50276,3887,46389,0.229,2.968,46750,2.76,5.936,87,87,2834
2010,6114,6145,6681,62886,63247,748,11.093,872,12.932,10133,4170,5963,6.593,16.021,10859,3526,7333,5.575,17.169,-726,-1.148,32.043,585,595,2482
2010,6115,6047,7665,130890,126336,829,10.949,642,8.479,24700,7863,16837,6.224,19.551,15495,4701,10794,3.721,12.265,9205,7.286,24.53,474,480,3129
2010,6116,33203,36048,337022,330710,5046,14.218,3931,11.076,72947,31970,40977,9.667,22.058,60176,19364,40812,5.855,18.196,12771,3.862,36.392,2831,2848,13209
2010,6117,5341,6112,80457,79004,1054,17.414,935,15.448,15946,6982,8964,8.838,20.184,13109,3602,9507,4.559,16.593,2837,3.591,33.186,527,531,1838
2010,6211,175271,207338,2208343,2205292,15438,7.484,13342,6.468,263978,98046,165932,4.446,11.97,257451,71574,185877,3.246,11.674,6527,0.296,23.348,9425,9644,47343
2010,6212,117704,124643,846141,842214,6186,4.995,4603,3.717,93077,30945,62132,3.674,11.051,85217,21363,63854,2.537,10.118,7860,0.933,20.236,3611,3655,16400
2010,6213,108201,121919,678776,667264,11990,9.992,8152,6.793,110335,41723,68612,6.253,16.535,87585,26565,61020,3.981,13.126,22750,3.409,26.252,5536,5588,16678
2010,6214,14531,32250,715186,708714,2793,8.805,1735,5.47,92667,34316,58351,4.842,13.075,79094,22743,56351,3.209,11.16,13573,1.915,22.32,807,850,8833
2010,6215,7111,12572,249600,248005,1277,10.181,1220,9.726,28438,9311,19127,3.754,11.467,25206,9378,15828,3.781,10.164,3232,1.303,20.327,650,708,5211
2010,6216,17471,25470,1172714,1139515,3734,15.202,1918,7.809,195840,64083,131757,5.624,17.186,129543,34986,94557,3.07,11.368,66297,5.818,22.737,1282,1337,19087
2010,6219,5826,9303,285704,286453,949,10.329,719,7.825,36285,12273,24012,4.284,12.667,38058,11243,26815,3.925,13.286,-1773,-0.619,25.334,342,353,3840
2010,6221,2969,5093,5146334,5142766,83,1.632,71,1.396,158887,27793,131094,0.54,3.09,152891,20323,132568,0.395,2.973,5996,0.117,5.946,39,39,13339
2010,6222,441,615,219846,218699,26,4.266,15,2.461,7577,1765,5812,0.807,3.465,5375,546,4829,0.25,2.458,2202,1.007,4.915,9,9,321
2010,6223,409,900,265381,260135,66,7.479,31,3.513,18478,6544,11934,2.516,7.103,8119,1338,6781,0.514,3.121,10359,3.982,6.242,22,22,544
2010,6231,8081,15900,1628884,1617261,786,4.978,562,3.56,121096,44789,76307,2.769,7.488,97706,28810,68896,1.781,6.041,23390,1.446,12.083,324,342,18248
2010,6232,8788,34654,643539,639097,3055,9.035,1374,4.063,86273,40145,46128,6.282,13.499,76870,14424,62446,2.257,12.028,9403,1.471,24.056,354,411,3775
2010,6233,14810,21171,819604,807404,2074,9.986,1272,6.124,93534,43745,49789,5.418,11.585,68899,22668,46231,2.808,8.533,24635,3.051,17.067,807,820,10149
2010,6239,3360,5685,142474,144827,333,5.776,493,8.552,14521,4938,9583,3.41,10.026,19161,5826,13335,4.023,13.23,-4640,-3.204,20.053,287,302,3211
2010,6241,41223,57875,1336496,1311427,5613,9.785,4590,8.002,194966,55791,139175,4.254,14.867,143623,32260,111363,2.46,10.952,51343,3.915,21.903,2935,3064,17706
2010,6242,10097,13791,177236,175300,858,6.236,794,5.771,22796,6474,16322,3.693,13.004,18706,5605,13101,3.197,10.671,4090,2.333,21.342,529,536,3775
2010,6243,4228,7842,347920,337956,835,10.934,424,5.552,59694,16057,43637,4.751,17.663,39867,6669,33198,1.973,11.797,19827,5.867,23.593,177,191,1630
2010,6244,55701,70933,861654,866126,6975,9.87,6453,9.131,108348,45644,62704,5.27,12.509,116607,37722,78885,4.355,13.463,-8259,-0.954,25.019,4657,4771,26622
2010,7111,6914,7046,116196,118008,724,10.176,861,12.102,16817,4909,11908,4.16,14.251,20304,5751,14553,4.873,17.206,-3487,-2.955,28.502,581,582,4055
2010,7112,3299,3465,120988,121731,477,13.735,493,14.195,12975,3246,9729,2.667,10.659,14621,3121,11500,2.564,12.011,-1646,-1.352,21.317,375,378,2282
2010,7113,5200,5520,127517,127340,587,10.564,660,11.878,19241,5397,13844,4.238,15.11,19240,6218,13022,4.883,15.109,1,0.001,30.218,453,456,3657
2010,7114,2725,2819,17414,17880,419,14.89,409,14.534,2370,1030,1340,5.761,13.255,3336,1238,2098,6.924,18.658,-966,-5.403,26.511,282,283,803
2010,7115,13207,13238,43401,43371,2389,18.003,2453,18.485,12299,6556,5743,15.116,28.358,12095,5116,6979,11.796,27.888,204,0.47,55.775,1462,1462,3203
2010,7121,6311,6796,126074,127306,329,4.85,303,4.467,10006,2956,7050,2.322,7.86,12624,2613,10011,2.053,9.916,-2618,-2.056,15.72,186,186,1800
2010,7131,2109,2522,147142,143134,367,14.503,384,15.175,19225,3744,15481,2.616,13.431,10945,3091,7854,2.16,7.647,8280,5.785,15.293,278,282,2562
2010,7132,1715,2536,171272,172078,321,12.978,196,7.924,13782,7129,6653,4.143,8.009,15422,3708,11714,2.155,8.962,-1640,-0.953,16.018,155,161,3116
2010,7139,48706,55504,1126480,1134439,5605,10.06,6026,10.816,137458,56927,80531,5.018,12.117,154194,43957,110237,3.875,13.592,-16736,-1.475,24.234,4614,4669,33186
2010,7211,38566,49283,1770399,1784849,4044,8.242,3613,7.363,180316,84353,95963,4.726,10.103,208737,55437,153300,3.106,11.695,-28421,-1.592,20.205,2345,2384,30256
2010,7212,5196,5744,38430,38134,478,8.346,444,7.753,5986,1541,4445,4.041,15.697,5372,1275,4097,3.343,14.087,614,1.61,28.174,268,268,814
2010,7213,1885,1992,10503,10647,150,7.564,132,6.657,1278,504,774,4.734,12.003,1560,315,1245,2.959,14.652,-282,-2.649,24.007,100,100,233
2010,7223,11959,35719,632279,637879,4601,13.002,3935,11.12,101362,50423,50939,7.905,15.89,111706,38845,72861,6.09,17.512,-10344,-1.622,31.781,1518,1614,10078
2010,7224,39418,40160,347109,347398,4047,10.012,4574,11.315,64469,31786,32683,9.15,18.558,65026,26992,38034,7.77,18.718,-557,-0.16,37.115,3713,3718,22714
2010,7225,328890,454723,8506115,8560384,50557,11.201,43827,9.71,1154423,605777,548646,7.077,13.486,1255536,416891,838645,4.87,14.667,-101113,-1.181,26.971,34199,35131,302124
2010,8111,133059,145828,790612,797837,11838,8.086,12967,8.858,107323,42402,64921,5.315,13.452,121537,39956,81581,5.008,15.233,-14214,-1.782,26.903,9196,9342,28631
2010,8112,9980,11364,113390,115196,1128,9.847,1310,11.436,17283,6111,11172,5.305,15.003,20980,9124,11856,7.92,18.213,-3697,-3.209,30.006,898,906,3456
2010,8113,18366,20000,182031,187099,1512,7.449,2109,10.39,23922,9372,14550,5.009,12.786,34196,8758,25438,4.681,18.277,-10274,-5.491,25.572,1413,1414,4322
2010,8114,16831,17604,70003,71276,1881,10.586,2210,12.438,10815,4723,6092,6.626,15.173,13292,5559,7733,7.799,18.649,-2477,-3.475,30.347,1540,1540,3594
2010,8121,86279,102508,625960,621992,12168,11.9,11652,11.396,109777,48333,61444,7.771,17.649,102128,42119,60009,6.772,16.42,7649,1.23,32.839,8969,9087,32542
2010,8122,14559,19890,134051,134314,731,3.675,736,3.7,11900,3072,8828,2.287,8.86,12562,2468,10094,1.837,9.353,-662,-0.493,17.72,415,424,1425
2010,8123,29391,34885,305433,310718,2809,8.008,3198,9.116,32124,12693,19431,4.085,10.339,42608,13525,29083,4.353,13.713,-10484,-3.374,20.677,2415,2471,9259
2010,8129,21712,32264,241000,242490,4827,15.09,4275,13.364,47272,23914,23358,9.862,19.494,49375,25575,23800,10.547,20.362,-2103,-0.867,38.989,2178,2196,10008
2010,8131,174466,174811,1686485,1687678,8798,5.05,7615,4.371,154290,27884,126406,1.652,9.142,157012,20987,136025,1.244,9.303,-2722,-0.161,18.284,4792,4794,13610
2010,8132,14846,16809,167596,169395,1216,7.275,1028,6.15,16359,5243,11116,3.095,9.657,20033,4237,15796,2.501,11.826,-3674,-2.169,19.315,682,693,2452
2010,8133,13077,15467,141734,141649,1235,8.041,1020,6.641,17828,4434,13394,3.13,12.586,17640,3892,13748,2.748,12.453,188,0.133,24.907,661,698,2865
2010,8134,24119,25961,238544,241113,1128,4.322,1406,5.387,25838,6206,19632,2.574,10.716,30927,5824,25103,2.415,12.827,-5089,-2.111,21.432,944,945,3714
2010,8139,55981,58207,497564,501759,2960,5.097,2690,4.632,49418,11521,37897,2.296,9.849,57803,10109,47694,2.015,11.52,-8385,-1.671,19.698,1870,1877,7056
2011,1131,318,332,2021,2000,36,10.876,34,10.272,270,95,175,4.75,13.5,213,75,138,3.75,10.65,57,2.85,21.3,28,28,61
2011,1132,125,143,1550,1517,20,14.286,14,10,353,82,271,5.405,23.27,276,21,255,1.384,18.194,77,5.076,36.388,8,8,10
2011,1133,7143,7243,49709,49840,740,10.149,837,11.479,7613,2261,5352,4.537,15.275,7840,2681,5159,5.379,15.73,-227,-0.455,30.55,595,595,1991
2011,1141,1150,1161,6067,5996,204,17.376,230,19.591,1335,494,841,8.239,22.265,1143,563,580,9.39,19.063,192,3.202,38.125,128,128,313
2011,1142,235,235,1493,1492,28,11.966,26,11.111,225,87,138,5.831,15.08,237,53,184,3.552,15.885,-12,-0.804,30.161,20,20,30
2011,1151,3357,3709,63070,62265,397,10.737,374,10.115,9436,2477,6959,3.978,15.155,7831,2126,5705,3.414,12.577,1605,2.578,25.154,243,243,1370
2011,1152,3596,3695,19036,19063,422,11.344,472,12.688,2740,1044,1696,5.477,14.374,2811,1177,1634,6.174,14.746,-71,-0.372,28.748,360,360,945
2011,1153,1219,1311,10628,10601,180,13.809,165,12.658,2310,924,1386,8.717,21.791,2279,666,1613,6.283,21.499,31,0.292,42.998,93,93,438
2011,2111,5777,7149,114126,110967,699,9.861,578,8.154,19228,6530,12698,5.885,17.328,12901,3916,8985,3.529,11.626,6327,5.702,23.252,377,384,1540
2011,2121,543,986,85016,83650,109,11.1,101,10.285,10644,3160,7484,3.778,12.725,7837,2022,5815,2.417,9.369,2807,3.356,18.738,64,70,1036
2011,2122,237,298,34867,33476,47,16.462,22,7.706,4700,460,4240,1.374,14.04,1865,158,1707,0.472,5.571,2835,8.469,11.142,18,18,145
2011,2123,2860,4910,79311,79470,298,6.043,340,6.895,8536,1665,6871,2.095,10.741,8820,2265,6555,2.85,11.099,-284,-0.357,21.482,202,208,1360
2011,2131,9521,11907,335690,311110,1654,14.193,1148,9.851,90577,21711,68866,6.979,29.114,41064,12554,28510,4.035,13.199,49513,15.915,26.398,739,742,6210
2011,2211,1669,10108,515174,515692,645,6.365,696,6.868,38654,14630,24024,2.837,7.496,40064,14462,25602,2.804,7.769,-1410,-0.273,14.991,48,50,348
2011,2212,433,2500,85444,85214,133,5.334,120,4.813,6510,2121,4389,2.489,7.64,5959,1265,4694,1.485,6.993,551,0.647,13.986,21,21,253
2011,2213,3403,4573,41864,42043,214,4.662,249,5.424,2932,868,2064,2.065,6.974,3222,937,2285,2.229,7.664,-290,-0.69,13.948,127,133,424
2011,2361,118626,119888,530814,547928,22313,18.236,27249,22.27,124740,57532,67208,10.5,22.766,158947,71305,87642,13.014,29.009,-34207,-6.243,45.532,17279,17319,46476
2011,2362,36157,37580,555307,568487,4213,11.068,5179,13.606,99220,23718,75502,4.172,17.453,125077,29098,95979,5.118,22.002,-25857,-4.548,34.907,3392,3409,16906
2011,2371,16308,17765,478790,476722,1733,9.702,1927,10.788,91960,20643,71317,4.33,19.29,87088,15669,71419,3.287,18.268,4872,1.022,36.536,1240,1245,8727
2011,2372,5897,5977,34568,36678,567,9.014,1194,18.981,4942,1675,3267,4.567,13.474,9177,3704,5473,10.099,25.021,-4235,-11.547,26.948,919,922,2717
2011,2373,8649,9489,260140,265345,659,6.85,921,9.574,35715,5030,30685,1.896,13.46,46039,7032,39007,2.65,17.351,-10324,-3.891,26.92,560,565,4270
2011,2379,3563,3705,62979,62648,414,11.04,504,13.44,14595,2707,11888,4.321,23.297,13961,3794,10167,6.056,22.285,634,1.012,44.57,300,300,1959
2011,2381,70063,70919,644739,667004,9925,13.648,13525,18.599,138668,36582,102086,5.485,20.79,182341,54655,127686,8.194,27.337,-43673,-6.548,41.579,8269,8277,37237
2011,2382,148002,151963,1581723,1597903,14612,9.543,16916,11.048,247394,52606,194788,3.292,15.482,280276,65753,214523,4.115,17.54,-32882,-2.058,30.965,11549,11581,46980
2011,2383,85942,86951,591456,608292,12672,14.292,16101,18.159,123728,36764,86964,6.044,20.34,157284,48358,108926,7.95,25.857,-33556,-5.516,40.68,10304,10321,33437
2011,2389,49216,49920,433020,435277,6937,13.68,8515,16.792,91843,23123,68720,5.312,21.1,96529,30107,66422,6.917,22.176,-4686,-1.077,42.2,5250,5263,20640
2011,3111,1078,1665,49989,50150,79,4.738,84,5.037,3745,792,2953,1.579,7.468,4031,797,3234,1.589,8.038,-286,-0.57,14.935,52,52,309
2011,3112,427,759,53214,53289,36,4.746,35,4.614,3255,596,2659,1.118,6.108,3410,809,2601,1.518,6.399,-155,-0.291,12.217,24,24,212
2011,3113,1444,1580,68752,68454,122,7.744,113,7.172,5999,1052,4947,1.537,8.764,5360,882,4478,1.288,7.83,639,0.933,15.66,81,81,562
2011,3114,1208,1568,154913,154924,88,5.61,89,5.674,11350,1314,10036,0.848,7.326,11322,2651,8671,1.711,7.308,28,0.018,14.616,55,55,1467
2011,3115,982,1484,135935,136186,86,5.801,83,5.599,8113,1366,6747,1.003,5.957,8622,1430,7192,1.05,6.331,-509,-0.374,11.915,60,60,552
2011,3116,2813,3404,486112,488834,186,5.461,190,5.578,28864,4841,24023,0.99,5.905,34371,8693,25678,1.778,7.031,-5507,-1.127,11.809,132,133,2983
2011,3117,455,547,31327,31470,33,5.925,53,9.515,2795,486,2309,1.544,8.882,3057,842,2215,2.676,9.714,-262,-0.833,17.763,35,35,485
2011,3118,8837,9564,280375,278896,993,10.506,768,8.126,27784,7914,19870,2.838,9.962,24819,6779,18040,2.431,8.899,2965,1.063,17.798,593,593,4419
2011,3119,2637,3080,162420,163193,290,9.598,173,5.726,12932,3235,9697,1.982,7.924,14475,3912,10563,2.397,8.87,-1543,-0.946,15.849,125,125,1518
2011,3121,3490,4078,129678,127593,540,13.685,276,6.994,16630,4630,12000,3.629,13.034,12383,3601,8782,2.822,9.705,4247,3.329,19.41,190,192,1117
2011,3122,94,117,15020,14555,22,20,8,7.273,1815,158,1657,1.086,12.47,912,118,794,0.811,6.266,903,6.204,12.532,6,6,32
2011,3131,244,320,27171,27345,23,7.244,18,5.669,2314,776,1538,2.838,8.462,2698,816,1882,2.984,9.867,-384,-1.404,16.924,14,14,131
2011,3132,870,965,51974,51541,51,5.217,76,7.775,5196,641,4555,1.244,10.081,4331,1256,3075,2.437,8.403,865,1.678,16.806,54,54,505
2011,3133,987,1030,30638,30793,74,7.115,94,9.038,3011,640,2371,2.078,9.778,3244,1000,2244,3.248,10.535,-233,-0.757,19.557,72,72,582
2011,3141,1721,1843,53174,53593,141,7.542,194,10.377,4444,969,3475,1.808,8.292,5361,1615,3746,3.013,10.003,-917,-1.711,16.584,142,142,1047
2011,3149,3740,3850,59118,58889,321,8.222,429,10.989,7680,1607,6073,2.729,13.042,7223,2227,4996,3.782,12.266,457,0.776,24.531,329,329,1426
2011,3151,267,282,13142,13331,20,7.03,25,8.787,1046,105,941,0.788,7.847,1419,233,1186,1.748,10.645,-373,-2.798,15.693,20,20,201
2011,3152,4894,4950,88130,90623,791,15.812,896,17.911,14978,6452,8526,7.12,16.528,19954,8982,10972,9.911,22.019,-4976,-5.491,33.056,769,770,7572
2011,3159,564,576,9120,9394,45,7.647,70,11.895,939,193,746,2.055,9.996,1485,643,842,6.845,15.809,-546,-5.813,19.993,52,52,243
2011,3161,180,188,3729,3732,15,8.065,11,5.914,356,43,313,1.152,9.539,346,140,206,3.751,9.271,10,0.268,18.542,7,7,26
2011,3162,185,206,11555,11295,21,10.244,19,9.268,1323,118,1205,1.045,11.714,823,190,633,1.682,7.287,500,4.427,14.573,14,14,57
2011,3169,647,655,13812,13071,57,8.482,91,13.542,2744,430,2314,3.29,20.993,1218,487,731,3.726,9.318,1526,11.675,18.637,74,74,288
2011,3211,2860,3251,79376,78778,220,6.712,273,8.33,9037,1916,7121,2.432,11.472,7800,3033,4767,3.85,9.901,1237,1.57,19.803,180,180,1282
2011,3212,1151,1442,61513,62912,63,4.227,160,10.735,5428,1054,4374,1.675,8.628,8033,3325,4708,5.285,12.769,-2605,-4.141,17.256,97,98,1409
2011,3219,7666,8584,205103,207365,576,6.608,842,9.659,22375,5181,17194,2.498,10.79,26940,8778,18162,4.233,12.992,-4565,-2.201,21.58,611,623,5476
2011,3221,214,431,110963,111136,9,2.05,25,5.695,4222,956,3266,0.86,3.799,4688,2025,2663,1.822,4.218,-466,-0.419,7.598,15,15,372
2011,3222,2647,3964,252057,253163,140,3.492,230,5.737,18067,4051,14016,1.6,7.137,20275,8549,11726,3.377,8.009,-2208,-0.872,14.273,135,137,2371
2011,3231,25339,26652,481355,490968,1490,5.481,2560,9.416,36703,8285,28418,1.687,7.476,55752,21080,34672,4.294,11.356,-19049,-3.88,14.951,2028,2041,12626
2011,3241,971,2118,98321,98715,109,5.103,145,6.788,5481,1244,4237,1.26,5.552,6356,1054,5302,1.068,6.439,-875,-0.886,11.105,66,66,405
2011,3251,1308,2381,155355,152965,131,5.498,134,5.624,11933,2935,8998,1.919,7.801,7031,2006,5025,1.311,4.596,4902,3.205,9.193,79,80,852
2011,3252,961,1273,86536,86335,53,4.149,62,4.853,7414,1432,5982,1.659,8.588,7016,1489,5527,1.725,8.127,398,0.461,16.253,40,42,774
2011,3253,612,848,27900,28393,70,8.284,64,7.574,2002,594,1408,2.092,7.051,3027,740,2287,2.606,10.661,-1025,-3.61,14.102,39,41,306
2011,3254,1484,1933,228295,229933,167,8.771,109,5.725,16450,4554,11896,1.981,7.154,19743,1636,18107,0.712,8.586,-3293,-1.432,14.309,83,83,639
2011,3255,1299,1638,52720,52347,71,4.284,110,6.637,4627,1021,3606,1.95,8.839,3865,1268,2597,2.422,7.383,762,1.456,14.767,73,76,586
2011,3256,1904,2093,91450,91659,156,7.478,142,6.807,7170,1340,5830,1.462,7.823,7736,2264,5472,2.47,8.44,-566,-0.618,15.645,106,106,1531
2011,3259,1807,2321,83200,84697,150,6.394,200,8.525,7321,1343,5978,1.586,8.644,10206,3694,6512,4.361,12.05,-2885,-3.406,17.288,113,122,879
2011,3261,8253,10488,561969,555132,461,4.368,594,5.628,58383,9471,48912,1.706,10.517,44681,15276,29405,2.752,8.049,13702,2.468,16.097,369,377,6342
2011,3262,1478,1895,122981,120407,77,4.034,105,5.5,11083,792,10291,0.658,9.205,5983,2006,3977,1.666,4.969,5100,4.236,9.938,69,69,734
2011,3271,992,1175,33822,33741,81,6.77,124,10.364,3297,633,2664,1.876,9.772,3205,525,2680,1.556,9.499,92,0.273,18.998,90,90,332
2011,3272,1384,1657,80661,80386,105,6.269,141,8.418,6596,857,5739,1.066,8.205,5993,1572,4421,1.956,7.455,603,0.75,14.911,97,97,432
2011,3273,4242,8695,148159,151434,344,3.898,604,6.844,14068,2470,11598,1.631,9.29,20599,4693,15906,3.099,13.603,-6531,-4.313,18.58,234,265,2156
2011,3274,174,298,12138,12556,16,5.281,26,8.581,517,71,446,0.565,4.118,1357,371,986,2.955,10.808,-840,-6.69,8.235,14,14,96
2011,3279,2517,2954,64257,63823,194,6.504,252,8.448,6886,1270,5616,1.99,10.789,5950,1914,4036,2.999,9.323,936,1.467,18.645,178,178,1288
2011,3311,338,474,102323,99954,38,7.983,42,8.824,6601,550,6051,0.55,6.604,1868,332,1536,0.332,1.869,4733,4.735,3.738,35,35,249
2011,3312,509,642,40114,38475,57,9.084,28,4.462,5745,1635,4110,4.25,14.932,2488,472,2016,1.227,6.467,3257,8.465,12.933,16,16,154
2011,3313,400,523,51241,50442,32,6.119,32,6.119,5615,794,4821,1.574,11.132,4154,1245,2909,2.468,8.235,1461,2.896,16.471,24,25,395
2011,3314,731,920,57834,56841,53,5.786,45,4.913,5370,638,4732,1.122,9.447,3357,1021,2336,1.796,5.906,2013,3.541,11.812,27,27,502
2011,3315,1621,1825,120139,115706,68,3.7,94,5.114,15345,746,14599,0.645,13.262,6618,2055,4563,1.776,5.72,8727,7.542,11.439,65,66,839
2011,3321,2240,2475,107156,104257,87,3.497,113,4.542,12321,1077,11244,1.033,11.818,6499,1862,4637,1.786,6.234,5822,5.584,12.467,73,73,760
2011,3322,1185,1283,40509,39922,70,5.431,82,6.362,3779,859,2920,2.152,9.466,2604,624,1980,1.563,6.523,1175,2.943,13.045,64,66,410
2011,3323,11196,12160,310831,310413,653,5.298,986,7.999,37788,8080,29708,2.603,12.173,36940,8927,28013,2.876,11.9,848,0.273,23.801,696,698,5768
2011,3324,1151,1443,79625,80556,63,4.386,50,3.481,8824,2010,6814,2.495,10.954,10557,1475,9082,1.831,13.105,-1733,-2.151,21.908,25,25,324
2011,3325,546,607,26776,26663,20,3.234,43,6.952,2222,230,1992,0.863,8.334,2068,499,1569,1.872,7.756,154,0.578,15.512,25,25,171
2011,3326,1169,1317,39614,38824,42,3.164,63,4.746,4597,650,3947,1.674,11.841,2965,959,2006,2.47,7.637,1632,4.204,15.274,37,37,458
2011,3327,21717,22136,357738,343133,1290,5.834,1244,5.626,54218,8071,46147,2.352,15.801,25032,8677,16355,2.529,7.295,29186,8.506,14.59,894,896,5476
2011,3328,4970,5478,117665,113505,281,5.12,302,5.502,16730,2762,13968,2.433,14.739,8371,2342,6029,2.063,7.375,8359,7.364,14.75,227,229,1632
2011,3329,5572,6109,251740,247817,404,6.618,396,6.486,26279,3604,22675,1.454,10.604,18236,4797,13439,1.936,7.359,8043,3.246,14.717,272,273,1913
2011,3331,2440,2796,183357,177443,205,7.418,140,5.066,22733,3360,19373,1.894,12.811,10683,3479,7204,1.961,6.021,12050,6.791,12.041,95,95,928
2011,3332,3111,3279,100860,99140,168,5.097,202,6.129,11187,1298,9889,1.309,11.284,7779,2183,5596,2.202,7.847,3408,3.438,15.693,142,144,1438
2011,3333,1784,1916,75581,75044,145,7.592,133,6.963,6552,1383,5169,1.843,8.731,5502,1524,3978,2.031,7.332,1050,1.399,14.663,98,99,611
2011,3334,1456,1717,122577,120385,97,5.638,104,6.045,12963,1632,11331,1.356,10.768,8586,3555,5031,2.953,7.132,4377,3.636,14.264,68,72,1138
2011,3335,6423,6625,136876,132633,303,4.549,376,5.644,17876,2423,15453,1.827,13.478,9320,3160,6160,2.383,7.027,8556,6.451,14.054,278,280,2284
2011,3336,788,971,93585,92177,59,6.045,69,7.07,12203,2130,10073,2.311,13.239,9213,4070,5143,4.415,9.995,2990,3.244,19.99,49,49,575
2011,3339,5112,5722,259444,254397,285,4.967,317,5.525,27743,2773,24970,1.09,10.905,17521,5114,12407,2.01,6.887,10222,4.018,13.775,214,215,2092
2011,3341,944,992,67170,68944,77,7.719,88,8.822,3645,521,3124,0.756,5.287,7217,1633,5584,2.369,10.468,-3572,-5.181,10.574,64,64,535
2011,3342,1289,1423,111578,110364,120,8.454,113,7.961,11594,972,10622,0.881,10.505,8830,2943,5887,2.667,8.001,2764,2.504,16.002,74,74,720
2011,3343,423,427,8067,8147,44,10.341,41,9.636,732,244,488,2.995,8.985,874,462,412,5.671,10.729,-142,-1.743,17.971,33,33,353
2011,3344,3638,4101,283693,281035,245,5.954,273,6.634,28725,4788,23937,1.704,10.221,24082,7757,16325,2.76,8.569,4643,1.652,17.138,189,189,2502
2011,3345,4265,4923,388106,386099,314,6.369,328,6.653,31238,5963,25275,1.544,8.091,27216,6812,20404,1.764,7.049,4022,1.042,14.098,209,209,2609
2011,3346,491,508,14468,15432,40,7.533,86,16.196,995,563,432,3.648,6.448,3080,1321,1759,8.56,19.959,-2085,-13.511,12.896,66,67,867
2011,3351,963,1042,45455,45425,77,7.309,100,9.492,3824,1052,2772,2.316,8.418,3806,1600,2206,3.522,8.379,18,0.04,16.757,70,70,867
2011,3352,232,272,43584,44404,26,9.612,23,8.503,2084,523,1561,1.178,4.693,3662,1619,2043,3.646,8.247,-1578,-3.554,9.387,12,12,81
2011,3353,1822,2102,111821,111598,104,4.893,151,7.104,9184,1402,7782,1.256,8.23,8583,3304,5279,2.961,7.691,601,0.539,15.382,97,97,719
2011,3359,1783,2078,130746,127644,137,6.617,122,5.892,15502,3846,11656,3.013,12.145,9423,3466,5957,2.715,7.382,6079,4.762,14.765,75,75,820
2011,3361,261,322,139254,132976,31,9.598,33,10.217,17319,357,16962,0.268,13.024,5073,1899,3174,1.428,3.815,12246,9.209,7.63,26,26,94
2011,3362,1531,1775,102693,97728,107,5.949,154,8.563,17238,2688,14550,2.75,17.639,7515,3041,4474,3.112,7.69,9723,9.949,15.379,105,110,1499
2011,3363,3965,4846,425894,414667,258,5.266,365,7.45,56082,9562,46520,2.306,13.525,33643,15318,18325,3.694,8.113,22439,5.411,16.227,219,229,3246
2011,3364,1231,1641,350232,358301,110,6.693,115,6.997,17803,2301,15502,0.642,4.969,34855,4065,30790,1.135,9.728,-17052,-4.759,9.937,61,61,539
2011,3365,148,216,25275,24846,15,6.961,14,6.497,3269,390,2879,1.57,13.157,2326,132,2194,0.531,9.362,943,3.795,18.724,7,7,64
2011,3366,1278,1391,127153,127989,114,8.062,160,11.315,10335,1400,8935,1.094,8.075,11846,3253,8593,2.542,9.255,-1511,-1.181,16.15,118,119,2040
2011,3369,763,791,36411,37036,94,11.967,83,10.567,3873,1833,2040,4.949,10.458,4953,680,4273,1.836,13.374,-1080,-2.916,20.915,62,63,290
2011,3371,10823,11057,202800,206901,847,7.46,1442,12.7,18990,4236,14754,2.047,9.178,27242,8648,18594,4.18,13.167,-8252,-3.988,18.357,1030,1033,5085
2011,3372,3302,3479,100928,101460,179,5.015,359,10.059,10843,1555,9288,1.533,10.687,11856,3781,8075,3.727,11.685,-1013,-0.998,21.374,274,278,2536
2011,3379,716,810,30803,31342,39,4.671,89,10.659,2518,493,2025,1.573,8.034,3616,1540,2076,4.914,11.537,-1098,-3.503,16.068,72,73,949
2011,3391,10085,10950,287068,285503,682,6.182,845,7.66,26472,5098,21374,1.786,9.272,23521,7465,16056,2.615,8.238,2951,1.034,16.477,630,633,3451
2011,3399,14715,15122,270840,271102,1308,8.603,1473,9.688,29527,7488,22039,2.762,10.891,29922,9105,20817,3.359,11.037,-395,-0.146,21.783,1108,1110,5760
2011,4231,16352,23749,356548,352800,1594,6.705,1643,6.911,37669,10356,27313,2.935,10.677,30313,9624,20689,2.728,8.592,7356,2.085,17.184,1130,1192,5878
2011,4232,9775,11575,134684,135211,1001,8.602,1124,9.659,15349,5052,10297,3.736,11.352,16389,5039,11350,3.727,12.121,-1040,-0.769,22.704,838,870,4006
2011,4233,9937,16268,186544,191160,943,5.694,1531,9.244,18929,5129,13800,2.683,9.902,27853,10097,17756,5.282,14.571,-8924,-4.668,19.804,898,939,4933
2011,4234,22296,33821,660985,670176,3752,11.24,2870,8.598,87152,31264,55888,4.665,13.004,104494,46247,58247,6.901,15.592,-17342,-2.588,26.009,1575,1618,10851
2011,4235,7274,10172,144646,142891,532,5.196,665,6.495,16471,3403,13068,2.382,11.527,13155,3737,9418,2.615,9.206,3316,2.321,18.413,375,398,2064
2011,4236,17770,27587,506233,500821,2049,7.422,2092,7.577,69190,21257,47933,4.244,13.815,57937,22557,35380,4.504,11.568,11253,2.247,23.137,1223,1278,7933
2011,4237,9759,18493,210784,207122,1113,6.029,1049,5.682,24310,6457,17853,3.117,11.737,17185,4724,12461,2.281,8.297,7125,3.44,16.594,584,621,2652
2011,4238,38673,55394,667731,659485,3186,5.741,3381,6.093,80037,19172,60865,2.907,12.136,63857,19501,44356,2.957,9.683,16180,2.453,19.366,2030,2135,10769
2011,4239,26716,29988,317062,313755,3385,11.365,2979,10.002,47386,15498,31888,4.94,15.103,40755,15703,25052,5.005,12.989,6631,2.113,25.979,2156,2184,8539
2011,4241,7563,10079,148537,148756,555,5.411,912,8.891,13810,3707,10103,2.492,9.284,14277,5123,9154,3.444,9.598,-467,-0.314,18.567,545,563,2482
2011,4242,5659,8983,267305,267662,1041,11.797,724,8.204,29313,7301,22012,2.728,10.952,30238,9405,20833,3.514,11.297,-925,-0.346,21.903,450,452,3206
2011,4243,12918,14111,182721,182381,1604,11.326,1707,12.053,27453,7664,19789,4.202,15.053,26750,9429,17321,5.17,14.667,703,0.385,29.334,1304,1320,6381
2011,4244,24134,31161,758441,756705,2954,9.534,2602,8.398,82527,29069,53458,3.842,10.906,80243,21918,58325,2.897,10.604,2284,0.302,21.209,1747,1785,10910
2011,4245,3263,6000,63221,63420,297,4.938,327,5.436,7196,1733,5463,2.733,11.347,7599,1998,5601,3.15,11.982,-403,-0.635,22.693,181,195,1015
2011,4246,7735,11883,142997,140410,782,6.586,764,6.434,21708,8919,12789,6.352,15.46,16185,6628,9557,4.72,11.527,5523,3.933,23.054,405,422,1844
2011,4247,4630,6964,105067,105931,325,4.638,412,5.879,11375,2473,8902,2.335,10.738,13091,2649,10442,2.501,12.358,-1716,-1.62,21.476,232,236,1318
2011,4248,3091,4033,178625,177480,306,7.63,261,6.508,13000,2982,10018,1.68,7.325,10680,3017,7663,1.7,6.018,2320,1.307,12.035,186,194,2273
2011,4249,19915,25945,319624,320601,2241,8.605,2436,9.354,38651,12834,25817,4.003,12.056,40538,14174,26364,4.421,12.644,-1887,-0.589,24.112,1742,1768,7354
2011,4251,38389,40701,299251,297445,4664,11.385,5191,12.672,48566,14459,34107,4.861,16.328,44200,16469,27731,5.537,14.86,4366,1.468,29.72,3915,3947,12666
2011,4411,37135,42169,1056750,1046101,3670,8.677,3927,9.284,122162,39092,83070,3.737,11.678,101249,37508,63741,3.586,9.679,20913,1.999,19.357,3080,3165,29775
2011,4412,11857,13419,120732,121425,961,7.059,1350,9.917,15595,4961,10634,4.086,12.843,16882,6357,10525,5.235,13.903,-1287,-1.06,25.687,1017,1045,4989
2011,4413,27047,54407,481154,476052,2490,4.568,2684,4.924,48428,11877,36551,2.495,10.173,38083,10706,27377,2.249,8,10345,2.173,16,1762,1838,6521
2011,4421,14245,22774,196308,199290,1733,7.515,2305,9.996,22766,9289,13477,4.661,11.424,28581,10013,18568,5.024,14.341,-5815,-2.918,22.847,1490,1704,6585
2011,4422,19239,27086,227136,224825,1831,6.637,2834,10.273,32800,8027,24773,3.57,14.589,28322,8977,19345,3.993,12.597,4478,1.992,25.195,2030,2076,5673
2011,4431,24701,47485,440677,433476,6203,13.254,4836,10.333,71528,34692,36836,8.003,16.501,56309,19182,37127,4.425,12.99,15219,3.511,25.98,3007,3332,12276
2011,4441,38139,60824,1047434,1053732,2538,4.125,3930,6.388,67070,15361,51709,1.458,6.365,80024,17554,62470,1.666,7.594,-12954,-1.229,12.73,2658,2818,11873
2011,4442,13512,17002,146712,145862,1048,6.127,1255,7.337,18972,4132,14840,2.833,13.007,16998,4606,12392,3.158,11.653,1974,1.353,23.307,831,855,3047
2011,4451,58218,84373,2542200,2534204,8595,10.251,7541,8.994,205891,85215,120676,3.363,8.124,189584,56419,133165,2.226,7.481,16307,0.643,14.962,5600,5702,27033
2011,4452,16652,20476,143864,143059,2417,11.75,2606,12.669,26140,11771,14369,8.228,18.272,24417,10044,14373,7.021,17.068,1723,1.204,34.136,1829,1860,7305
2011,4453,25918,29778,148411,148011,2565,8.668,2195,7.417,20885,8167,12718,5.518,14.11,20041,7041,13000,4.757,13.54,844,0.57,27.081,1673,1690,5313
2011,4461,39378,88282,966537,978483,7824,8.976,5597,6.421,115623,45509,70114,4.651,11.817,141651,39901,101750,4.078,14.477,-26028,-2.66,23.633,2904,2971,13022
2011,4471,62053,107919,853126,853914,7741,7.173,7731,7.164,114994,42874,72120,5.021,13.467,115827,38625,77202,4.523,13.564,-833,-0.098,26.933,5151,5488,25533
2011,4481,32479,92243,1323363,1266203,8629,9.409,7567,8.251,266500,74342,192158,5.871,21.047,152786,55000,97786,4.344,12.066,113714,8.981,24.133,4066,4476,16454
2011,4482,5571,24956,207956,202396,1108,4.395,1622,6.433,32145,8147,23998,4.025,15.882,21351,7640,13711,3.775,10.549,10794,5.333,21.098,553,615,1966
2011,4483,15870,22820,127509,127364,1572,6.845,1862,8.108,16969,4980,11989,3.91,13.323,16495,6081,10414,4.775,12.951,474,0.372,25.902,1132,1197,3304
2011,4511,25001,35213,406541,404777,3097,8.778,3236,9.172,47643,16758,30885,4.14,11.77,43504,12514,30990,3.092,10.748,4139,1.023,21.495,2342,2433,8271
2011,4512,4283,9108,112461,116730,467,5.008,901,9.662,9431,1967,7464,1.685,8.079,18170,5903,12267,5.057,15.566,-8739,-7.487,16.159,517,532,1683
2011,4522,31,5029,608706,607255,50,0.99,96,1.9,27430,3989,23441,0.657,4.517,23694,3568,20126,0.588,3.902,3736,0.615,7.804,4,4,9
2011,4523,7196,40517,2226911,2206045,2580,6.457,1456,3.644,153063,36654,116409,1.662,6.938,111800,8867,102933,0.402,5.068,41263,1.87,10.136,915,979,3496
2011,4531,13641,14278,65977,67865,1030,7.021,1815,12.372,8971,2731,6240,4.024,13.219,12726,4949,7777,7.292,18.752,-3755,-5.533,26.438,1453,1467,3967
2011,4532,20254,31080,259430,264530,2654,8.413,3585,11.365,30419,10618,19801,4.014,11.499,41272,16837,24435,6.365,15.602,-10853,-4.103,22.999,2493,2600,8349
2011,4533,11834,17047,156500,151904,1873,11.136,1419,8.436,25278,10159,15119,6.688,16.641,15942,4877,11065,3.211,10.495,9336,6.146,20.99,1071,1097,3047
2011,4539,27876,36537,233124,232011,3943,10.737,4317,11.755,36489,15705,20784,6.769,15.727,33664,13574,20090,5.851,14.51,2825,1.218,29.019,2848,2945,9167
2011,4541,20453,21502,328818,323082,3618,17.249,2565,12.229,58092,20004,38088,6.192,17.981,46234,18184,28050,5.628,14.31,11858,3.67,28.621,1929,1948,8268
2011,4542,3446,3918,35501,36317,332,8.307,489,12.236,2906,900,2006,2.478,8.002,4572,1857,2715,5.113,12.589,-1666,-4.587,16.004,388,390,1560
2011,4543,20551,26371,187408,188680,2158,8.127,2520,9.491,22877,7209,15668,3.821,12.125,25419,8470,16949,4.489,13.472,-2542,-1.347,24.25,1797,1834,6049
2011,4811,415,2646,389920,385121,146,5.505,158,5.958,26142,3002,23140,0.779,6.788,16174,2374,13800,0.616,4.2,9968,2.588,8.399,37,41,715
2011,4812,1916,2100,34139,33449,227,10.797,232,11.034,5070,1699,3371,5.079,15.158,3634,1067,2567,3.19,10.864,1436,4.293,21.729,177,177,663
2011,4831,658,999,45626,45344,96,9.538,111,11.028,5084,2238,2846,4.936,11.212,4397,1524,2873,3.361,9.697,687,1.515,19.394,58,58,946
2011,4832,417,472,17745,17333,46,9.654,55,11.542,2282,349,1933,2.014,13.166,1443,499,944,2.879,8.325,839,4.84,16.65,44,44,438
2011,4841,45183,54146,871739,854220,9515,17.844,7871,14.761,138074,46328,91746,5.423,16.164,103018,38468,64550,4.503,12.06,35056,4.104,24.12,5622,5673,21948
2011,4842,36227,40314,443828,436131,5034,12.454,5245,12.976,76627,21534,55093,4.938,17.57,61327,22300,39027,5.113,14.062,15300,3.508,28.123,3545,3570,14139
2011,4851,536,795,49126,48788,76,9.596,70,8.838,3624,1272,2352,2.607,7.428,2985,786,2199,1.611,6.118,639,1.31,12.237,47,47,241
2011,4852,203,420,15821,14753,76,18.765,46,11.358,4125,1430,2695,9.693,27.96,1923,1172,751,7.944,13.035,2202,14.926,26.069,19,23,374
2011,4853,6133,6269,66578,65248,1043,16.804,919,14.806,11200,4497,6703,6.892,17.165,8453,3701,4752,5.672,12.955,2747,4.21,25.91,710,710,3095
2011,4854,2716,4275,214028,213575,237,5.503,301,6.989,18958,6061,12897,2.838,8.877,18285,7197,11088,3.37,8.561,673,0.315,17.123,161,162,1831
2011,4855,1115,1216,27412,27141,118,9.664,128,10.483,3466,958,2508,3.53,12.77,2935,958,1977,3.53,10.814,531,1.956,21.628,87,88,473
2011,4859,3156,3575,75474,73915,539,15.278,445,12.613,11927,4260,7667,5.763,16.136,8764,3487,5277,4.718,11.857,3163,4.279,23.714,350,352,2657
2011,4861,47,648,9597,8806,245,45.161,34,6.267,2983,2320,663,26.346,33.875,1165,757,408,8.596,13.23,1818,20.645,26.459,(D),(D),(D)
2011,4862,108,1948,29028,29013,184,9.651,101,5.298,4771,1192,3579,4.109,16.444,4760,692,4068,2.385,16.406,11,0.038,32.813,10,10,40
2011,4869,45,686,6883,6674,74,11.028,44,6.557,1755,405,1350,6.068,26.296,1331,485,846,7.267,19.943,424,6.353,39.886,(D),(D),(D)
2011,4871,486,532,9461,9348,68,12.915,57,10.826,1278,369,909,3.948,13.672,1046,188,858,2.011,11.19,232,2.482,22.38,47,47,164
2011,4872,1120,1162,10906,10568,170,14.561,181,15.503,2071,539,1532,5.1,19.597,1345,465,880,4.4,12.727,726,6.87,25.454,106,109,296
2011,4879,150,170,2070,2016,36,22.222,20,12.346,441,243,198,12.054,21.875,337,98,239,4.861,16.716,104,5.159,33.433,13,13,80
2011,4881,3712,5476,156070,156935,611,11.221,549,10.083,21631,5737,15894,3.656,13.783,23741,8589,15152,5.473,15.128,-2110,-1.345,27.567,303,309,2062
2011,4882,481,1185,28603,27604,120,10.345,70,6.034,4268,1218,3050,4.412,15.462,2224,571,1653,2.069,8.057,2044,7.405,16.114,26,31,219
2011,4883,1664,2243,88163,87132,193,8.637,176,7.876,12623,5806,6817,6.663,14.487,10733,4145,6588,4.757,12.318,1890,2.169,24.636,89,90,420
2011,4884,8502,9461,75981,75059,1195,12.714,1071,11.395,13404,5315,8089,7.081,17.858,11499,4204,7295,5.601,15.32,1905,2.538,30.64,754,759,2885
2011,4885,13381,19076,230070,226792,1753,9.184,1776,9.305,33397,9182,24215,4.049,14.726,26430,11320,15110,4.991,11.654,6967,3.072,23.308,973,1019,4102
2011,4889,1151,1256,15820,15625,154,12.155,176,13.891,3117,831,2286,5.318,19.949,2731,1045,1686,6.688,17.478,386,2.47,34.957,138,138,681
2011,4921,4009,8488,489868,487823,1434,17.259,1075,12.939,28271,6441,21830,1.32,5.795,23070,8208,14862,1.683,4.729,5201,1.066,9.458,428,438,1875
2011,4922,3922,4296,32442,31360,1080,26.341,688,16.78,7667,3796,3871,12.105,24.449,5388,2519,2869,8.033,17.181,2279,7.267,34.363,582,590,2116
2011,4931,6838,14174,682396,677388,1000,7.049,1024,7.218,87952,26180,61772,3.865,12.984,75729,18216,57513,2.689,11.18,12223,1.804,22.359,331,343,2999
2011,5111,12887,18626,494804,510701,1335,7.044,1990,10.499,41548,12070,29478,2.363,8.135,73255,26700,46555,5.228,14.344,-31707,-6.209,16.271,1070,1083,5610
2011,5112,5026,7632,385443,378678,957,12.783,666,8.896,53366,13785,39581,3.64,14.093,40070,16348,23722,4.317,10.582,13296,3.511,21.163,330,346,6838
2011,5121,12645,16036,288370,289299,2392,15.073,2059,12.975,41886,16124,25762,5.573,14.478,44156,12686,31470,4.385,15.263,-2270,-0.785,28.957,1254,1268,4931
2011,5122,2737,3019,22517,22544,437,14.411,464,15.301,2898,1139,1759,5.052,12.855,2933,1254,1679,5.562,13.01,-35,-0.155,25.71,320,321,812
2011,5151,4062,8731,212198,215812,1059,11.98,1276,14.435,23978,10805,13173,5.007,11.111,31220,12625,18595,5.85,14.466,-7242,-3.356,22.221,215,220,1659
2011,5152,393,777,48733,46784,110,14.608,62,8.234,10889,8153,2736,17.427,23.275,6679,2645,4034,5.654,14.276,4210,8.999,28.552,36,36,575
2011,5173,4174,44671,1046617,1069705,6402,14.268,6801,15.157,148802,78538,70264,7.342,13.911,192180,95950,96230,8.97,17.966,-43378,-4.055,27.821,355,391,4008
2011,5174,380,497,8346,8212,70,14.042,73,14.644,1237,378,859,4.603,15.063,971,476,495,5.796,11.824,266,3.239,23.648,49,49,367
2011,5179,3611,4066,51487,52064,490,11.693,739,17.635,9545,3310,6235,6.358,18.333,10705,4400,6305,8.451,20.561,-1160,-2.228,36.667,594,608,3312
2011,5182,7933,12568,419933,407400,1926,15.661,1386,11.27,99488,40003,59485,9.819,24.42,74797,22369,52428,5.491,18.36,24691,6.061,36.719,718,854,8354
2011,5191,6669,8664,176956,169416,1529,18.168,1033,12.274,35352,12607,22745,7.441,20.867,19828,7244,12584,4.276,11.704,15524,9.163,23.408,703,712,3190
2011,5211,12,47,18039,18449,0,0,(D),(D),468,0,468,0,2.537,1355,(D),514,(D),7.345,-887,-4.808,5.073,0,0,0
2011,5221,13634,124763,2003543,1993638,5410,4.332,5665,4.536,228757,53997,174760,2.708,11.474,212382,51346,161036,2.575,10.653,16375,0.821,21.306,356,539,6497
2011,5222,13471,39670,522077,522804,5188,13.048,5367,13.499,103171,38143,65028,7.296,19.734,103037,42456,60581,8.121,19.709,134,0.026,39.417,1494,1666,8810
2011,5223,12561,28550,245495,251340,2329,7.819,4802,16.121,38035,15162,22873,6.032,15.133,49798,22055,27743,8.775,19.813,-11763,-4.68,30.266,2588,2881,9986
2011,5231,11631,41580,419714,434481,4965,11.762,6227,14.752,58943,18459,40484,4.249,13.566,88954,50065,38889,11.523,20.474,-30011,-6.907,27.133,903,929,4899
2011,5232,18,33,4975,4969,4,7.207,(D),(D),561,71,490,1.429,11.291,557,(D),237,(D),11.211,4,0.081,22.421,0,0,0
2011,5239,38158,43867,448083,445085,5770,13.202,5449,12.467,66954,26995,39959,6.065,15.043,61220,26305,34915,5.91,13.755,5734,1.288,27.509,3478,3518,11930
2011,5241,5408,29927,1383417,1403982,3444,11.198,5102,16.589,134958,51615,83343,3.676,9.613,175924,58821,117103,4.19,12.53,-40966,-2.918,19.225,399,430,2596
2011,5242,117398,132025,848226,850500,10481,7.899,11798,8.892,111615,42717,68898,5.023,13.123,116074,44636,71438,5.248,13.648,-4459,-0.524,26.247,8138,8274,24770
2011,5259,523,536,4303,5119,108,19.286,156,27.857,497,286,211,5.588,9.71,2118,862,1256,16.841,41.379,-1621,-31.669,19.42,138,138,811
2011,5311,82876,106503,514312,516675,9788,9.229,8895,8.387,71549,32698,38851,6.329,13.848,76456,31184,45272,6.036,14.798,-4907,-0.95,27.696,6156,6217,19109
2011,5312,56402,67111,263338,268428,10340,15.206,12119,17.822,49923,25737,24186,9.588,18.598,59660,28474,31186,10.608,22.226,-9737,-3.627,37.197,7317,7480,15020
2011,5313,59746,74054,610599,609495,8739,11.843,8214,11.131,88093,35171,52922,5.771,14.453,85965,35728,50237,5.862,14.104,2128,0.349,28.209,5221,5280,19374
2011,5321,3620,10712,148154,147993,1680,15.878,1417,13.393,23501,12197,11304,8.242,15.88,23285,14917,8368,10.08,15.734,216,0.146,31.468,341,353,1298
2011,5322,8201,22078,170024,180718,2279,9.559,5808,24.36,24091,8496,15595,4.701,13.331,47096,32791,14305,18.145,26.061,-23005,-12.73,26.662,1134,4027,22554
2011,5323,2496,3823,23911,24298,211,5.395,387,9.895,2827,791,2036,3.255,11.635,3684,1519,2165,6.252,15.162,-857,-3.527,23.269,175,253,765
2011,5324,7024,12930,146867,144462,1517,11.85,1260,9.843,25124,9322,15802,6.453,17.391,20368,7684,12684,5.319,14.099,4756,3.292,28.199,631,716,3596
2011,5331,1941,2052,29087,28896,266,12.963,266,12.963,4981,1958,3023,6.776,17.238,4638,2210,2428,7.648,16.051,343,1.187,32.101,201,201,830
2011,5411,159937,170175,1140300,1144620,13610,7.985,14150,8.302,116751,39460,77291,3.447,10.2,125690,38237,87453,3.341,10.981,-8939,-0.781,20.4,10312,10427,27743
2011,5412,97679,113217,1267038,1264987,10796,9.542,10650,9.413,213346,59799,153547,4.727,16.865,210468,80582,129886,6.37,16.638,2878,0.228,33.276,6665,6711,37886
2011,5413,79054,95379,1276656,1281095,9944,10.361,11144,11.611,185357,65485,119872,5.112,14.469,195027,60183,134844,4.698,15.223,-9670,-0.755,28.937,6267,6383,22161
2011,5414,24044,24319,106972,105766,3482,14.189,3926,15.998,21659,7652,14007,7.235,20.478,19547,9636,9911,9.111,18.481,2112,1.997,36.963,2660,2664,7168
2011,5415,88288,106325,1478975,1452766,18819,17.947,15889,15.153,307107,91428,215679,6.293,21.139,255034,78709,176325,5.418,17.555,52073,3.584,35.11,9887,10001,39013
2011,5416,105987,114414,920421,893433,21613,19.17,18272,16.207,199957,78405,121552,8.776,22.381,146533,65036,81497,7.279,16.401,53424,5.98,32.802,12839,12907,38212
2011,5417,12065,15454,684727,683388,1989,13.008,1663,10.876,72614,15429,57185,2.258,10.626,70007,22389,47618,3.276,10.244,2607,0.381,20.488,981,991,6664
2011,5418,29652,33154,424429,418512,3811,11.435,4156,12.471,66917,19998,46919,4.778,15.989,54835,23389,31446,5.589,13.102,12082,2.887,26.205,2988,3015,13776
2011,5419,51124,60730,577912,577546,5624,9.257,5669,9.331,84198,26932,57266,4.663,14.579,84283,31039,53244,5.374,14.593,-85,-0.015,29.157,3998,4062,15607
2011,5511,26596,50738,2964172,2916847,4305,8.521,3871,7.662,474271,146351,327920,5.017,16.26,378298,95882,282416,3.287,12.969,95973,3.29,25.939,851,885,12882
2011,5611,23734,25899,412185,401845,3573,13.953,2989,11.673,76338,25400,50938,6.321,18.997,55072,20888,34184,5.198,13.705,21266,5.292,27.41,2132,2172,14987
2011,5612,1765,5501,268797,262596,593,10.74,634,11.482,46643,9892,36751,3.767,17.762,32962,10297,22665,3.921,12.552,13681,5.21,25.105,93,111,2395
2011,5613,24236,43338,4376217,4189301,5602,12.912,5696,13.129,1107218,177199,930019,4.23,26.43,720552,234413,486139,5.596,17.2,386666,9.23,34.4,2701,2837,94441
2011,5614,24832,31057,753798,763183,3091,9.852,3725,11.873,121978,37371,84607,4.897,15.983,140192,44439,95753,5.823,18.369,-18214,-2.387,31.966,2636,2690,22576
2011,5615,13034,18801,225603,226728,2644,14.046,2689,14.285,30751,12708,18043,5.605,13.563,33064,13274,19790,5.855,14.583,-2313,-1.02,27.126,1126,1160,4596
2011,5616,17263,23387,796087,789327,2406,10.249,2583,11.003,110915,30852,80063,3.909,14.052,97673,31463,66210,3.986,12.374,13242,1.678,24.748,1591,1615,15706
2011,5617,134913,141987,1627923,1614873,19284,13.573,19452,13.692,276245,77729,198516,4.813,17.106,251870,87244,164626,5.403,15.597,24375,1.509,31.194,12924,12947,56560
2011,5619,15620,17677,267788,261107,1809,10.247,1763,9.986,44181,11469,32712,4.392,16.921,30930,10653,20277,4.08,11.846,13251,5.075,23.691,1184,1193,5901
2011,5621,7158,10060,185662,186326,1400,14.268,905,9.223,28605,15150,13455,8.131,15.352,30518,8482,22036,4.552,16.379,-1913,-1.027,30.704,565,570,3660
2011,5622,1303,2586,52703,52245,270,10.642,172,6.78,7260,3143,4117,6.016,13.896,6261,1967,4294,3.765,11.984,999,1.912,23.968,93,93,762
2011,5629,7641,9157,125657,121581,1223,13.725,730,8.193,27334,9933,17401,8.17,22.482,19475,4535,14940,3.73,16.018,7859,6.464,32.036,487,489,3180
2011,6111,18063,20420,870598,860577,969,4.765,797,3.92,74344,20513,53831,2.384,8.639,53849,11121,42728,1.292,6.257,20495,2.382,12.515,581,585,8121
2011,6112,451,919,91671,88725,51,5.607,32,3.518,11270,1460,9810,1.646,12.702,5407,772,4635,0.87,6.094,5863,6.608,12.188,20,22,254
2011,6113,2161,4035,1770652,1742773,497,12.396,446,11.124,124925,15949,108976,0.915,7.168,69362,7836,61526,0.45,3.98,55563,3.188,7.96,50,50,1281
2011,6114,6314,6890,65172,64114,880,12.869,776,11.348,11328,4161,7167,6.49,17.669,9121,3241,5880,5.055,14.226,2207,3.442,28.452,510,514,2189
2011,6115,6020,7722,137336,134933,713,9.254,678,8.8,22889,8706,14183,6.452,16.963,18078,4607,13471,3.414,13.398,4811,3.565,26.796,444,454,2273
2011,6116,34372,37396,362107,351601,4983,13.53,3851,10.456,76962,25403,51559,7.225,21.889,55458,16971,38487,4.827,15.773,21504,6.116,31.546,2872,2906,12276
2011,6117,5280,6090,89796,84535,979,16.374,757,12.661,20062,5356,14706,6.336,23.732,9503,3239,6264,3.832,11.242,10559,12.491,22.483,558,559,2047
2011,6211,173521,207526,2237677,2220784,15279,7.374,14632,7.062,280070,102158,177912,4.6,12.611,246209,87957,158252,3.961,11.087,33861,1.525,22.173,10312,10621,54589
2011,6212,118466,125993,854454,849993,6511,5.198,5035,4.02,95282,32042,63240,3.77,11.21,86006,22642,63364,2.664,10.118,9276,1.091,20.237,4062,4126,18527
2011,6213,110335,124752,707704,693922,11752,9.522,9082,7.359,118965,49259,69706,7.099,17.144,90972,31343,59629,4.517,13.11,27993,4.034,26.22,6209,6294,20554
2011,6214,14706,33095,740561,728461,2331,7.122,1601,4.892,90138,27456,62682,3.769,12.374,65434,19313,46121,2.651,8.982,24704,3.391,17.965,829,862,7574
2011,6215,7115,12509,249909,249302,1097,8.73,1210,9.63,27993,8155,19838,3.271,11.229,26773,9021,17752,3.619,10.739,1220,0.489,21.478,622,713,4407
2011,6216,18728,27108,1243983,1214649,3672,13.926,2193,8.317,192377,47048,145329,3.873,15.838,134479,37586,96893,3.094,11.071,57898,4.767,22.143,1419,1444,21926
2011,6219,6021,9521,288786,286658,930,9.835,801,8.47,36280,10913,25367,3.807,12.656,31913,11283,20630,3.936,11.133,4367,1.523,22.266,392,413,6018
2011,6221,2919,5085,5167938,5146810,71,1.398,61,1.201,197627,21501,176126,0.418,3.84,154730,19119,135611,0.371,3.006,42897,0.833,6.013,28,28,5761
2011,6222,431,603,218419,218728,15,2.479,19,3.14,7546,2312,5234,1.057,3.45,8144,2861,5283,1.308,3.723,-598,-0.273,6.9,8,8,1836
2011,6223,370,892,263453,262301,38,4.274,32,3.6,17716,6042,11674,2.303,6.754,15607,5279,10328,2.013,5.95,2109,0.804,11.9,18,18,2499
2011,6231,8021,16126,1633677,1629269,1281,8.039,897,5.629,120060,48807,71253,2.996,7.369,112100,40315,71785,2.474,6.88,7960,0.489,13.761,336,345,18255
2011,6232,8919,34679,647353,646322,1385,3.989,1462,4.211,62691,13896,48795,2.15,9.7,60449,13887,46562,2.149,9.353,2242,0.347,18.706,358,514,5765
2011,6233,15062,21522,832228,825185,1827,8.549,1526,7.14,82411,29049,53362,3.52,9.987,68801,29131,39670,3.53,8.338,13610,1.649,16.675,1022,1103,21093
2011,6239,3186,5588,139337,139949,468,8.38,461,8.255,15759,3595,12164,2.569,11.261,17148,5429,11719,3.879,12.253,-1389,-0.993,22.521,233,251,2692
2011,6241,42310,59274,1383845,1362192,5417,9.244,4071,6.947,178503,43681,134822,3.207,13.104,135665,34321,101344,2.52,9.959,42838,3.145,19.919,2497,2550,18495
2011,6242,9925,13623,178991,178041,619,4.516,784,5.72,20256,3914,16342,2.198,11.377,18294,6070,12224,3.409,10.275,1962,1.102,20.55,518,528,4286
2011,6243,4160,7975,356179,351184,566,7.185,371,4.71,47145,8391,38754,2.389,13.425,37218,5100,32118,1.452,10.598,9927,2.827,21.196,163,178,1964
2011,6244,55403,70869,866417,863913,6539,9.24,6331,8.947,109436,39338,70098,4.553,12.667,104257,36668,67589,4.244,12.068,5179,0.599,24.136,4708,4778,26318
2011,7111,6895,7036,113239,114800,765,10.833,816,11.556,20102,5945,14157,5.179,17.51,23691,4862,18829,4.235,20.637,-3589,-3.126,35.021,526,527,3478
2011,7112,3267,3433,124554,122738,453,13.113,496,14.358,17237,3432,13805,2.796,14.044,13408,3076,10332,2.506,10.924,3829,3.12,21.848,390,392,2626
2011,7113,5321,5664,129040,128886,669,11.916,570,10.152,18752,3612,15140,2.802,14.549,18596,4583,14013,3.556,14.428,156,0.121,28.857,428,428,1695
2011,7114,2788,2893,17536,17510,433,15.148,364,12.734,2779,1271,1508,7.259,15.871,2692,937,1755,5.351,15.375,87,0.497,30.749,268,268,678
2011,7115,13358,13386,42417,42822,2542,19.121,2359,17.744,11195,5679,5516,13.262,26.143,12234,5716,6518,13.348,28.57,-1039,-2.426,52.287,1429,1430,3320
2011,7121,6329,6797,128845,127464,315,4.63,328,4.821,10332,1140,9192,0.894,8.106,7588,1194,6394,0.937,5.953,2744,2.153,11.906,196,196,889
2011,7131,2238,2626,147935,147995,377,14.428,351,13.433,19844,6175,13669,4.172,13.409,19863,4065,15798,2.747,13.421,-19,-0.013,26.817,266,270,2498
2011,7132,1770,2622,164739,166656,282,10.901,212,8.195,12311,4816,7495,2.89,7.387,16437,4518,11919,2.711,9.863,-4126,-2.476,14.774,153,157,3040
2011,7139,48080,55041,1128457,1128713,5793,10.51,5946,10.788,139590,52150,87440,4.62,12.367,140055,43820,96235,3.882,12.408,-465,-0.041,24.734,4490,4545,32024
2011,7211,38626,49635,1813598,1795791,3802,7.681,3532,7.135,183777,71567,112210,3.985,10.234,149162,54198,94964,3.018,8.306,34615,1.928,16.612,2394,2444,35687
2011,7212,5195,5767,38446,38470,460,7.962,481,8.325,5802,1573,4229,4.089,15.082,5873,1398,4475,3.634,15.267,-71,-0.185,30.164,284,285,843
2011,7213,1856,1966,10617,10499,106,5.381,114,5.787,1451,484,967,4.61,13.821,1225,284,941,2.705,11.668,226,2.153,23.337,75,76,216
2011,7223,12076,35790,664209,655925,3435,9.619,3274,9.168,88874,26814,62060,4.088,13.549,72557,23428,49129,3.572,11.062,16317,2.488,22.124,1493,1502,7698
2011,7224,38989,39730,348045,348450,3956,9.855,4778,11.903,64252,29793,34459,8.55,18.439,64900,27352,37548,7.85,18.625,-648,-0.186,36.879,3887,3894,22788
2011,7225,334242,461999,8681529,8593306,51265,11.187,43753,9.548,1271306,633920,637386,7.377,14.794,1090217,398504,691713,4.637,12.687,181089,2.107,25.374,34786,35828,297585
2011,8111,133070,145518,801495,797002,12337,8.465,12791,8.776,114330,42478,71852,5.33,14.345,105262,38370,66892,4.814,13.207,9068,1.138,26.415,9049,9250,27724
2011,8112,9904,11329,109771,111525,1280,11.261,1356,11.929,14481,6502,7979,5.83,12.985,17722,7193,10529,6.45,15.891,-3241,-2.906,25.969,967,987,3641
2011,8113,17968,19685,187057,184342,1616,8.181,1751,8.865,32765,9703,23062,5.264,17.774,27723,7183,20540,3.897,15.039,5042,2.735,30.078,1173,1182,4189
2011,8114,16667,17379,67804,68943,1955,11.17,2203,12.586,10838,4572,6266,6.632,15.72,13139,5982,7157,8.677,19.058,-2301,-3.338,31.44,1542,1544,3390
2011,8121,87246,103411,631866,629341,12469,12.108,11615,11.278,103672,46814,56858,7.439,16.473,99003,40354,58649,6.412,15.731,4669,0.742,31.462,9139,9275,31656
2011,8122,14410,20016,136337,135181,1015,5.087,885,4.436,17866,5638,12228,4.171,13.216,15767,3102,12665,2.295,11.664,2099,1.553,23.327,468,496,1696
2011,8123,29031,34428,296756,301120,2721,7.857,3132,9.043,30361,12291,18070,4.082,10.083,39200,14706,24494,4.884,13.018,-8839,-2.935,20.165,2326,2430,9788
2011,8129,22478,33118,243843,242016,4807,14.709,3931,12.029,46885,18218,28667,7.528,19.373,43738,16426,27312,6.787,18.072,3147,1.3,36.145,2167,2196,8670
2011,8131,174414,174753,1666091,1676759,8515,4.87,8716,4.985,158272,28302,129970,1.688,9.439,179767,24830,154937,1.481,10.721,-21495,-1.282,18.878,5444,5444,16081
2011,8132,15416,17384,171972,169546,1470,8.563,1036,6.035,20028,4175,15853,2.462,11.813,15079,4113,10966,2.426,8.894,4949,2.919,17.788,696,705,2721
2011,8133,13330,15804,146821,144246,1339,8.555,1035,6.613,19481,4362,15119,3.024,13.505,14456,3573,10883,2.477,10.022,5025,3.484,20.044,663,663,2395
2011,8134,23447,25325,235341,236919,1130,4.43,1494,5.857,24080,4860,19220,2.051,10.164,27149,5623,21526,2.373,11.459,-3069,-1.295,20.328,1042,1047,3781
2011,8139,54916,57223,488821,493980,2410,4.177,3350,5.807,44490,8370,36120,1.694,9.006,54969,12892,42077,2.61,11.128,-10479,-2.121,18.013,2321,2322,8329
2012,1131,321,336,2095,2048,30,8.982,26,7.784,302,68,234,3.32,14.746,207,75,132,3.662,10.107,95,4.639,20.215,18,18,44
2012,1132,128,145,1604,1580,19,13.103,19,13.103,392,77,315,4.875,24.818,374,61,313,3.862,23.678,18,1.14,47.357,11,11,39
2012,1133,7115,7208,48828,49257,691,9.564,725,10.035,7074,2080,4994,4.223,14.361,7997,2781,5216,5.646,16.235,-923,-1.874,28.723,511,511,1907
2012,1141,1196,1207,6076,6079,226,19.072,182,15.359,1159,518,641,8.521,19.066,1177,396,781,6.514,19.362,-18,-0.296,38.131,108,108,238
2012,1142,243,243,1609,1553,27,11.273,20,8.351,265,75,190,4.831,17.069,153,69,84,4.444,9.855,112,7.214,19.71,14,14,48
2012,1151,3474,3817,65943,65091,425,11.281,326,8.653,10714,2865,7849,4.402,16.46,9049,2115,6934,3.249,13.902,1665,2.558,27.804,212,215,1361
2012,1152,3663,3768,19851,19449,434,11.589,388,10.36,3387,1210,2177,6.222,17.415,2545,1014,1531,5.214,13.086,842,4.329,26.172,298,298,708
2012,1153,1248,1334,10499,10593,161,12.188,135,10.22,1793,416,1377,3.927,16.926,1964,560,1404,5.287,18.541,-171,-1.614,33.853,82,82,362
2012,2111,5890,7313,127894,121261,669,9.221,553,7.622,23248,6283,16965,5.181,19.172,10236,4336,5900,3.576,8.441,13012,10.731,16.883,356,361,1670
2012,2121,539,988,90709,88106,94,9.471,103,10.378,14027,4446,9581,5.046,15.921,9025,2774,6251,3.148,10.243,5002,5.677,20.487,52,53,1064
2012,2122,258,325,40002,37534,50,15.873,30,9.524,6086,330,5756,0.879,16.215,1335,488,847,1.3,3.557,4751,12.658,7.114,22,22,151
2012,2123,2818,4869,76703,78302,321,6.577,345,7.068,11179,2385,8794,3.046,14.277,14465,3141,11324,4.011,18.473,-3286,-4.197,28.554,160,164,1047
2012,2131,10254,12804,393641,364718,1869,15.038,1118,8.995,101013,26749,74264,7.334,27.696,43698,15334,28364,4.204,11.981,57315,15.715,23.963,707,722,7933
2012,2211,1668,10271,514848,515934,551,5.408,388,3.808,33293,10909,22384,2.114,6.453,35638,5443,30195,1.055,6.907,-2345,-0.455,12.906,75,76,1298
2012,2212,433,2428,84654,84289,127,5.141,212,8.581,8000,2670,5330,3.168,9.491,7361,3270,4091,3.88,8.733,639,0.758,17.466,20,25,201
2012,2213,3447,4644,43557,42938,254,5.509,187,4.056,4636,1393,3243,3.244,10.797,3412,721,2691,1.679,7.946,1224,2.851,15.893,104,104,253
2012,2361,119885,120981,530380,523500,23627,19.714,21367,17.828,135947,61726,74221,11.791,25.969,121636,54410,67226,10.394,23.235,14311,2.734,46.47,13165,13186,34874
2012,2362,35726,37087,552064,550102,3839,10.285,4317,11.566,99299,19051,80248,3.463,18.051,95411,26864,68547,4.883,17.344,3888,0.707,34.689,2845,2851,16412
2012,2371,16300,17739,488197,470446,1646,9.25,1758,9.879,98823,13711,85112,2.914,21.006,64205,15506,48699,3.296,13.648,34618,7.359,27.295,1060,1071,7544
2012,2372,4926,4987,23497,24432,483,9.305,891,17.164,3763,1263,2500,5.169,15.402,5553,2912,2641,11.919,22.728,-1790,-7.326,30.804,679,679,2209
2012,2373,8362,9146,260877,257028,691,7.515,789,8.581,44257,8349,35908,3.248,17.219,36584,7272,29312,2.829,14.233,7673,2.985,28.467,462,465,4009
2012,2379,3554,3669,87728,87725,463,12.755,385,10.606,13859,2675,11184,3.049,15.798,14013,3083,10930,3.514,15.974,-154,-0.176,31.596,226,226,1032
2012,2381,70761,71489,661814,650177,10938,15.379,10210,14.355,161295,40408,120887,6.215,24.808,138116,44179,93937,6.795,21.243,23179,3.565,42.486,6498,6558,30821
2012,2382,149272,153213,1620704,1604152,15214,9.953,14503,9.488,272209,56005,216204,3.491,16.969,238353,69221,169132,4.315,14.859,33856,2.111,29.717,9779,9805,44373
2012,2383,86306,87269,608951,607746,12286,14.05,12635,14.449,131683,35691,95992,5.873,21.667,129287,45359,83928,7.463,21.273,2396,0.394,42.546,8129,8158,33417
2012,2389,51334,52014,470482,459688,7436,14.435,6437,12.496,100063,22860,77203,4.973,21.768,78051,25342,52709,5.513,16.979,22012,4.788,33.958,4040,4050,17432
2012,3111,1036,1624,44274,46753,66,4.024,98,5.976,3574,653,2921,1.397,7.645,8181,1219,6962,2.607,17.499,-4607,-9.854,15.289,65,65,347
2012,3112,428,789,54445,54297,58,7.426,42,5.378,3952,897,3055,1.652,7.279,3612,1023,2589,1.884,6.652,340,0.626,13.305,22,22,379
2012,3113,1557,1724,70481,69748,153,8.963,119,6.971,7996,1710,6286,2.452,11.464,6432,1856,4576,2.661,9.222,1564,2.242,18.444,89,90,1131
2012,3114,1277,1636,155466,155496,122,7.536,88,5.435,12489,2334,10155,1.501,8.032,12693,2771,9922,1.782,8.163,-204,-0.131,16.063,56,56,1364
2012,3115,1012,1520,133935,134735,103,6.839,75,4.98,8326,1138,7188,0.845,6.18,10028,2387,7641,1.772,7.443,-1702,-1.263,12.359,43,43,1456
2012,3116,2822,3416,487955,488820,171,4.966,226,6.563,26697,3181,23516,0.651,5.462,28624,7805,20819,1.597,5.856,-1927,-0.394,10.923,158,158,3047
2012,3117,449,544,32132,31931,33,6.049,36,6.599,4004,1189,2815,3.724,12.54,3517,1100,2417,3.445,11.014,487,1.525,22.029,30,30,829
2012,3118,9117,9847,277561,277820,1069,11.026,766,7.901,29074,8803,20271,3.169,10.465,28993,7097,21896,2.555,10.436,81,0.029,20.872,602,611,4779
2012,3119,2609,3045,163710,161252,251,8.287,219,7.23,16812,4119,12693,2.554,10.426,11990,3477,8513,2.156,7.436,4822,2.99,14.871,170,170,2250
2012,3121,3793,4394,135265,133373,567,13.327,288,6.769,14645,3891,10754,2.917,10.98,10963,3129,7834,2.346,8.22,3682,2.761,16.44,201,204,1205
2012,3122,89,111,14876,15068,12,10.48,19,16.594,1400,266,1134,1.765,9.292,1779,269,1510,1.785,11.807,-379,-2.515,18.583,13,13,37
2012,3131,231,300,25019,26040,11,3.554,30,9.693,1020,45,975,0.173,3.917,3036,1019,2017,3.913,11.659,-2016,-7.742,7.834,17,17,128
2012,3132,835,920,50496,50357,42,4.494,71,7.598,4175,678,3497,1.346,8.291,3944,1497,2447,2.973,7.832,231,0.459,15.664,54,55,1072
2012,3133,965,1009,30623,30956,51,5.005,71,6.968,2310,463,1847,1.496,7.462,3011,1367,1644,4.416,9.727,-701,-2.265,14.924,52,52,693
2012,3141,1747,1871,51307,52694,115,6.005,203,10.601,4570,1525,3045,2.894,8.673,7309,2446,4863,4.642,13.871,-2739,-5.198,17.346,144,151,1019
2012,3149,3846,3952,62008,60567,314,7.943,316,7.994,8414,2007,6407,3.314,13.892,5486,1200,4286,1.981,9.058,2928,4.834,18.116,237,238,954
2012,3151,246,261,12821,13063,11,4.143,20,7.533,798,104,694,0.796,6.109,1303,408,895,3.123,9.975,-505,-3.866,12.218,17,17,404
2012,3152,4764,4812,88025,86439,785,16.3,793,16.466,17072,5942,11130,6.874,19.75,13730,7522,6208,8.702,15.884,3342,3.866,31.768,687,690,6184
2012,3159,488,499,8075,8243,52,10.176,76,14.873,718,262,456,3.178,8.71,1069,445,624,5.399,12.969,-351,-4.258,17.421,60,60,330
2012,3161,170,179,3512,3598,10,5.51,15,8.264,230,33,197,0.917,6.393,411,111,300,3.085,11.425,-181,-5.031,12.787,12,12,33
2012,3162,179,198,11248,11278,18,9.045,20,10.05,855,102,753,0.904,7.581,939,447,492,3.963,8.326,-84,-0.745,15.162,13,13,66
2012,3169,648,651,11966,11890,61,9.349,64,9.808,1476,563,913,4.735,12.414,1337,371,966,3.12,11.245,139,1.169,22.49,47,48,296
2012,3211,2757,3136,76339,76713,206,6.495,277,8.734,7604,1823,5781,2.376,9.912,8397,3147,5250,4.102,10.946,-793,-1.034,19.825,176,185,1930
2012,3212,1117,1387,59505,60370,58,4.097,115,8.124,5637,960,4677,1.59,9.337,7309,3143,4166,5.206,12.107,-1672,-2.77,18.675,69,70,981
2012,3219,7527,8418,205866,205997,507,5.953,704,8.266,23246,4239,19007,2.058,11.285,23616,7045,16571,3.42,11.464,-370,-0.18,22.569,494,504,4653
2012,3221,149,364,107146,108648,13,3.537,20,5.442,2995,951,2044,0.875,2.757,5840,1708,4132,1.572,5.375,-2845,-2.619,5.513,8,8,744
2012,3222,2675,3964,247493,251422,125,3.118,216,5.387,15150,2728,12422,1.085,6.026,22703,8789,13914,3.496,9.03,-7553,-3.004,12.051,119,123,2608
2012,3231,24924,26189,473750,479469,1406,5.289,2193,8.25,38634,10166,28468,2.12,8.058,50201,19007,31194,3.964,10.47,-11567,-2.412,16.115,1721,1727,11044
2012,3241,948,2131,98723,99148,121,5.667,129,6.042,5944,746,5198,0.752,5.995,6912,2023,4889,2.04,6.971,-968,-0.976,11.99,51,51,377
2012,3251,1362,2431,155278,155024,122,5.045,96,3.97,10792,1711,9081,1.104,6.962,10097,1655,8442,1.068,6.513,695,0.448,13.026,54,54,701
2012,3252,1063,1388,90488,89060,51,3.661,61,4.379,7988,1066,6922,1.197,8.969,5084,1374,3710,1.543,5.709,2904,3.261,11.417,34,34,606
2012,3253,638,881,29512,29231,67,7.679,50,5.731,2645,446,2199,1.526,9.049,2087,554,1533,1.895,7.14,558,1.909,14.279,28,28,272
2012,3254,1571,2043,236808,234261,151,7.462,112,5.535,17817,2452,15365,1.047,7.606,12609,2993,9616,1.278,5.382,5208,2.223,10.765,78,78,2076
2012,3255,1309,1652,55057,54747,68,4.104,78,4.707,4390,915,3475,1.671,8.019,3766,804,2962,1.469,6.879,624,1.14,13.758,49,49,339
2012,3256,1902,2096,93530,93595,130,6.183,143,6.801,7864,2426,5438,2.592,8.402,8162,2253,5909,2.407,8.721,-298,-0.318,16.804,107,107,1020
2012,3259,1826,2310,81473,81503,138,5.955,153,6.602,6970,1190,5780,1.46,8.552,7069,2409,4660,2.956,8.673,-99,-0.121,17.104,90,95,1483
2012,3261,8216,10469,573802,571155,414,3.926,566,5.367,51712,8778,42934,1.537,9.054,46310,11738,34572,2.055,8.108,5402,0.946,16.216,371,372,5069
2012,3262,1479,1887,128205,126278,67,3.524,95,4.997,11012,2543,8469,2.014,8.72,7085,1798,5287,1.424,5.611,3927,3.11,11.221,55,55,340
2012,3271,965,1153,34160,34097,64,5.496,87,7.471,3424,884,2540,2.593,10.042,3223,404,2819,1.185,9.453,201,0.59,18.905,61,61,277
2012,3272,1434,1707,83605,83054,120,7.038,116,6.804,6935,1075,5860,1.294,8.35,5743,1980,3763,2.384,6.915,1192,1.435,13.83,70,70,413
2012,3273,4148,8471,146433,146999,416,4.849,631,7.356,18972,3674,15298,2.499,12.906,19839,4828,15011,3.284,13.496,-867,-0.59,25.812,225,249,1652
2012,3274,169,300,12254,12347,14,4.613,21,6.919,678,112,566,0.907,5.491,853,110,743,0.891,6.909,-175,-1.417,10.982,14,14,76
2012,3279,2565,3019,69777,68709,202,6.647,242,7.963,7973,1890,6083,2.751,11.604,5854,1675,4179,2.438,8.52,2119,3.084,17.04,181,182,1060
2012,3311,254,403,103994,102495,12,2.916,29,7.047,6082,340,5742,0.332,5.934,3081,405,2676,0.395,3.006,3001,2.928,6.012,18,18,138
2012,3312,524,650,47731,45965,40,6.14,43,6.6,5658,891,4767,1.938,12.309,2174,660,1514,1.436,4.73,3484,7.58,9.459,26,26,488
2012,3313,394,521,54689,53230,21,4.019,24,4.593,5132,577,4555,1.084,9.641,2218,267,1951,0.502,4.167,2914,5.474,8.334,17,17,138
2012,3314,801,1004,63181,62086,57,5.729,39,3.92,5455,642,4813,1.034,8.786,3264,776,2488,1.25,5.257,2191,3.529,10.515,27,27,529
2012,3315,1607,1806,126712,121567,74,4.081,89,4.908,15610,1683,13927,1.384,12.841,5331,1488,3843,1.224,4.385,10279,8.455,8.771,55,56,586
2012,3321,2261,2484,113032,109550,61,2.428,117,4.658,12843,1432,11411,1.307,11.723,5937,2448,3489,2.235,5.419,6906,6.304,10.839,74,74,1179
2012,3322,1053,1142,36130,36395,55,4.77,77,6.678,1996,146,1850,0.401,5.484,2525,608,1917,1.671,6.938,-529,-1.454,10.969,56,56,270
2012,3323,10925,11851,319050,314700,579,4.834,831,6.938,38259,6105,32154,1.94,12.157,29434,10609,18825,3.371,9.353,8825,2.804,18.706,580,587,6541
2012,3324,1181,1486,87972,86016,57,3.817,72,4.821,9693,1555,8138,1.808,11.269,5824,1463,4361,1.701,6.771,3869,4.498,13.542,53,55,851
2012,3325,529,584,27007,26965,31,5.286,36,6.138,1892,143,1749,0.53,7.017,1813,308,1505,1.142,6.724,79,0.293,13.447,27,27,173
2012,3326,1108,1252,37687,37436,40,3.168,61,4.832,3453,588,2865,1.571,9.224,2961,717,2244,1.915,7.91,492,1.314,15.819,46,46,581
2012,3327,22189,22647,385853,373690,1285,5.7,1075,4.769,49249,9211,40038,2.465,13.179,24941,7697,17244,2.06,6.674,24308,6.505,13.349,778,779,4956
2012,3328,5053,5567,122898,120373,285,5.122,279,5.014,14433,2575,11858,2.139,11.99,9433,3453,5980,2.869,7.836,5000,4.154,15.673,193,194,1967
2012,3329,5520,6047,253469,247618,439,7.313,351,5.847,28139,5430,22709,2.193,11.364,16452,5363,11089,2.166,6.644,11687,4.72,13.288,248,248,2735
2012,3331,2570,2934,213612,201640,154,5.266,135,4.616,32837,2835,30002,1.406,16.285,9249,3080,6169,1.527,4.587,23588,11.698,9.174,100,100,1417
2012,3332,2976,3140,96692,96486,154,4.88,185,5.863,9630,1342,8288,1.391,9.981,9061,2571,6490,2.665,9.391,569,0.59,18.782,136,136,1243
2012,3333,1813,1945,77734,78466,97,4.914,155,7.852,6039,766,5273,0.976,7.696,7551,2352,5199,2.997,9.623,-1512,-1.927,15.393,114,114,1104
2012,3334,1495,1766,128911,127455,84,4.734,101,5.692,12658,3273,9385,2.568,9.931,9970,1705,8265,1.338,7.822,2688,2.109,15.645,73,73,997
2012,3335,6289,6492,141257,137276,226,3.464,291,4.46,15552,2215,13337,1.614,11.329,7557,3091,4466,2.252,5.505,7995,5.824,11.01,199,202,1759
2012,3336,778,979,106101,101975,36,3.64,56,5.662,15384,3023,12361,2.964,15.086,6973,1298,5675,1.273,6.838,8411,8.248,13.676,41,41,390
2012,3339,5343,5971,282747,275520,300,5.025,298,4.992,29999,3193,26806,1.159,10.888,15587,5220,10367,1.895,5.657,14412,5.231,11.315,179,181,1695
2012,3341,970,1005,63862,66911,99,9.817,106,10.511,4216,1483,2733,2.216,6.301,10554,3581,6973,5.352,15.773,-6338,-9.472,12.602,79,79,2475
2012,3342,1276,1412,104226,108745,73,5.117,102,7.15,6782,1099,5683,1.011,6.237,15836,2096,13740,1.927,14.563,-9054,-8.326,12.473,77,79,1355
2012,3343,420,426,9289,9129,39,9.166,38,8.931,1054,279,775,3.056,11.546,719,132,587,1.446,7.876,335,3.67,15.752,32,32,117
2012,3344,3598,4044,280471,280791,250,6.164,273,6.732,23515,4550,18965,1.62,8.375,24503,7008,17495,2.496,8.726,-988,-0.352,16.749,188,190,3631
2012,3345,4473,5136,384159,389270,297,5.769,322,6.254,28968,6061,22907,1.557,7.442,39062,9895,29167,2.542,10.035,-10094,-2.593,14.883,199,199,3383
2012,3346,509,522,14838,15177,54,10.208,68,12.854,1474,716,758,4.718,9.712,2175,1167,1008,7.689,14.331,-701,-4.619,19.424,43,43,338
2012,3351,975,1052,43789,43769,66,6.283,63,5.997,4080,456,3624,1.042,9.322,4092,1773,2319,4.051,9.349,-12,-0.027,18.643,42,42,310
2012,3352,195,235,43438,43230,17,7.173,21,8.861,2900,328,2572,0.759,6.708,2475,984,1491,2.276,5.725,425,0.983,11.45,18,18,173
2012,3353,1820,2099,114666,112502,99,4.704,110,5.227,11331,1399,9932,1.244,10.072,6907,1957,4950,1.74,6.139,4424,3.932,12.279,70,70,648
2012,3359,1798,2079,131508,130835,138,6.696,102,4.949,11031,2022,9009,1.545,8.431,9816,1983,7833,1.516,7.503,1215,0.929,15.005,63,63,747
2012,3361,265,324,151411,144821,29,8.923,31,9.538,18970,122,18848,0.084,13.099,6284,2784,3500,1.922,4.339,12686,8.76,8.678,24,24,1961
2012,3362,1570,1828,117828,111475,117,6.425,103,5.656,18853,1585,17268,1.422,16.912,6321,2345,3976,2.104,5.67,12532,11.242,11.341,70,70,1076
2012,3363,4090,4971,465401,449648,262,5.263,276,5.544,59613,7087,52526,1.576,13.258,27980,10262,17718,2.282,6.223,31633,7.035,12.445,175,177,1928
2012,3364,1287,1693,364009,359861,88,5.164,110,6.455,36704,4106,32598,1.141,10.2,27240,6069,21171,1.686,7.57,9464,2.63,15.139,57,58,1261
2012,3365,153,231,29657,27718,14,6.022,17,7.312,5880,265,5615,0.956,21.214,1890,556,1334,2.006,6.819,3990,14.395,13.637,6,6,255
2012,3366,1344,1464,136333,132850,128,8.794,111,7.626,17391,4621,12770,3.478,13.091,10047,1133,8914,0.853,7.563,7344,5.528,15.125,74,74,568
2012,3369,788,817,34281,35519,89,10.927,84,10.313,4094,369,3725,1.039,11.526,6461,968,5493,2.725,18.19,-2367,-6.664,23.052,56,56,482
2012,3371,10568,10848,202188,202744,862,7.82,1211,10.987,21192,4614,16578,2.276,10.453,22550,8221,14329,4.055,11.122,-1358,-0.67,20.905,838,839,4843
2012,3372,3436,3610,107629,107449,195,5.332,289,7.903,10945,1385,9560,1.289,10.186,10650,3004,7646,2.796,9.912,295,0.275,19.823,196,196,1647
2012,3379,665,752,31120,31104,34,4.373,85,10.932,3289,415,2874,1.334,10.574,3124,1489,1635,4.787,10.044,165,0.53,20.088,61,65,1067
2012,3391,10025,10904,289094,287937,645,5.886,752,6.863,27467,6908,20559,2.399,9.539,25063,7191,17872,2.497,8.704,2404,0.835,17.409,565,565,3019
2012,3399,15149,15525,260119,255634,2100,13.898,1271,8.411,34744,11432,23312,4.472,13.591,25946,8502,17444,3.326,10.15,8798,3.442,20.299,946,948,5766
2012,4231,16245,23845,371157,365860,1601,6.716,1588,6.661,49381,11837,37544,3.235,13.497,39244,10935,28309,2.989,10.727,10137,2.771,21.453,943,994,5239
2012,4232,10163,11973,142271,141687,928,7.697,1095,9.082,18782,4834,13948,3.412,13.256,17626,6199,11427,4.375,12.44,1156,0.816,24.88,711,735,3850
2012,4233,9648,15834,187136,187895,971,6.033,1491,9.264,24145,5608,18537,2.985,12.85,25685,8925,16760,4.75,13.67,-1540,-0.82,25.701,751,786,4138
2012,4234,22330,33426,652045,647406,2685,7.99,3043,9.055,91541,21809,69732,3.369,14.14,82171,28913,53258,4.466,12.692,9370,1.447,25.385,1506,1553,9779
2012,4235,7434,10240,150874,147363,612,5.959,673,6.553,20984,4854,16130,3.294,14.24,13837,4892,8945,3.32,9.39,7147,4.85,18.78,336,346,2165
2012,4236,18668,28338,520986,514160,2356,8.277,2607,9.159,73980,18995,54985,3.694,14.389,60222,17516,42706,3.407,11.713,13758,2.676,23.425,1136,1156,6221
2012,4237,10307,19024,224391,223070,1018,5.35,1029,5.407,26625,7173,19452,3.216,11.936,23602,6071,17531,2.722,10.581,3023,1.355,21.161,439,477,2550
2012,4238,39548,56360,708663,693349,3258,5.763,3609,6.384,100933,21133,79800,3.048,14.557,70020,25095,44925,3.619,10.099,30913,4.459,20.198,1729,1856,10074
2012,4239,27765,31128,342590,333035,3711,12.124,2671,8.726,55620,16656,38964,5.001,16.701,36566,13174,23392,3.956,10.98,19054,5.721,21.959,1889,1936,8934
2012,4241,7895,10145,150342,153302,523,5.024,1052,10.106,13335,3901,9434,2.545,8.699,19440,8454,10986,5.515,12.681,-6105,-3.982,17.397,458,467,2107
2012,4242,5932,9113,285500,279610,831,9.119,830,9.108,43210,15062,28148,5.387,15.454,31142,8257,22885,2.953,11.138,12068,4.316,22.275,455,460,3282
2012,4243,13372,14567,196484,194023,1654,11.351,1664,11.419,30523,8647,21876,4.457,15.732,25550,8693,16857,4.48,13.169,4973,2.563,26.337,1247,1264,6253
2012,4244,24543,31447,755811,758311,2649,8.412,2739,8.697,87918,20263,67655,2.672,11.594,92580,26061,66519,3.437,12.209,-4662,-0.615,23.188,1738,1791,13018
2012,4245,3299,6028,59839,60354,282,4.658,333,5.501,7345,1633,5712,2.706,12.17,8427,1820,6607,3.016,13.963,-1082,-1.793,24.34,166,182,853
2012,4246,8217,12566,148360,147185,736,5.833,838,6.642,19461,4589,14872,3.118,13.222,16698,6792,9906,4.615,11.345,2763,1.877,22.69,369,378,2280
2012,4247,4345,6478,101487,101858,291,4.416,513,7.786,14676,3517,11159,3.453,14.408,15511,5229,10282,5.134,15.228,-835,-0.82,28.817,213,248,1649
2012,4248,3159,4106,184554,181931,336,8.201,318,7.762,17737,4134,13603,2.272,9.749,12425,5231,7194,2.875,6.83,5312,2.92,13.659,205,205,2207
2012,4249,20246,26517,321426,318945,2431,9.186,2326,8.789,44245,12230,32015,3.835,13.872,39616,12811,26805,4.017,12.421,4629,1.451,24.842,1512,1547,6647
2012,4251,34594,36877,272086,277290,4420,11.895,4981,13.405,53401,14969,38432,5.398,19.258,62785,19699,43086,7.104,22.642,-9384,-3.384,38.516,3631,3670,11669
2012,4411,37254,42249,1102342,1078494,3566,8.453,3438,8.15,125135,33694,91441,3.124,11.603,77674,31160,46514,2.889,7.202,47461,4.401,14.404,2417,2457,20759
2012,4412,11645,13158,124055,121632,982,7.409,1176,8.872,18565,5659,12906,4.653,15.263,13723,5499,8224,4.521,11.282,4842,3.981,22.565,771,796,3576
2012,4413,27260,54965,489843,484609,2892,5.282,2476,4.522,60439,15796,44643,3.26,12.472,50225,10257,39968,2.117,10.364,10214,2.108,20.728,1569,1629,6014
2012,4421,13661,22231,192367,194096,2214,9.873,2603,11.607,25334,8780,16554,4.524,13.052,28517,11630,16887,5.992,14.692,-3183,-1.64,26.105,1320,1539,7464
2012,4422,18669,26458,231178,228132,1974,7.376,2584,9.655,36236,16655,19581,7.301,15.884,30135,13485,16650,5.911,13.209,6101,2.674,26.419,1566,1627,5162
2012,4431,23577,45350,417110,421138,4618,10.093,5429,11.865,64998,22577,42421,5.361,15.434,72950,26340,46610,6.254,17.322,-7952,-1.888,30.868,2925,3197,13260
2012,4441,36363,58173,1023597,1025481,2628,4.466,3982,6.766,73480,15148,58332,1.477,7.165,76966,21557,55409,2.102,7.505,-3486,-0.34,14.331,2434,2575,10611
2012,4442,13221,16465,143945,142538,976,5.898,1144,6.913,19565,3936,15629,2.761,13.726,16650,4670,11980,3.276,11.681,2915,2.045,23.362,770,789,3164
2012,4451,58772,85116,2593264,2569729,8963,10.624,7461,8.844,248902,89177,159725,3.47,9.686,205116,60585,144531,2.358,7.982,43786,1.704,15.964,5386,5454,26503
2012,4452,15743,19514,138185,134494,2385,12.283,2191,11.284,29481,11039,18442,8.208,21.92,22083,8747,13336,6.504,16.419,7398,5.501,32.839,1643,1659,6602
2012,4453,26393,30249,151005,149180,2635,8.771,2223,7.399,23881,8468,15413,5.676,16.008,20217,6912,13305,4.633,13.552,3664,2.456,27.104,1648,1664,4987
2012,4461,39495,86649,997680,973559,5560,6.396,6123,7.044,160953,34058,126895,3.498,16.532,109282,37990,71292,3.902,11.225,51671,5.307,22.45,2852,2979,13048
2012,4471,62080,108129,856895,854430,7936,7.342,7870,7.281,127190,46471,80719,5.439,14.886,121807,40165,81642,4.701,14.256,5383,0.63,28.512,5025,5225,24624
2012,4481,32138,91636,1299807,1304657,7724,8.424,7838,8.548,208539,70488,138051,5.403,15.984,220177,68323,151854,5.237,16.876,-11638,-0.892,31.968,3591,3956,15394
2012,4482,5483,24576,201529,204758,1197,4.829,1621,6.539,28747,8354,20393,4.08,14.04,35122,7771,27351,3.795,17.153,-6375,-3.113,28.079,527,581,2013
2012,4483,15972,22813,129089,128075,1653,7.237,1711,7.491,19043,5770,13273,4.505,14.869,16874,6380,10494,4.981,13.175,2169,1.694,26.35,1050,1073,3884
2012,4511,24849,35063,421466,414218,3156,9.004,3134,8.941,56138,19359,36779,4.674,13.553,41557,12961,28596,3.129,10.033,14581,3.52,20.065,2072,2168,7660
2012,4512,3797,8021,92301,101347,533,6.324,1347,15.982,10842,2975,7867,2.935,10.698,26889,20921,5968,20.643,26.532,-16047,-15.834,21.396,466,1100,18499
2012,4522,15,5103,602648,607646,68,1.332,71,1.391,21681,4878,16803,0.803,3.568,30506,3919,26587,0.645,5.02,-8825,-1.452,7.136,7,7,18
2012,4523,7126,41814,2263998,2245557,2843,6.913,1471,3.577,141705,39614,102091,1.764,6.31,104292,9682,94610,0.431,4.644,37413,1.666,9.289,893,973,3128
2012,4531,13062,13624,63507,64080,1053,7.582,1582,11.391,9887,3077,6810,4.802,15.429,11026,4278,6748,6.676,17.207,-1139,-1.777,30.859,1222,1234,3193
2012,4532,19379,29529,244243,248684,2427,8.079,3454,11.497,30292,10742,19550,4.32,12.181,39366,16160,23206,6.498,15.83,-9074,-3.649,24.362,2183,2254,7562
2012,4533,12552,18018,170154,164552,2103,11.895,1427,8.071,29117,11221,17896,6.819,17.695,18064,5196,12868,3.158,10.978,11053,6.717,21.955,1028,1055,3140
2012,4539,27516,36532,232880,230251,4349,12.015,3678,10.161,37997,16482,21515,7.158,16.502,32743,12278,20465,5.332,14.221,5254,2.282,28.441,2513,2603,8337
2012,4541,23769,24827,366314,356175,4672,19.645,2583,10.861,71625,24893,46732,6.989,20.109,50931,16435,34496,4.614,14.299,20694,5.81,28.599,1944,1956,8357
2012,4542,3287,3780,41166,37981,403,10.519,505,13.182,11341,3144,8197,8.278,29.86,5239,2710,2529,7.135,13.794,6102,16.066,27.588,354,364,1525
2012,4543,21173,26591,174968,174965,2624,9.874,2594,9.761,26122,8683,17439,4.963,14.93,26410,9258,17152,5.291,15.094,-288,-0.165,29.86,1711,1780,6073
2012,4811,392,2543,398028,389888,119,4.635,168,6.543,28144,3370,24774,0.864,7.218,12216,2136,10080,0.548,3.133,15928,4.085,6.266,38,40,191
2012,4812,1911,2104,36399,35588,227,10.779,231,10.969,5310,1668,3642,4.687,14.921,3577,935,2642,2.627,10.051,1733,4.87,20.102,159,160,593
2012,4831,559,880,44340,44216,87,9.842,95,10.747,3701,1028,2673,2.325,8.37,3470,889,2581,2.011,7.848,231,0.522,15.696,48,48,177
2012,4832,402,465,20671,20156,57,12.391,47,10.217,3317,769,2548,3.815,16.457,2284,876,1408,4.346,11.332,1033,5.125,22.663,35,35,123
2012,4841,46529,55729,884463,873680,9258,16.896,7391,13.488,120646,40480,80166,4.633,13.809,98966,36028,62938,4.124,11.327,21680,2.481,22.655,5342,5405,22701
2012,4842,37569,41233,450286,444203,5800,14.23,4850,11.9,84897,25484,59413,5.737,19.112,71821,25523,46298,5.746,16.169,13076,2.944,32.337,3355,3386,16369
2012,4851,516,767,47862,46795,90,11.889,70,9.247,5208,2266,2942,4.842,11.129,3096,1393,1703,2.977,6.616,2112,4.513,13.232,49,50,877
2012,4852,284,478,15064,15616,35,7.307,37,7.724,1718,653,1065,4.182,11.002,2839,340,2499,2.177,18.181,-1121,-7.179,22.004,20,20,86
2012,4853,6263,6412,72369,69497,1079,17.061,904,14.294,14104,4907,9197,7.061,20.295,8478,3663,4815,5.271,12.199,5626,8.095,24.398,709,709,2979
2012,4854,2671,4171,214083,214197,195,4.627,282,6.691,16694,3811,12883,1.779,7.794,17370,5192,12178,2.424,8.109,-676,-0.316,15.588,162,162,2303
2012,4855,1183,1299,32601,32365,115,8.802,130,9.95,4296,1286,3010,3.973,13.274,3797,1368,2429,4.227,11.732,499,1.542,23.464,100,100,1046
2012,4859,3268,3737,81178,79816,635,17.336,487,13.295,13330,4616,8714,5.783,16.701,10706,4797,5909,6.01,13.413,2624,3.288,26.827,362,364,2967
2012,4861,41,650,10422,11364,32,4.889,41,6.264,935,122,813,1.074,8.228,2677,1015,1662,8.932,23.558,-1742,-15.33,16.456,(D),(D),(D)
2012,4862,112,2167,29923,27791,391,19.139,143,7,7576,3988,3588,14.35,27.261,3279,1087,2192,3.911,11.799,4297,15.462,23.598,(D),(D),(D)
2012,4869,43,608,6070,6275,26,4.101,78,12.303,511,129,382,2.056,8.144,941,562,379,8.957,14.997,-430,-6.853,16.288,(D),(D),(D)
2012,4871,435,478,9139,8837,68,14.152,73,15.193,1493,390,1103,4.414,16.896,899,524,375,5.93,10.174,594,6.722,20.347,67,67,498
2012,4872,1166,1212,12410,11821,175,14.547,157,13.051,2406,726,1680,6.142,20.354,1239,458,781,3.874,10.481,1167,9.872,20.963,101,101,281
2012,4879,158,178,2357,2244,25,14.085,24,13.521,387,70,317,3.119,17.246,170,48,122,2.139,7.576,217,9.67,15.152,15,15,31
2012,4881,3772,5564,163016,162231,472,8.473,485,8.707,22954,7929,15025,4.887,14.149,21498,7482,14016,4.612,13.251,1456,0.897,26.503,245,245,1913
2012,4882,481,1263,32589,31633,94,7.49,78,6.215,4646,910,3736,2.877,14.687,2725,770,1955,2.434,8.615,1921,6.073,17.229,36,36,182
2012,4883,1743,2268,93375,91015,175,7.713,177,7.801,16371,1708,14663,1.877,17.987,12045,2268,9777,2.492,13.234,4326,4.753,26.468,90,91,723
2012,4884,8652,9960,84169,82858,1202,12.157,1056,10.681,15181,5835,9346,7.042,18.322,12415,4376,8039,5.281,14.984,2766,3.338,29.967,765,767,2971
2012,4885,13573,19024,228099,226243,1764,9.279,1736,9.132,33055,8980,24075,3.969,14.61,29212,11458,17754,5.064,12.912,3843,1.699,25.824,885,939,4593
2012,4889,1142,1226,14543,14719,158,12.893,157,12.811,3111,1332,1779,9.05,21.136,3422,1504,1918,10.218,23.249,-311,-2.113,42.272,113,113,447
2012,4921,4093,8633,498673,496411,737,8.607,597,6.972,22872,5933,16939,1.195,4.607,17828,2700,15128,0.544,3.591,5044,1.016,7.183,412,413,1359
2012,4922,3797,4187,31686,31933,590,14.069,603,14.379,5410,2072,3338,6.489,16.942,5869,3109,2760,9.736,18.379,-459,-1.437,33.884,487,492,1886
2012,4931,6716,13993,714083,709068,962,6.824,1172,8.313,90053,25219,64834,3.557,12.7,79463,20580,58883,2.902,11.207,10590,1.494,22.413,324,340,3822
2012,5111,12305,17897,455810,472517,1240,6.84,1703,9.394,44006,18422,25584,3.899,9.313,77038,24865,52173,5.262,16.304,-33032,-6.991,18.626,950,993,5764
2012,5112,5358,8284,418060,408769,861,10.503,688,8.393,58922,18593,40329,4.549,14.414,40586,19228,21358,4.704,9.929,18336,4.486,19.858,341,356,6050
2012,5121,13136,16425,318912,303678,2471,15.199,2136,13.139,67528,16888,50640,5.561,22.237,39957,11410,28547,3.757,13.158,27571,9.079,26.315,1249,1268,5447
2012,5122,2787,3103,22938,23054,443,14.456,366,11.943,3132,1045,2087,4.533,13.586,3353,1223,2130,5.305,14.544,-221,-0.959,27.172,257,263,854
2012,5151,4039,8510,220142,216142,502,5.842,667,7.763,28147,6963,21184,3.222,13.022,19850,6502,13348,3.008,9.184,8297,3.839,18.368,226,237,1630
2012,5152,379,731,50675,49005,62,8.35,85,11.448,7458,1557,5901,3.177,15.219,4117,1778,2339,3.628,8.401,3341,6.818,16.802,27,27,108
2012,5173,4287,44340,1009412,1028865,4943,10.996,6172,13.729,130072,50540,79532,4.912,12.642,170821,63266,107555,6.149,16.603,-40749,-3.961,25.285,284,367,3037
2012,5174,350,449,8485,8430,60,12.766,102,21.702,1477,633,844,7.509,17.522,1394,724,670,8.589,16.537,83,0.985,33.074,58,59,455
2012,5179,3072,3532,48775,48796,527,14.574,695,19.22,8705,2687,6018,5.507,17.84,8991,4157,4834,8.519,18.426,-286,-0.586,35.679,545,551,2809
2012,5182,8794,13428,491578,478693,1972,14.656,2027,15.064,107058,28047,79011,5.859,22.365,80928,36317,44611,7.587,16.906,26130,5.459,33.812,680,708,6664
2012,5191,7369,9366,211696,199557,1614,17.76,1058,11.642,48475,19073,29402,9.558,24.291,23613,8242,15371,4.13,11.833,24862,12.459,23.665,682,689,3328
2012,5211,13,58,17943,17991,(D),(D),0,0,799,(D),698,(D),4.441,851,0,851,0,4.73,-52,-0.289,8.882,0,0,0
2012,5221,13216,125190,2021763,1998292,6206,4.971,5495,4.402,249885,66410,183475,3.323,12.505,204665,43838,160827,2.194,10.242,45220,2.263,20.484,354,527,6776
2012,5222,12982,38540,572922,571846,5563,14.247,6578,16.846,118578,36162,82416,6.324,20.736,114974,60861,54113,10.643,20.106,3604,0.63,40.212,1151,1282,6676
2012,5223,12155,27280,243052,242751,2720,9.755,3929,14.09,43717,11277,32440,4.646,18.009,43002,18635,24367,7.677,17.714,715,0.295,35.429,1612,1744,6610
2012,5231,11783,44824,417915,415860,6744,15.546,3857,8.891,61942,20270,41672,4.874,14.895,59387,20943,38444,5.036,14.281,2555,0.614,28.561,754,769,3299
2012,5232,15,31,5700,5697,(D),(D),5,15.625,229,(D),226,(D),4.02,231,9,222,0.158,4.055,-2,-0.035,8.04,(D),(D),(D)
2012,5239,38770,44339,477105,463234,5704,12.961,5046,11.466,81805,32571,49234,7.031,17.66,53885,20104,33781,4.34,11.632,27920,6.027,23.265,3231,3268,10714
2012,5241,4361,30270,1423314,1410724,4322,14.587,3041,10.263,166053,72777,93276,5.159,11.771,140247,38036,102211,2.696,9.941,25806,1.829,19.883,398,413,2625
2012,5242,118645,132848,855969,852173,11049,8.305,11441,8.599,119321,40124,79197,4.708,14.002,112200,41826,70374,4.908,13.166,7121,0.836,26.333,7298,7500,21787
2012,5259,420,421,4192,3104,112,26.016,131,30.43,2714,2390,324,77.01,87.45,426,324,102,10.44,13.726,2288,73.723,27.453,103,103,260
2012,5311,86036,110364,534269,533691,10526,9.585,9429,8.586,81909,34011,47898,6.373,15.348,80803,32261,48542,6.045,15.14,1106,0.207,30.281,6018,6133,19198
2012,5312,55671,65968,245096,243667,9322,14.131,9325,14.135,47192,19875,27317,8.157,19.367,44088,19060,25028,7.822,18.094,3104,1.274,36.187,5502,5618,11112
2012,5313,61135,74167,619794,611368,8708,11.771,8331,11.261,101449,42462,58987,6.945,16.594,84713,34317,50396,5.613,13.856,16736,2.737,27.713,4725,4826,18380
2012,5321,3478,13281,139533,143571,4122,34.443,1495,12.492,52518,37975,14543,26.45,36.58,59621,11235,48386,7.825,41.527,-7103,-4.947,73.16,327,377,1329
2012,5322,7683,20887,154945,163438,2065,9.458,3959,18.132,26473,9398,17075,5.75,16.198,42140,24087,18053,14.738,25.784,-15667,-9.586,32.395,931,1292,5120
2012,5323,2360,2785,16971,16991,176,6.222,263,9.298,2711,683,2028,4.02,15.956,2754,1196,1558,7.039,16.209,-43,-0.253,31.911,143,159,699
2012,5324,6995,12960,158284,153570,1140,8.797,1138,8.782,28965,7826,21139,5.096,18.861,19926,7250,12676,4.721,12.975,9039,5.886,25.95,535,560,3496
2012,5331,1984,2140,33964,32412,293,13.962,210,10.007,6510,1932,4578,5.961,20.085,3227,870,2357,2.684,9.956,3283,10.129,19.912,150,150,626
2012,5411,160073,170112,1145632,1144802,13512,7.941,13600,7.993,127974,41717,86257,3.644,11.179,126377,38603,87774,3.372,11.039,1597,0.14,22.078,9444,9531,26607
2012,5412,99019,114180,1282311,1291196,10090,8.851,9738,8.542,178054,57631,120423,4.463,13.79,193688,78035,115653,6.044,15.001,-15634,-1.211,27.58,6145,6299,45276
2012,5413,79614,95184,1337493,1324108,9346,9.797,9764,10.236,213180,65466,147714,4.944,16.1,187631,63715,123916,4.812,14.17,25549,1.93,28.341,5296,5396,21311
2012,5414,24117,24393,99738,98802,3578,14.761,3272,13.498,18055,7761,10294,7.855,18.274,16251,8351,7900,8.452,16.448,1804,1.826,32.896,2251,2254,5871
2012,5415,91218,108828,1473225,1467255,19265,17.943,16348,15.226,327246,109939,217307,7.493,22.303,316727,140515,176212,9.577,21.586,10519,0.717,43.173,9491,9561,41016
2012,5416,109224,117408,993342,963464,21775,18.838,18138,15.692,218453,86346,132107,8.962,22.674,157406,62122,95284,6.448,16.338,61047,6.336,32.675,12533,12628,37323
2012,5417,12000,14986,599212,607128,1872,12.462,1944,12.941,68550,19597,48953,3.228,11.291,83717,32354,51363,5.329,13.789,-15167,-2.498,22.582,1021,1046,6319
2012,5418,29583,32838,441831,436086,3752,11.39,3957,12.013,74361,19618,54743,4.499,17.052,62819,26076,36743,5.98,14.405,11542,2.647,28.81,2679,2700,14236
2012,5419,50186,59914,575180,573972,5446,9.093,5401,9.018,86236,27003,59233,4.705,15.024,84038,26781,57257,4.666,14.641,2198,0.383,29.283,3667,3694,15836
2012,5511,26065,51553,3079184,3048884,4819,9.373,4539,8.829,488043,123156,364887,4.039,16.007,426527,119516,307011,3.92,13.99,61516,2.018,27.979,818,863,11297
2012,5611,24859,26912,380825,374206,3865,14.588,3031,11.44,75870,33258,42612,8.888,20.275,62436,26923,35513,7.195,16.685,13434,3.59,33.37,2063,2070,15641
2012,5612,1711,5214,257566,255229,492,9.443,484,9.29,38353,11230,27123,4.4,15.027,33843,9883,23960,3.872,13.26,4510,1.767,26.52,89,96,866
2012,5613,24102,43522,4704132,4552987,4871,11.204,4778,10.99,994206,163224,830982,3.585,21.836,692908,228285,464623,5.014,15.219,301298,6.618,30.438,2549,2734,122304
2012,5614,24324,30505,757080,750695,3002,9.758,3521,11.445,121841,37213,84628,4.957,16.23,108602,39492,69110,5.261,14.467,13239,1.764,28.934,2368,2418,21662
2012,5615,12887,18276,225425,222509,1447,7.83,1856,10.043,27849,11039,16810,4.961,12.516,21892,7609,14283,3.42,9.839,5957,2.677,19.677,965,987,3411
2012,5616,17659,23784,841463,827713,2459,10.387,2240,9.462,114591,33032,81559,3.991,13.844,86455,26934,59521,3.254,10.445,28136,3.399,20.89,1374,1412,16136
2012,5617,139766,146634,1680831,1652674,21811,15.113,17180,11.904,287765,85939,201826,5.2,17.412,231380,78193,153187,4.731,14,56385,3.412,28.001,11401,11571,46751
2012,5619,15349,17270,260469,259949,1740,10.069,1760,10.185,42360,11377,30983,4.377,16.296,41259,15074,26185,5.799,15.872,1101,0.424,31.744,1154,1172,5889
2012,5621,7314,10245,184785,187275,823,8.025,845,8.239,30338,8001,22337,4.272,16.2,34745,13149,21596,7.021,18.553,-4407,-2.353,32.399,498,503,3282
2012,5622,1199,2341,48930,48958,145,6.107,212,8.928,6821,1945,4876,3.973,13.932,6817,2035,4782,4.157,13.924,4,0.008,27.848,95,100,658
2012,5629,7853,9218,125827,125695,888,9.623,908,9.84,24420,6541,17879,5.204,19.428,24237,9372,14865,7.456,19.282,183,0.146,38.565,485,492,3038
2012,6111,18185,20537,894496,880840,996,4.867,849,4.149,78648,17158,61490,1.948,8.929,51574,12893,38681,1.464,5.855,27074,3.074,11.71,599,607,9109
2012,6112,443,932,81669,82465,55,5.995,26,2.834,5878,1058,4820,1.283,7.128,7278,596,6682,0.723,8.826,-1400,-1.698,14.256,16,16,72
2012,6113,2202,4234,1805771,1789584,272,6.551,108,2.601,101556,7278,94278,0.407,5.675,67758,5386,62372,0.301,3.786,33798,1.889,7.572,39,39,289
2012,6114,6870,7359,65189,65023,955,13.087,832,11.401,12865,5057,7808,7.777,19.785,12839,5997,6842,9.223,19.745,26,0.04,39.491,492,497,1965
2012,6115,6022,7835,139025,137790,749,9.63,635,8.164,22003,6304,15699,4.575,15.969,19592,3662,15930,2.658,14.219,2411,1.75,28.438,417,429,2029
2012,6116,36184,39101,382405,373450,5342,13.944,3762,9.82,78380,24536,53844,6.57,20.988,60410,20809,39601,5.572,16.176,17970,4.812,32.352,2605,2626,12725
2012,6117,5081,5954,92385,91193,923,15.689,781,13.276,14965,4121,10844,4.519,16.41,12494,3412,9082,3.742,13.701,2471,2.71,27.401,542,543,2063
2012,6211,169846,204601,2205423,2188496,15206,7.423,15702,7.665,300732,105216,195516,4.808,13.741,265700,100140,165560,4.576,12.141,35032,1.601,24.282,10821,11091,66168
2012,6212,119220,127154,874056,865029,6399,5.049,5563,4.389,105531,33249,72282,3.844,12.2,87763,25941,61822,2.999,10.146,17768,2.054,20.291,4368,4474,20873
2012,6213,113471,128284,749824,733097,12032,9.441,10357,8.127,130185,42474,87711,5.794,17.758,97807,39134,58673,5.338,13.342,32378,4.417,26.683,5901,7446,29082
2012,6214,14970,34616,773874,762570,2875,8.436,1807,5.302,106507,34989,71518,4.588,13.967,83166,20478,62688,2.685,10.906,23341,3.061,21.812,822,937,10339
2012,6215,7189,12816,245420,245930,1264,9.902,1161,9.096,31866,10873,20993,4.421,12.957,33561,10121,23440,4.115,13.647,-1695,-0.689,25.915,611,642,4824
2012,6216,19425,27611,1251120,1223288,3353,12.36,2388,8.803,194082,43343,150739,3.543,15.866,137836,36780,101056,3.007,11.268,56246,4.598,22.535,1387,1439,17955
2012,6219,6055,9403,287673,284876,809,8.604,809,8.604,42033,11132,30901,3.908,14.755,36713,13885,22828,4.874,12.887,5320,1.867,25.775,411,423,6405
2012,6221,2820,5023,5251810,5208806,76,1.514,72,1.434,278875,29772,249103,0.572,5.354,195730,23709,172021,0.455,3.758,83145,1.596,7.515,35,38,8383
2012,6222,416,593,227192,225965,10,1.674,19,3.18,23128,914,22214,0.404,10.235,20674,5687,14987,2.517,9.149,2454,1.086,18.298,16,16,5140
2012,6223,346,883,272201,268440,25,2.834,23,2.608,19605,3644,15961,1.357,7.303,12202,2335,9867,0.87,4.546,7403,2.758,9.091,8,8,1308
2012,6231,8137,16028,1675479,1663239,921,5.757,861,5.382,149001,66021,82980,3.969,8.958,124470,42138,82332,2.533,7.484,24531,1.475,14.967,438,446,27803
2012,6232,9327,35976,698512,691833,1798,5.016,1532,4.274,83981,16147,67834,2.334,12.139,71125,14832,56293,2.144,10.281,12856,1.858,20.561,331,408,4780
2012,6233,15104,21291,821092,813669,1687,7.985,1359,6.433,84498,27784,56714,3.415,10.385,68856,24289,44567,2.985,8.462,15642,1.922,16.925,923,954,15912
2012,6239,2930,4976,130324,131864,296,5.818,520,10.22,14691,2898,11793,2.198,11.141,17718,6066,11652,4.6,13.437,-3027,-2.296,22.282,191,206,2456
2012,6241,44038,60435,1452307,1432365,5865,9.806,4617,7.719,195743,45167,150576,3.153,13.666,155517,36758,118759,2.566,10.857,40226,2.808,21.715,2613,2683,17768
2012,6242,10005,14054,178766,177771,1059,7.63,710,5.115,25491,8998,16493,5.062,14.339,23470,5296,18174,2.979,13.202,2021,1.137,26.405,318,351,2561
2012,6243,4034,7614,328986,339061,349,4.516,577,7.466,43172,10337,32835,3.049,12.733,63821,19448,44373,5.736,18.823,-20649,-6.09,25.466,175,181,5961
2012,6244,55560,70640,869405,870178,6335,8.944,6719,9.486,111559,36818,74741,4.231,12.82,113226,40229,72997,4.623,13.012,-1667,-0.192,25.641,4600,4688,26927
2012,7111,6848,6984,116975,114890,884,12.776,754,10.898,21090,6155,14935,5.357,18.357,17006,5152,11854,4.484,14.802,4084,3.555,29.604,506,507,3785
2012,7112,3229,3388,120255,119636,470,13.903,455,13.46,15401,4302,11099,3.596,12.873,14249,2806,11443,2.345,11.91,1152,0.963,23.821,330,331,1944
2012,7113,5471,5784,139744,137844,659,11.464,588,10.229,18661,3151,15510,2.286,13.538,14913,3942,10971,2.86,10.819,3748,2.719,21.638,403,407,2387
2012,7114,2841,2950,17338,17430,407,13.917,356,12.173,3154,1145,2009,6.569,18.096,3308,1439,1869,8.256,18.979,-154,-0.884,36.192,249,251,660
2012,7115,13895,13934,41913,41179,2565,18.658,2192,15.945,11117,5767,5350,14.005,26.997,9629,4717,4912,11.455,23.384,1488,3.614,46.767,1294,1294,2861
2012,7121,6403,6846,136748,132984,364,5.35,280,4.115,14408,2141,12267,1.61,10.834,6969,1250,5719,0.94,5.24,7439,5.594,10.481,156,156,742
2012,7131,2372,2720,162755,155400,408,15.179,344,12.798,26961,5411,21550,3.482,17.349,11565,2622,8943,1.687,7.442,15396,9.907,14.884,232,234,2011
2012,7132,1813,2737,152398,148189,300,11.138,213,7.908,16439,6390,10049,4.312,11.093,8444,2404,6040,1.622,5.698,7995,5.395,11.396,152,158,1837
2012,7139,48350,55520,1178118,1156717,6232,11.3,5495,9.963,171340,60689,110651,5.247,14.813,128533,42953,85580,3.713,11.112,42807,3.701,22.224,4017,4069,29255
2012,7211,38688,49919,1893045,1875480,4106,8.256,3736,7.512,201139,89892,111247,4.793,10.725,166314,69112,97202,3.685,8.868,34825,1.857,17.736,2349,2396,39212
2012,7212,5318,5895,41002,40105,478,8.14,433,7.373,7287,1633,5654,4.072,18.17,5583,1151,4432,2.87,13.921,1704,4.249,27.842,252,254,701
2012,7213,1897,2023,11616,11053,132,6.52,135,6.668,2359,1343,1016,12.151,21.344,1222,402,820,3.637,11.056,1137,10.287,22.113,97,97,311
2012,7223,12471,34653,675947,671596,5117,14.533,6232,17.699,136813,49387,87426,7.354,20.371,127570,52749,74821,7.854,18.995,9243,1.376,37.99,1425,1436,9691
2012,7224,37732,38584,349321,342234,4059,10.488,4292,11.09,70552,32841,37711,9.596,20.615,56365,24920,31445,7.282,16.47,14187,4.145,32.939,3451,3456,20498
2012,7225,343241,471221,9019695,8861052,51938,11.114,44146,9.447,1438936,639745,799191,7.22,16.239,1118548,427016,691532,4.819,12.623,320388,3.616,25.246,33770,34913,303099
2012,8111,133768,146264,811639,805746,12520,8.595,11337,7.783,119987,41871,78116,5.197,14.891,107576,37625,69951,4.67,13.351,12411,1.54,26.702,8205,8311,26285
2012,8112,9794,11111,100253,102496,1208,10.809,1337,11.964,13995,4478,9517,4.369,13.654,18500,8442,10058,8.236,18.05,-4505,-4.395,27.309,868,950,4423
2012,8113,17787,19397,190971,184596,1789,9.286,1527,7.926,34782,9813,24969,5.316,18.842,21656,8533,13123,4.623,11.732,13126,7.111,23.463,1005,1008,3931
2012,8114,16771,17452,64845,64727,1998,11.494,1859,10.695,10947,4536,6411,7.008,16.913,10660,4524,6136,6.989,16.469,287,0.443,32.939,1320,1333,3099
2012,8121,89540,105973,639989,635719,13602,12.998,10955,10.468,113864,53689,60175,8.445,17.911,104796,40353,64443,6.348,16.485,9068,1.426,32.969,8255,8360,29473
2012,8122,14428,20082,137012,136425,766,3.821,691,3.447,17165,3150,14015,2.309,12.582,15722,2506,13216,1.837,11.524,1443,1.058,23.049,430,444,1738
2012,8123,28499,33803,292146,293972,2480,7.29,2911,8.557,37742,11347,26395,3.86,12.839,41552,13681,27871,4.654,14.135,-3810,-1.296,25.677,2177,2259,9218
2012,8129,23323,33151,253028,249300,5176,15.687,4863,14.739,55862,23208,32654,9.309,22.408,48456,24929,23527,10,19.437,7406,2.971,38.874,2113,2330,10025
2012,8131,176039,176364,1683482,1675324,8641,4.92,7166,4.08,155999,29876,126123,1.783,9.312,139690,19519,120171,1.165,8.338,16309,0.973,16.676,4588,4594,13469
2012,8132,15897,18004,176451,174293,1496,8.406,1082,6.08,20019,5827,14192,3.343,11.486,15700,4836,10864,2.775,9.008,4319,2.478,18.016,723,724,2929
2012,8133,13538,15895,150857,147824,1284,8.114,1144,7.229,21089,4338,16751,2.935,14.266,15056,4606,10450,3.116,10.185,6033,4.081,20.37,629,631,2178
2012,8134,23190,24948,229040,228664,1257,5.023,1413,5.646,27074,4964,22110,2.171,11.84,26315,6228,20087,2.724,11.508,759,0.332,23.016,910,920,3762
2012,8139,55120,57327,498617,493871,2800,4.886,2770,4.833,55133,12049,43084,2.44,11.163,46057,10299,35758,2.085,9.326,9076,1.838,18.651,1847,1866,6833
2013,1131,351,399,3030,2581,84,22.672,27,7.287,1031,833,198,32.281,39.953,183,75,108,2.906,7.092,848,32.862,14.183,15,15,29
2013,1132,113,129,1587,1585,15,11.07,28,20.664,202,31,171,1.956,12.744,204,87,117,5.489,12.871,-2,-0.126,25.489,20,20,49
2013,1133,7026,7116,49367,49053,655,9.146,746,10.417,7327,2068,5259,4.216,14.937,6646,2226,4420,4.538,13.549,681,1.388,27.097,528,528,1695
2013,1141,1190,1201,5954,5948,183,15.231,184,15.314,1000,339,661,5.699,16.812,965,356,609,5.985,16.224,35,0.588,32.448,85,85,179
2013,1142,258,258,1432,1460,38,14.99,29,11.44,196,112,84,7.674,13.429,254,75,179,5.139,17.403,-58,-3.974,26.859,15,15,58
2013,1151,3548,3879,63808,64676,414,10.725,376,9.741,8414,2038,6376,3.151,13.01,10112,4511,5601,6.975,15.635,-1698,-2.625,26.019,254,254,3261
2013,1152,3666,3769,18297,18622,432,11.463,431,11.437,2689,1058,1631,5.681,14.44,3408,1426,1982,7.658,18.301,-719,-3.861,28.88,341,341,1254
2013,1153,1224,1307,10451,10480,143,10.842,167,12.661,2110,822,1288,7.844,20.135,2232,1123,1109,10.716,21.299,-122,-1.164,40.269,119,119,978
2013,2111,5856,7307,130254,128782,625,8.551,629,8.606,19859,6086,13773,4.726,15.421,16994,5596,11398,4.345,13.196,2865,2.225,26.392,389,392,1566
2013,2121,485,916,84812,87551,79,8.311,148,15.571,7660,4359,3301,4.979,8.749,13077,5295,7782,6.048,14.936,-5417,-6.187,17.498,64,64,1024
2013,2122,259,326,41272,40632,41,12.596,40,12.289,3765,364,3401,0.896,9.266,2465,273,2192,0.672,6.067,1300,3.199,12.133,27,27,198
2013,2123,2720,4788,76686,75656,276,5.73,333,6.914,10764,3093,7671,4.088,14.228,8583,2070,6513,2.736,11.345,2181,2.883,22.69,182,183,940
2013,2131,10247,12756,395339,392524,1655,13.093,1423,11.258,73144,20241,52903,5.157,18.634,67869,25594,42275,6.52,17.29,5275,1.344,34.581,894,924,9370
2013,2211,1690,10387,511734,513185,584,5.654,469,4.54,35723,12691,23032,2.473,6.961,38643,9175,29468,1.788,7.53,-2920,-0.569,13.922,68,75,1396
2013,2212,423,2451,82398,82706,199,8.196,153,6.301,7550,3621,3929,4.378,9.129,8173,1724,6449,2.084,9.882,-623,-0.753,18.257,28,30,159
2013,2213,3468,4602,41950,42838,210,4.534,269,5.808,3060,770,2290,1.797,7.143,4801,1580,3221,3.688,11.207,-1741,-4.064,14.287,112,112,508
2013,2361,124809,126001,597234,581604,23060,18.466,20810,16.665,152341,63112,89229,10.851,26.193,121124,54073,67051,9.297,20.826,31217,5.367,41.652,12877,12882,35574
2013,2362,34355,35641,545485,539987,3603,10.039,4104,11.434,98180,18076,80104,3.347,18.182,86649,22555,64094,4.177,16.046,11531,2.135,32.093,2751,2770,14598
2013,2371,15925,17421,516330,503372,1483,8.458,1710,9.752,108230,20641,87589,4.101,21.501,83068,17286,65782,3.434,16.502,25162,4.999,33.005,1071,1101,11578
2013,2372,4645,4711,23061,23360,424,8.735,710,14.627,3940,1388,2552,5.942,16.866,4498,1973,2525,8.446,19.255,-558,-2.389,33.733,536,536,1514
2013,2373,8088,8899,252835,257112,544,6.023,809,8.958,32860,4605,28255,1.791,12.78,41198,5971,35227,2.322,16.023,-8338,-3.243,25.561,466,468,3617
2013,2379,3492,3596,81353,81297,371,10.223,437,12.042,12751,2587,10164,3.182,15.685,12503,2952,9551,3.631,15.38,248,0.305,30.759,265,266,1382
2013,2381,68598,69319,670067,663352,8754,12.478,10426,14.861,149300,35001,114299,5.276,22.507,136141,43461,92680,6.552,20.523,13159,1.984,41.046,6254,6268,29651
2013,2382,149980,153907,1672072,1644162,14773,9.626,13887,9.049,274479,53159,221320,3.233,16.694,218537,59450,159087,3.616,13.292,55942,3.402,26.583,9487,9514,41284
2013,2383,85358,86329,625553,614387,11515,13.327,11658,13.493,131753,34496,97257,5.615,21.445,109373,36886,72487,6.004,17.802,22380,3.643,35.604,7531,7534,26240
2013,2389,50894,51585,479162,474576,6396,12.376,6590,12.751,89683,23341,66342,4.918,18.898,80487,24761,55726,5.218,16.96,9196,1.938,33.92,3931,3934,16737
2013,3111,1023,1616,45746,45038,87,5.367,97,5.984,5330,1513,3817,3.359,11.834,3965,1663,2302,3.692,8.804,1365,3.031,17.607,64,64,743
2013,3112,453,801,54376,54019,51,6.427,36,4.537,4496,1558,2938,2.884,8.323,3662,877,2785,1.624,6.779,834,1.544,13.558,22,22,110
2013,3113,1480,1613,71025,69413,137,8.6,97,6.089,8134,745,7389,1.073,11.718,5011,1644,3367,2.368,7.219,3123,4.499,14.438,73,73,454
2013,3114,1272,1635,157145,156587,100,6.096,111,6.766,11895,1579,10316,1.008,7.596,10858,3005,7853,1.919,6.934,1037,0.662,13.868,80,80,1680
2013,3115,1039,1541,134905,134369,102,6.647,89,5.8,9444,1468,7976,1.093,7.028,8275,2478,5797,1.844,6.158,1169,0.87,12.317,58,58,530
2013,3116,2785,3380,476934,481872,173,5.107,188,5.55,21801,3007,18794,0.624,4.524,31732,8146,23586,1.69,6.585,-9931,-2.061,9.048,137,137,4052
2013,3117,437,530,31397,31722,31,5.778,44,8.201,2699,436,2263,1.374,8.508,3423,782,2641,2.465,10.791,-724,-2.282,17.017,28,29,610
2013,3118,8997,9657,267633,270510,942,9.785,882,9.162,28114,7764,20350,2.87,10.393,33290,17122,16168,6.33,12.306,-5176,-1.913,20.786,673,682,4630
2013,3119,2654,3081,176922,171384,254,8.263,240,7.807,22935,4440,18495,2.591,13.382,12306,4060,8246,2.369,7.18,10629,6.202,14.361,161,164,1829
2013,3121,4407,5014,145041,140355,853,18.085,258,5.47,17782,4565,13217,3.252,12.669,8394,1958,6436,1.395,5.981,9388,6.689,11.961,170,175,956
2013,3122,92,111,14286,14478,10,8.969,11,9.865,630,123,507,0.85,4.351,1036,296,740,2.044,7.156,-406,-2.804,8.703,6,6,49
2013,3131,243,311,24849,24966,22,7.143,16,5.195,1228,238,990,0.953,4.919,1414,251,1163,1.005,5.664,-186,-0.745,9.838,10,11,79
2013,3132,808,888,50982,50797,44,4.9,64,7.127,4206,519,3687,1.022,8.28,3826,1221,2605,2.404,7.532,380,0.748,15.064,38,40,404
2013,3133,1003,1049,28718,29240,119,11.587,75,7.303,2899,791,2108,2.705,9.915,4074,1555,2519,5.318,13.933,-1175,-4.019,19.829,54,54,334
2013,3141,1614,1728,52546,51603,91,5.138,177,9.994,5150,852,4298,1.651,9.98,3194,1067,2127,2.068,6.19,1956,3.791,12.379,130,130,438
2013,3149,3944,4052,60611,61767,376,9.302,356,8.808,6541,1540,5001,2.493,10.59,8762,2846,5916,4.608,14.186,-2221,-3.596,21.18,257,257,1500
2013,3151,253,267,12204,12455,11,4.037,22,8.073,700,24,676,0.193,5.62,1166,552,614,4.432,9.362,-466,-3.741,11.24,19,19,181
2013,3152,4766,4812,90261,89225,760,15.758,782,16.214,17454,8792,8662,9.854,19.562,15525,6647,8878,7.45,17.4,1929,2.162,34.8,687,687,6012
2013,3159,495,503,8532,8572,57,11.298,60,11.893,1010,365,645,4.258,11.783,1063,495,568,5.775,12.402,-53,-0.618,23.566,41,41,354
2013,3161,174,184,3569,3546,16,8.767,13,7.123,273,71,202,2.003,7.7,221,37,184,1.044,6.233,52,1.467,12.467,8,8,29
2013,3162,173,191,11588,11431,15,7.752,20,10.336,1199,63,1136,0.551,10.489,932,144,788,1.26,8.154,267,2.336,16.307,16,16,53
2013,3169,644,647,11073,11461,46,6.991,68,10.334,992,131,861,1.143,8.655,1753,668,1085,5.828,15.295,-761,-6.64,17.311,47,47,530
2013,3211,2634,3004,77357,76963,190,6.224,287,9.402,8056,2184,5872,2.838,10.467,7162,3126,4036,4.062,9.306,894,1.162,18.612,197,201,1616
2013,3212,1080,1352,64761,62556,54,3.932,97,7.062,8472,1331,7141,2.128,13.543,3976,1811,2165,2.895,6.356,4496,7.187,12.712,66,67,898
2013,3219,7394,8265,211133,206987,541,6.495,671,8.055,27769,4824,22945,2.331,13.416,19585,7651,11934,3.696,9.462,8184,3.954,18.924,477,477,4876
2013,3221,221,435,106980,107613,14,3.193,21,4.789,4173,797,3376,0.741,3.878,5426,2358,3068,2.191,5.042,-1253,-1.164,7.756,6,6,555
2013,3222,2519,3802,242371,242598,130,3.4,172,4.499,14941,3253,11688,1.341,6.159,15580,4133,11447,1.704,6.422,-639,-0.263,12.317,102,104,1385
2013,3231,24046,25291,463683,469181,1319,5.133,2132,8.297,35848,8901,26947,1.897,7.641,46932,16601,30331,3.538,10.003,-11084,-2.362,15.281,1711,1715,10967
2013,3241,917,2091,97904,98290,101,4.803,125,5.944,6043,1048,4995,1.066,6.148,6775,1312,5463,1.335,6.893,-732,-0.745,12.296,44,47,299
2013,3251,1305,2370,156833,155665,83,3.468,129,5.391,12923,2739,10184,1.76,8.302,10734,2852,7882,1.832,6.896,2189,1.406,13.791,76,79,1547
2013,3252,1064,1412,94322,93897,63,4.473,56,3.976,6794,1438,5356,1.531,7.236,5861,1663,4198,1.771,6.242,933,0.994,12.484,33,33,855
2013,3253,622,865,28427,28661,57,6.582,59,6.813,2081,341,1740,1.19,7.261,2550,707,1843,2.467,8.897,-469,-1.636,14.521,38,38,317
2013,3254,1562,2012,232553,232327,151,7.573,115,5.767,23581,9468,14113,4.075,10.15,24215,2726,21489,1.173,10.423,-634,-0.273,20.3,83,83,1661
2013,3255,1245,1559,53946,53029,57,3.625,84,5.342,5733,1528,4205,2.881,10.811,3888,1649,2239,3.11,7.332,1845,3.479,14.664,55,55,443
2013,3256,1861,2045,93001,92487,119,5.791,139,6.764,7139,836,6303,0.904,7.719,6113,2201,3912,2.38,6.61,1026,1.109,13.219,104,104,866
2013,3259,1730,2214,81127,81494,113,5.054,157,7.021,7307,2090,5217,2.565,8.966,7904,1972,5932,2.42,9.699,-597,-0.733,17.933,110,110,971
2013,3261,8026,10271,581807,578696,419,4.051,565,5.462,51075,7950,43125,1.374,8.826,44852,15741,29111,2.72,7.751,6223,1.075,15.501,366,378,7910
2013,3262,1412,1807,126224,126520,54,2.964,84,4.61,7299,962,6337,0.76,5.769,8043,1027,7016,0.812,6.357,-744,-0.588,11.538,53,53,498
2013,3271,907,1088,32575,33162,66,5.965,103,9.309,2494,395,2099,1.191,7.521,3746,857,2889,2.584,11.296,-1252,-3.775,15.042,74,74,475
2013,3272,1373,1640,85784,84687,101,6.083,142,8.552,7339,831,6508,0.981,8.666,5167,1975,3192,2.332,6.101,2172,2.565,12.203,101,102,1106
2013,3273,4036,8283,150017,148338,318,3.799,493,5.89,20668,5056,15612,3.408,13.933,17646,4278,13368,2.884,11.896,3022,2.037,23.792,198,203,1935
2013,3274,164,293,12046,12104,11,3.716,17,5.743,667,102,565,0.843,5.511,786,297,489,2.454,6.494,-119,-0.983,11.021,12,12,74
2013,3279,2515,2995,70269,70058,162,5.376,199,6.604,6463,1370,5093,1.956,9.225,6046,1801,4245,2.571,8.63,417,0.595,17.26,136,137,974
2013,3311,283,419,102513,102804,41,10.074,17,4.177,3703,756,2947,0.735,3.602,4364,1336,3028,1.3,4.245,-661,-0.643,7.204,9,9,107
2013,3312,520,648,44825,44839,32,4.916,38,5.837,3356,434,2922,0.968,7.485,3378,380,2998,0.847,7.534,-22,-0.049,14.969,30,30,344
2013,3313,400,533,57087,56081,20,3.735,25,4.669,5251,1250,4001,2.229,9.363,3229,1318,1911,2.35,5.758,2022,3.605,11.515,16,16,177
2013,3314,754,940,59311,59593,40,4.253,41,4.359,3341,756,2585,1.269,5.606,3911,697,3214,1.17,6.563,-570,-0.956,11.213,30,31,470
2013,3315,1583,1787,128754,129257,57,3.173,76,4.23,8756,1566,7190,1.212,6.774,9806,1350,8456,1.044,7.586,-1050,-0.812,13.548,57,57,800
2013,3321,2294,2530,118723,118394,55,2.159,91,3.571,8460,1172,7288,0.99,7.146,7811,1300,6511,1.098,6.597,649,0.548,13.195,60,60,645
2013,3322,1059,1140,35884,36143,38,3.284,72,6.223,2078,149,1929,0.412,5.749,2611,821,1790,2.272,7.224,-533,-1.475,11.499,50,50,574
2013,3323,10973,11901,334274,330135,582,4.86,732,6.112,37297,6128,31169,1.856,11.298,28964,7847,21117,2.377,8.773,8333,2.524,17.547,518,529,4922
2013,3324,1116,1412,85104,84010,58,4.102,62,4.385,8023,1565,6458,1.863,9.55,5817,1255,4562,1.494,6.924,2206,2.626,13.848,46,46,711
2013,3325,500,551,23347,24079,28,5.059,33,5.962,1244,155,1089,0.644,5.166,2686,752,1934,3.123,11.155,-1442,-5.989,10.333,20,20,168
2013,3326,1102,1241,39804,39291,34,2.703,68,5.405,3780,978,2802,2.489,9.621,2768,802,1966,2.041,7.045,1012,2.576,14.09,43,45,400
2013,3327,21083,21547,366842,365820,1037,4.793,1210,5.593,35292,7440,27852,2.034,9.647,33152,10159,22993,2.777,9.062,2140,0.585,18.125,912,915,6683
2013,3328,5101,5639,128407,126933,252,4.452,296,5.229,13230,2867,10363,2.259,10.423,10130,2998,7132,2.362,7.981,3100,2.442,15.961,226,227,1827
2013,3329,5694,6229,265513,262484,392,6.305,369,5.935,25134,3070,22064,1.17,9.575,18882,5095,13787,1.941,7.194,6252,2.382,14.387,264,265,2504
2013,3331,2508,2893,213624,212081,170,5.884,162,5.607,19356,2875,16481,1.356,9.127,16652,3780,12872,1.782,7.852,2704,1.275,15.703,119,119,2372
2013,3332,2993,3152,101579,99745,146,4.623,158,5.003,10594,1948,8646,1.953,10.621,7102,1785,5317,1.79,7.12,3492,3.501,14.24,112,113,1067
2013,3333,1790,1917,76556,77406,102,5.296,120,6.231,5351,1052,4299,1.359,6.913,7011,1819,5192,2.35,9.057,-1660,-2.145,13.826,78,78,612
2013,3334,1485,1751,129906,130268,82,4.643,112,6.342,10268,1292,8976,0.992,7.882,10874,3822,7052,2.934,8.347,-606,-0.465,15.764,70,71,669
2013,3335,6411,6637,152814,150076,228,3.417,299,4.481,14634,2667,11967,1.777,9.751,9102,2534,6568,1.688,6.065,5532,3.686,12.13,224,224,1684
2013,3336,849,1052,105297,107520,33,3.131,37,3.51,6694,363,6331,0.338,6.226,11343,2677,8666,2.49,10.55,-4649,-4.324,12.452,20,20,1019
2013,3339,5311,5961,289770,285496,248,4.152,271,4.537,25081,4609,20472,1.614,8.785,16568,4277,12291,1.498,5.803,8513,2.982,11.606,181,181,1461
2013,3341,955,990,62515,63164,72,7.225,85,8.53,3660,903,2757,1.43,5.794,4915,1486,3429,2.353,7.781,-1255,-1.987,11.589,56,56,469
2013,3342,1207,1329,102301,102851,66,4.871,118,8.708,7793,599,7194,0.582,7.577,9088,2405,6683,2.338,8.836,-1295,-1.259,15.154,90,91,527
2013,3343,412,420,8433,8390,39,9.308,37,8.831,1120,218,902,2.598,13.35,1010,679,331,8.093,12.039,110,1.311,24.078,32,32,295
2013,3344,3531,3976,265516,271394,191,4.76,264,6.579,15457,2802,12655,1.032,5.695,27153,7614,19539,2.806,10.005,-11696,-4.31,11.391,190,192,3676
2013,3345,4325,4961,383018,382087,257,5.144,328,6.565,29835,5182,24653,1.356,7.808,28169,6457,21712,1.69,7.372,1666,0.436,14.745,212,212,2841
2013,3346,487,499,14008,14416,36,7.052,59,11.557,802,140,662,0.971,5.563,1617,695,922,4.821,11.217,-815,-5.653,11.127,45,45,483
2013,3351,962,1035,43270,43643,58,5.566,72,6.91,3253,576,2677,1.32,7.454,3989,932,3057,2.136,9.14,-736,-1.686,14.907,53,53,408
2013,3352,220,257,43248,43059,26,10.4,12,4.8,2797,529,2268,1.229,6.496,2341,1192,1149,2.768,5.437,456,1.059,10.873,7,7,51
2013,3353,1818,2098,117346,116405,96,4.573,99,4.715,8661,1285,7376,1.104,7.44,6840,1891,4949,1.625,5.876,1821,1.564,11.752,68,68,994
2013,3359,1785,2074,131421,132279,91,4.379,99,4.764,8784,1152,7632,0.871,6.641,10563,2348,8215,1.775,7.985,-1779,-1.345,13.281,63,63,830
2013,3361,259,314,162899,157464,24,7.559,31,9.764,17684,470,17214,0.298,11.231,7075,1529,5546,0.971,4.493,10609,6.737,8.986,21,21,211
2013,3362,1563,1824,121882,120366,113,6.195,113,6.195,12657,1727,10930,1.435,10.515,9716,1966,7750,1.633,8.072,2941,2.443,16.144,74,78,1138
2013,3363,3861,4701,471118,458299,254,5.385,285,6.043,56494,7138,49356,1.557,12.327,30831,8484,22347,1.851,6.727,25663,5.6,13.455,184,187,2189
2013,3364,1274,1676,365461,364004,96,5.711,106,6.306,25772,2246,23526,0.617,7.08,22890,3626,19264,0.996,6.288,2882,0.792,12.577,71,71,1019
2013,3365,143,217,30141,29730,21,9.79,16,7.459,4905,1773,3132,5.964,16.498,3904,827,3077,2.782,13.132,1001,3.367,26.263,10,10,217
2013,3366,1281,1400,140241,138121,102,7.201,135,9.531,11711,1106,10605,0.801,8.479,7481,1965,5516,1.423,5.416,4230,3.063,10.833,95,96,1173
2013,3369,792,824,33518,34318,88,10.706,84,10.219,4416,2322,2094,6.766,12.868,6139,1001,5138,2.917,17.889,-1723,-5.021,25.736,58,58,328
2013,3371,10086,10309,204697,202490,785,7.528,1023,9.81,21784,3931,17853,1.941,10.758,17325,6528,10797,3.224,8.556,4459,2.202,17.112,712,714,4400
2013,3372,3447,3611,106629,107682,188,5.161,251,6.891,9298,1764,7534,1.638,8.635,11235,4124,7111,3.83,10.434,-1937,-1.799,17.269,176,178,1469
2013,3379,658,750,31422,31281,45,6,45,6,2665,585,2080,1.87,8.52,2402,667,1735,2.132,7.679,263,0.841,15.358,35,35,484
2013,3391,9743,10630,292130,293040,586,5.447,842,7.827,22786,3888,18898,1.327,7.776,24597,6489,18108,2.214,8.394,-1811,-0.618,15.551,619,624,3191
2013,3399,14440,14820,262687,263333,1519,10.273,1453,9.826,27974,6531,21443,2.48,10.623,28941,11700,17241,4.443,10.99,-967,-0.367,21.246,1129,1132,6679
2013,4231,15894,23600,372988,369606,1588,6.712,1704,7.203,45302,9956,35346,2.694,12.257,38363,11571,26792,3.131,10.379,6939,1.877,20.759,1118,1184,6939
2013,4232,9874,11665,143391,142476,940,8.025,1036,8.845,16563,4504,12059,3.161,11.625,14628,5703,8925,4.003,10.267,1935,1.358,20.534,751,778,3576
2013,4233,9513,15725,194815,191234,1012,6.415,1112,7.049,25149,6257,18892,3.272,13.151,18071,6661,11410,3.483,9.45,7078,3.701,18.899,650,670,3887
2013,4234,21806,33056,668339,663610,2947,8.887,3157,9.52,86748,31150,55598,4.694,13.072,77979,32566,45413,4.907,11.751,8769,1.321,23.501,1640,1679,10729
2013,4235,7310,10094,152973,152659,457,4.484,652,6.397,15554,3170,12384,2.077,10.189,14923,4078,10845,2.671,9.775,631,0.413,19.551,390,390,2146
2013,4236,18209,28027,527588,526557,2142,7.626,2265,8.064,94143,44678,49465,8.485,17.879,92099,26516,65583,5.036,17.491,2044,0.388,34.982,1180,1203,6625
2013,4237,10077,18763,227157,225542,1000,5.315,1104,5.868,24526,7603,16923,3.371,10.874,21736,5806,15930,2.574,9.637,2790,1.237,19.274,532,580,2941
2013,4238,38774,55938,727797,716589,3235,5.783,3234,5.781,90774,22972,67802,3.206,12.668,68787,20790,47997,2.901,9.599,21988,3.068,19.198,1941,2023,11164
2013,4239,27928,31451,337885,340441,3309,10.583,2941,9.406,42882,13731,29151,4.033,12.596,47597,17208,30389,5.055,13.981,-4715,-1.385,25.192,2224,2247,11606
2013,4241,7638,9822,146887,147486,496,4.991,726,7.306,11291,2432,8859,1.649,7.656,12534,3898,8636,2.643,8.498,-1243,-0.843,15.311,471,481,2294
2013,4242,5954,9197,297150,289837,944,10.349,793,8.694,41333,13794,27539,4.759,14.261,26967,6228,20739,2.149,9.304,14366,4.957,18.608,478,483,3455
2013,4243,13226,14395,197611,195599,1480,10.261,1537,10.656,28670,7401,21269,3.784,14.658,24610,7729,16881,3.951,12.582,4060,2.076,25.164,1219,1235,5312
2013,4244,24403,31463,777404,765391,2945,9.374,2851,9.075,116142,26748,89394,3.495,15.174,90281,30146,60135,3.939,11.795,25861,3.379,23.591,1792,1843,12081
2013,4245,3245,5972,60711,60600,263,4.386,312,5.203,6534,1035,5499,1.708,10.782,6244,1939,4305,3.2,10.304,290,0.479,20.607,151,162,973
2013,4246,8028,12410,152939,151177,812,6.52,899,7.219,21510,6229,15281,4.12,14.228,17855,5952,11903,3.937,11.811,3655,2.418,23.621,436,443,1913
2013,4247,4257,6427,101372,100644,358,5.529,455,7.026,16021,3354,12667,3.333,15.918,14370,5356,9014,5.322,14.278,1651,1.64,28.556,232,240,2211
2013,4248,3196,4120,187762,185512,363,8.847,329,8.019,16076,3017,13059,1.626,8.666,11599,5012,6587,2.702,6.252,4477,2.413,12.505,229,242,3176
2013,4249,20163,26487,328809,327877,2252,8.503,2246,8.481,38849,10802,28047,3.295,11.849,37082,11470,25612,3.498,11.31,1767,0.539,22.619,1579,1592,7002
2013,4251,36955,39353,291397,287795,4572,11.655,4321,11.015,48052,21791,26261,7.572,16.697,40675,17647,23028,6.132,14.133,7377,2.563,28.267,3146,3156,9842
2013,4411,37395,42648,1138134,1119823,3683,8.684,3212,7.573,117425,35569,81856,3.176,10.486,80951,26928,54023,2.405,7.229,36474,3.257,14.458,2444,2472,20526
2013,4412,11491,13023,127626,126363,872,6.659,1018,7.773,16612,4573,12039,3.619,13.146,14215,5041,9174,3.989,11.249,2397,1.897,22.499,720,737,3678
2013,4413,26940,54888,492360,491538,2669,4.859,2744,4.996,56129,13981,42148,2.844,11.419,54797,12567,42230,2.557,11.148,1332,0.271,22.296,1685,1787,7090
2013,4421,13383,22179,193557,192587,1860,8.375,1918,8.637,25297,8999,16298,4.673,13.135,23390,8846,14544,4.593,12.145,1907,0.99,24.29,1232,1359,6214
2013,4422,18365,26387,232177,232528,1880,7.091,2128,8.027,31127,8596,22531,3.697,13.386,31275,10231,21044,4.4,13.45,-148,-0.064,26.773,1369,1416,4017
2013,4431,22904,44845,406331,414937,3480,7.645,4824,10.598,46739,16792,29947,4.047,11.264,64565,23666,40899,5.704,15.56,-17826,-4.296,22.528,2845,3048,11763
2013,4441,35585,57302,1087479,1054811,2494,4.328,3145,5.457,114011,13142,100869,1.246,10.809,49578,14520,35058,1.377,4.7,64433,6.108,9.4,2075,2132,8739
2013,4442,12857,16403,145091,144116,1163,7.094,1147,6.996,18989,6943,12046,4.818,13.176,16744,4535,12209,3.147,11.618,2245,1.558,23.237,786,796,2941
2013,4451,59224,85395,2594042,2589223,8623,10.169,7422,8.753,215026,84820,130206,3.276,8.305,203730,65026,138704,2.511,7.868,11296,0.436,15.737,5482,5531,27443
2013,4452,16835,20644,155188,151772,2488,12.121,2253,10.976,31167,12835,18332,8.457,20.535,24091,10191,13900,6.715,15.873,7076,4.662,31.746,1537,1555,6562
2013,4453,26710,30503,156253,153635,2630,8.664,2334,7.689,24550,9345,15205,6.083,15.979,19069,7316,11753,4.762,12.412,5481,3.568,24.824,1717,1804,5669
2013,4461,39898,88706,1015929,1011433,6208,7.044,5063,5.745,111804,31780,80024,3.142,11.054,104729,37849,66880,3.742,10.355,7075,0.7,20.709,3021,3195,15757
2013,4471,61583,107652,883017,869427,7598,7.04,8132,7.535,137552,45690,91862,5.255,15.821,110645,41170,69475,4.735,12.726,26907,3.095,25.452,5450,5692,26228
2013,4481,32157,91692,1382242,1341399,7285,7.944,7313,7.974,224786,63840,160946,4.759,16.758,142221,49884,92337,3.719,10.602,82565,6.155,21.205,3526,3933,17727
2013,4482,5375,24253,208570,205204,1360,5.576,1633,6.696,31922,10762,21160,5.245,15.556,25719,9023,16696,4.397,12.533,6203,3.023,25.067,485,734,4071
2013,4483,15719,22655,131755,130271,1558,6.872,1590,7.013,18071,6363,11708,4.884,13.872,15183,4901,10282,3.762,11.655,2888,2.217,23.31,1090,1112,3021
2013,4511,24680,35167,442694,431432,3000,8.555,2804,7.996,60428,19007,41421,4.406,14.006,37657,11186,26471,2.593,8.728,22771,5.278,17.457,2003,2028,6607
2013,4512,3841,8120,93144,94709,495,6.023,692,8.42,9525,2462,7063,2.6,10.057,12548,3664,8884,3.869,13.249,-3023,-3.192,20.114,387,403,1371
2013,4522,49,5083,576886,590854,63,1.232,122,2.386,24046,4210,19836,0.713,4.07,50112,8364,41748,1.416,8.481,-26066,-4.412,8.139,0,0,0
2013,4523,7157,43346,2220227,2241976,2889,6.782,1397,3.279,102113,38573,63540,1.72,4.555,144162,10132,134030,0.452,6.43,-42049,-1.876,9.109,895,903,2928
2013,4531,12563,13111,61464,62323,938,7.034,1385,10.387,9457,2797,6660,4.488,15.174,11181,4681,6500,7.511,17.941,-1724,-2.766,30.349,1126,1129,3239
2013,4532,18495,28540,240684,239529,2271,7.884,2803,9.731,32101,12187,19914,5.088,13.402,30228,12348,17880,5.155,12.62,1873,0.782,25.24,1978,2035,7414
2013,4533,12620,18221,182805,175967,1936,10.771,1443,8.028,33539,10680,22859,6.069,19.06,19533,5404,14129,3.071,11.1,14006,7.959,22.201,1110,1115,3365
2013,4539,28830,38163,246324,242510,4242,11.222,3518,9.307,39381,16294,23087,6.719,16.239,31945,11801,20144,4.866,13.173,7436,3.066,26.345,2585,2639,8790
2013,4541,25599,26751,394814,381502,4860,18.791,3085,11.928,77233,34218,43015,8.969,20.244,50099,20829,29270,5.46,13.132,27134,7.112,26.264,2293,2308,8831
2013,4542,3165,3635,40546,40885,321,8.686,442,11.96,5469,1038,4431,2.539,13.377,6106,2891,3215,7.071,14.935,-637,-1.558,26.753,333,339,1341
2013,4543,20242,25574,165749,168080,2573,10.016,2804,10.915,23615,8729,14886,5.193,14.05,28028,9288,18740,5.526,16.675,-4413,-2.626,28.1,1902,1920,5914
2013,4811,441,2527,385590,392579,270,10.537,341,13.307,60131,6860,53271,1.747,15.317,74488,48181,26307,12.273,18.974,-14357,-3.657,30.634,48,49,322
2013,4812,1980,2186,37502,37339,241,11.017,244,11.154,4613,1161,3452,3.109,12.355,4357,1417,2940,3.795,11.669,256,0.686,23.338,164,164,658
2013,4831,756,1084,53221,52516,110,10.223,94,8.736,7070,959,6111,1.826,13.463,5709,1075,4634,2.047,10.871,1361,2.592,21.742,51,51,204
2013,4832,522,598,21718,21373,67,11.385,48,8.156,2189,526,1663,2.461,10.242,1476,618,858,2.892,6.906,713,3.336,13.812,28,28,116
2013,4841,48599,58551,930976,917125,9314,16.163,7461,12.948,131335,43511,87824,4.744,14.32,103949,35147,68802,3.832,11.334,27386,2.986,22.668,5218,5266,21272
2013,4842,36515,40183,446569,442884,4890,12.111,5279,13.074,73242,23986,49256,5.416,16.538,65729,25433,40296,5.743,14.841,7513,1.696,29.682,3644,3660,15515
2013,4851,684,986,57265,55696,88,8.998,72,7.362,7825,3061,4764,5.496,14.05,4668,1798,2870,3.228,8.381,3157,5.668,16.763,49,49,1354
2013,4852,217,408,13919,13947,39,9.512,43,10.488,1240,491,749,3.521,8.891,1314,480,834,3.442,9.422,-74,-0.531,17.782,20,20,94
2013,4853,6294,6445,70917,69951,1076,16.99,852,13.453,10825,4512,6313,6.45,15.475,8946,3626,5320,5.184,12.789,1879,2.686,25.578,658,659,2666
2013,4854,2454,3911,211700,210794,180,4.537,292,7.361,16522,3756,12766,1.782,7.838,14952,7582,7370,3.597,7.093,1570,0.745,14.186,191,194,3854
2013,4855,1082,1194,31299,30751,102,8.437,132,10.918,4371,919,3452,2.989,14.214,3319,1784,1535,5.802,10.793,1052,3.421,21.587,90,94,763
2013,4859,3770,4238,86860,86545,625,14.938,517,12.357,13713,4360,9353,5.038,15.845,13174,7418,5756,8.571,15.222,539,0.623,30.444,369,372,3519
2013,4861,50,720,15418,14919,73,10.542,18,2.599,2033,626,1407,4.196,13.627,1045,106,939,0.711,7.005,988,6.623,14.009,(D),(D),(D)
2013,4862,130,2330,32084,31290,204,9.007,74,3.267,5435,1338,4097,4.276,17.37,3944,1805,2139,5.769,12.605,1491,4.765,25.209,8,8,32
2013,4869,51,613,7133,6579,33,5.414,26,4.266,1739,486,1253,7.388,26.435,637,195,442,2.964,9.683,1102,16.752,19.366,(D),(D),(D)
2013,4871,443,486,9438,9249,64,13.389,48,10.042,1382,389,993,4.206,14.942,1039,264,775,2.854,11.234,343,3.709,22.467,36,36,119
2013,4872,1127,1171,12167,12163,138,11.795,136,11.624,1550,397,1153,3.264,12.744,1520,386,1134,3.174,12.497,30,0.247,24.994,95,95,292
2013,4879,147,167,2408,2372,19,11.48,16,9.668,272,65,207,2.74,11.467,193,81,112,3.415,8.137,79,3.331,16.273,12,12,23
2013,4881,3675,5459,174572,168616,447,8.146,504,9.185,26918,7233,19685,4.29,15.964,15240,4434,10806,2.63,9.038,11678,6.926,18.077,278,288,2486
2013,4882,480,1367,34891,33361,193,14.705,84,6.4,5813,2120,3693,6.355,17.425,2697,716,1981,2.146,8.084,3116,9.34,16.169,28,30,266
2013,4883,1610,2127,90225,88242,202,9.564,172,8.144,14485,3305,11180,3.745,16.415,10750,4084,6666,4.628,12.182,3735,4.233,24.365,108,109,1573
2013,4884,8737,9948,82383,81873,1147,11.575,1070,10.798,13689,4797,8892,5.859,16.72,12823,4553,8270,5.561,15.662,866,1.058,31.324,764,765,3039
2013,4885,13184,18250,223322,221214,1553,8.476,1696,9.257,31008,8563,22445,3.871,14.017,26734,10539,16195,4.764,12.085,4274,1.932,24.17,940,978,5101
2013,4889,1394,1498,17087,16646,202,13.746,145,9.867,3147,993,2154,5.965,18.905,2266,967,1299,5.809,13.613,881,5.293,27.226,111,111,533
2013,4921,4123,8556,489352,493791,610,7.068,760,8.805,21058,5305,15753,1.074,4.265,30563,3904,26659,0.791,6.189,-9505,-1.925,8.529,393,402,1507
2013,4922,3769,4141,34333,33366,489,11.707,561,13.431,7494,2369,5125,7.1,22.46,5494,2639,2855,7.909,16.466,2000,5.994,32.932,426,430,1682
2013,4931,6858,13919,720401,714812,1256,8.983,1381,9.877,92952,26071,66881,3.647,13.004,80569,27420,53149,3.836,11.271,12383,1.732,22.543,312,329,3512
2013,5111,11922,17310,440226,448093,952,5.404,1563,8.873,47341,11194,36147,2.498,10.565,63440,21690,41750,4.841,14.158,-16099,-3.593,21.13,934,944,7331
2013,5112,5409,8198,427574,421988,864,10.551,846,10.331,67042,24549,42493,5.817,15.887,55760,23940,31820,5.673,13.214,11282,2.674,26.427,415,437,6701
2013,5121,13246,16488,312950,308679,2378,14.519,2158,13.176,40747,16108,24639,5.218,13.2,32487,11785,20702,3.818,10.525,8260,2.676,21.049,1382,1400,7233
2013,5122,2731,2971,22030,21934,375,12.525,421,14.061,3764,1206,2558,5.498,17.161,3453,2246,1207,10.24,15.743,311,1.418,31.485,289,289,641
2013,5151,4055,8722,220203,221015,573,6.597,500,5.757,20412,8303,12109,3.757,9.236,22137,5462,16675,2.471,10.016,-1725,-0.78,18.471,248,306,3193
2013,5152,375,732,60419,57675,56,7.624,61,8.305,11049,405,10644,0.702,19.158,5299,1054,4245,1.827,9.188,5750,9.97,18.376,34,34,288
2013,5173,4106,42279,1009111,1006933,5202,12.179,6067,14.205,185608,89281,96327,8.867,18.433,182680,89236,93444,8.862,18.142,2928,0.291,36.284,418,491,8899
2013,5174,357,444,8312,8161,73,16.648,62,14.139,1384,768,616,9.411,16.959,1122,557,565,6.825,13.748,262,3.21,27.497,32,32,293
2013,5179,3385,3992,60193,57515,596,14.924,599,14.999,14937,5056,9881,8.791,25.971,9631,4721,4910,8.208,16.745,5306,9.225,33.49,425,429,2100
2013,5182,8527,13394,496797,484348,1893,14.319,1546,11.694,86477,24665,61812,5.092,17.854,61942,24612,37330,5.081,12.789,24535,5.066,25.578,774,798,8559
2013,5191,7755,9728,218957,214102,1636,17.16,1248,13.09,40563,16460,24103,7.688,18.946,30960,9635,21325,4.5,14.46,9603,4.485,28.921,820,822,4818
2013,5211,13,57,18502,18223,0,0,(D),(D),778,0,778,0,4.269,231,(D),227,(D),1.268,547,3.002,2.535,0,0,0
2013,5221,12743,122263,2005729,2008247,3366,2.724,5995,4.851,198186,47641,150545,2.372,9.869,203706,46534,157172,2.317,10.143,-5520,-0.275,19.737,430,549,5714
2013,5222,14554,40868,592534,593432,4738,11.684,4106,10.125,121086,34118,86968,5.749,20.404,124551,68116,56435,11.478,20.988,-3465,-0.584,40.809,914,967,5579
2013,5223,11193,25866,240298,233872,2527,9.742,2676,10.316,50075,18591,31484,7.949,21.411,37586,18516,19070,7.917,16.071,12489,5.34,32.142,1233,1352,6051
2013,5231,11528,41168,395478,403841,3905,9.116,7243,16.908,50424,17158,33266,4.249,12.486,65298,22903,42395,5.671,16.169,-14874,-3.683,24.972,808,834,3383
2013,5232,16,30,5577,5600,5,17.241,(D),(D),220,119,101,2.125,3.929,264,(D),260,(D),4.714,-44,-0.786,7.857,0,0,0
2013,5239,39455,45485,466954,471494,5986,13.349,4703,10.488,59549,24031,35518,5.097,12.63,68357,30206,38151,6.406,14.498,-8808,-1.868,25.26,3216,3234,20180
2013,5241,5682,31439,1457765,1442900,4191,13.263,4512,14.279,161847,39601,122246,2.745,11.217,132258,44539,87719,3.087,9.166,29589,2.051,18.332,284,333,6302
2013,5242,116928,130800,868439,857744,10594,8.091,10851,8.288,121401,40212,81189,4.688,14.154,100348,39795,60553,4.639,11.699,21053,2.454,23.398,7433,7557,24061
2013,5259,644,665,5594,5321,180,28.731,103,16.441,1256,900,356,16.914,23.605,700,386,314,7.254,13.155,556,10.449,26.311,84,84,259
2013,5311,85331,108043,521094,516685,11278,10.517,9660,9.008,86895,43981,42914,8.512,16.818,77436,33086,44350,6.404,14.987,9459,1.831,29.974,6636,6787,21276
2013,5312,58862,68365,243986,237731,12656,19.07,8659,13.047,55942,30050,25892,12.64,23.532,43772,20661,23111,8.691,18.412,12170,5.119,36.825,4609,4672,9693
2013,5313,63873,81324,670225,663853,9408,11.738,7065,8.814,98462,38889,59573,5.858,14.832,85866,31390,54476,4.728,12.934,12596,1.897,25.869,4426,4486,19591
2013,5321,3533,13607,148228,144781,1236,9.181,947,7.034,32196,11981,20215,8.275,22.238,25326,8365,16961,5.778,17.493,6870,4.745,34.985,319,348,1103
2013,5322,7594,19906,152381,154849,1682,8.209,2849,13.905,24246,8329,15917,5.379,15.658,28969,15129,13840,9.77,18.708,-4723,-3.05,31.316,782,827,3089
2013,5323,2208,2603,16089,16005,166,6.34,197,7.523,2302,786,1516,4.911,14.383,2153,625,1528,3.905,13.452,149,0.931,26.904,146,150,458
2013,5324,7282,13203,169131,162924,1116,8.525,893,6.821,31352,6630,24722,4.069,19.243,19124,6456,12668,3.963,11.738,12228,7.505,23.476,541,568,3438
2013,5331,2052,2229,35594,35161,292,13.303,224,10.205,5816,1903,3913,5.412,16.541,5044,2061,2983,5.862,14.345,772,2.196,28.691,154,154,797
2013,5411,159981,170731,1161718,1153188,13333,7.818,12961,7.6,130150,40255,89895,3.491,11.286,112772,35768,77004,3.102,9.779,17378,1.507,19.558,9477,9524,26255
2013,5412,99071,114668,1221306,1219618,10992,9.611,10394,9.088,207797,70293,137504,5.764,17.038,200690,72757,127933,5.966,16.455,7107,0.583,32.91,6334,6380,41761
2013,5413,79279,95039,1390475,1343576,9257,9.76,8879,9.361,251642,99418,152224,7.4,18.729,155600,47466,108134,3.533,11.581,96042,7.148,23.162,5088,5141,18500
2013,5414,24367,24643,103371,101435,3523,14.388,3210,13.109,18635,7680,10955,7.571,18.371,14662,6977,7685,6.878,14.455,3973,3.917,28.909,2186,2187,4873
2013,5415,94090,111995,1600323,1556681,20201,18.304,16935,15.345,342018,159844,182174,10.268,21.971,260631,103284,157347,6.635,16.743,81387,5.228,33.485,9959,10002,42054
2013,5416,113118,122737,1066743,1031867,23255,19.25,19386,16.048,244645,107854,136791,10.452,23.709,175001,76883,98118,7.451,16.96,69644,6.749,33.919,13025,13062,45677
2013,5417,12370,15545,636068,633374,1871,12.112,1675,10.844,85215,16340,68875,2.58,13.454,80636,23546,57090,3.718,12.731,4579,0.723,25.462,1048,1069,8076
2013,5418,29336,32553,439833,436366,3587,10.976,3842,11.756,66475,20696,45779,4.743,15.234,59883,22814,37069,5.228,13.723,6592,1.511,27.446,2709,2740,12313
2013,5419,50875,60150,568428,567278,5809,9.696,5328,8.893,76168,24396,51772,4.301,13.427,74310,27048,47262,4.768,13.099,1858,0.328,26.199,3311,3355,15789
2013,5511,26001,51830,3161257,3147636,3957,7.651,3741,7.233,492380,154231,338149,4.9,15.643,468834,131675,337159,4.183,14.895,23546,0.748,29.79,647,668,7803
2013,5611,25021,27334,444513,429746,3614,13.354,3071,11.348,91500,32892,58608,7.654,21.292,62019,25735,36284,5.988,14.432,29481,6.86,28.863,2314,2320,18398
2013,5612,1749,5094,256575,256690,618,12.128,621,12.187,34134,12324,21810,4.801,13.298,33877,12275,21602,4.782,13.198,257,0.1,26.395,99,104,1969
2013,5613,24268,45294,5059731,4938115,5660,12.718,4078,9.163,963379,191897,771482,3.886,19.509,716713,183681,533032,3.72,14.514,246666,4.995,29.028,2218,2304,102221
2013,5614,24101,30498,762655,763790,3277,10.716,3444,11.262,131509,46727,84782,6.118,17.218,133235,54138,79097,7.088,17.444,-1726,-0.226,34.436,2343,2367,16716
2013,5615,12848,20960,219967,222697,5740,29.309,2989,15.262,39085,18537,20548,8.324,17.551,44780,20946,23834,9.406,20.108,-5695,-2.557,35.102,929,937,3344
2013,5616,17621,24240,884790,862968,2703,11.247,2290,9.528,151426,45252,106174,5.244,17.547,108055,32476,75579,3.763,12.521,43372,5.026,25.043,1539,1549,16647
2013,5617,139098,145963,1704855,1691441,18974,12.991,19167,13.123,266024,76517,189507,4.524,15.728,238592,85232,153360,5.039,14.106,27432,1.622,28.212,12195,12207,49286
2013,5619,15333,17168,268367,266612,1664,9.69,1671,9.731,44266,9903,34363,3.714,16.603,41443,11930,29513,4.475,15.544,2823,1.059,31.089,1114,1184,7578
2013,5621,7329,10521,195534,191245,1014,9.714,850,8.143,32385,9747,22638,5.097,16.934,24194,7151,17043,3.739,12.651,8191,4.283,25.302,516,522,3320
2013,5622,1254,2476,52727,52341,236,9.641,180,7.353,6915,2535,4380,4.843,13.211,6021,1680,4341,3.21,11.503,894,1.708,23.007,103,103,645
2013,5629,7940,9332,128774,126467,879,9.463,792,8.527,23839,4817,19022,3.809,18.85,19035,5184,13851,4.099,15.051,4804,3.799,30.103,498,510,2961
2013,6111,18795,21518,939078,924884,1194,5.59,874,4.092,81115,18308,62807,1.979,8.77,52624,14157,38467,1.531,5.69,28491,3.08,11.38,594,633,10098
2013,6112,469,987,80470,82560,29,2.934,32,3.237,5167,808,4359,0.979,6.259,9380,806,8574,0.976,11.362,-4213,-5.103,12.517,17,18,357
2013,6113,2313,4504,1829099,1830087,170,3.795,120,2.679,72783,5298,67485,0.289,3.977,74293,2559,71734,0.14,4.06,-1510,-0.083,7.954,56,56,861
2013,6114,6470,6837,59043,58608,828,12.04,908,13.203,10282,3304,6978,5.638,17.544,9320,4206,5114,7.177,15.902,962,1.641,31.805,598,606,2771
2013,6115,6200,7939,119930,121589,693,8.735,682,8.596,15911,4990,10921,4.104,13.086,19240,4787,14453,3.937,15.824,-3329,-2.738,26.172,408,439,2666
2013,6116,37718,40489,386988,381108,5308,13.351,3847,9.676,80499,24478,56021,6.423,21.122,68720,22622,46098,5.936,18.032,11779,3.091,36.063,2768,2816,16299
2013,6117,5200,6123,96720,92300,993,16.466,808,13.399,21885,6879,15006,7.453,23.711,12688,5297,7391,5.739,13.747,9197,9.964,27.493,561,561,3623
2013,6211,167973,205385,2302804,2280822,15143,7.362,15756,7.66,314961,102572,212389,4.497,13.809,271552,95131,176421,4.171,11.906,43409,1.903,23.812,10863,11106,58341
2013,6212,119148,127214,874461,872412,6570,5.177,5973,4.706,99895,32912,66983,3.773,11.45,96070,29663,66407,3.4,11.012,3825,0.438,22.024,4839,4880,24303
2013,6213,114079,129229,765048,750879,12174,9.517,9563,7.476,135813,44284,91529,5.898,18.087,107392,36983,70409,4.925,14.302,28421,3.785,28.604,6488,6568,21287
2013,6214,15434,35617,826632,805504,2704,7.679,1894,5.379,115139,38841,76298,4.822,14.294,74058,20586,53472,2.556,9.194,41081,5.1,18.388,857,893,9481
2013,6215,7167,12712,252518,250547,1055,8.253,1198,9.371,29806,8032,21774,3.206,11.896,25880,10403,15477,4.152,10.329,3926,1.567,20.659,586,615,4857
2013,6216,19500,27796,1272110,1257181,3267,11.907,2550,9.294,186267,42974,143293,3.418,14.816,155698,43422,112276,3.454,12.385,30569,2.432,24.769,1759,1798,26437
2013,6219,6391,10125,308202,304227,903,9.023,668,6.675,43304,13730,29574,4.513,14.234,35394,11287,24107,3.71,11.634,7910,2.6,23.268,419,424,5625
2013,6221,2772,5077,5139939,5158785,123,2.435,70,1.386,180103,19749,160354,0.383,3.491,219128,31084,188044,0.603,4.248,-39025,-0.756,6.982,35,37,13940
2013,6222,410,603,227157,225275,26,4.355,14,2.345,14261,805,13456,0.357,6.33,10725,2727,7998,1.211,4.761,3536,1.57,9.522,8,8,2226
2013,6223,412,956,273247,271792,77,8.315,17,1.836,17211,5060,12151,1.862,6.332,14405,2672,11733,0.983,5.3,2806,1.032,10.6,3,3,429
2013,6231,8038,15616,1633889,1629444,920,5.936,684,4.413,119972,53599,66373,3.289,7.363,111060,36232,74828,2.224,6.816,8912,0.547,13.632,400,424,23194
2013,6232,9104,35374,679482,675945,1956,5.556,1614,4.585,92361,22140,70221,3.275,13.664,85552,23534,62018,3.482,12.657,6809,1.007,25.313,331,397,7190
2013,6233,16031,23001,910648,901615,1811,7.934,1459,6.392,92718,27379,65339,3.037,10.284,74619,26189,48430,2.905,8.276,18099,2.007,16.552,1003,1048,17788
2013,6239,2954,5121,137620,133084,498,9.848,370,7.317,24150,11383,12767,8.553,18.146,14313,4499,9814,3.381,10.755,9837,7.392,21.51,164,173,2167
2013,6241,47629,63522,1468099,1454894,7709,12.407,4936,7.944,208823,53593,155230,3.684,14.353,181758,49184,132574,3.381,12.493,27065,1.86,24.986,2768,2836,27625
2013,6242,10192,14450,185801,187721,654,4.502,807,5.555,21846,4077,17769,2.172,11.637,25423,8682,16741,4.625,13.543,-3577,-1.905,23.275,418,430,5751
2013,6243,3978,7482,328515,327049,381,5.061,474,6.296,39538,4349,35189,1.33,12.089,36749,8107,28642,2.479,11.237,2789,0.853,22.473,161,170,2279
2013,6244,55151,70227,864285,863535,6534,9.297,6641,9.449,114493,41765,72728,4.837,13.259,113036,42734,70302,4.949,13.09,1457,0.169,26.18,4738,4791,27516
2013,7111,6971,7110,118002,117112,812,11.476,743,10.501,18449,4642,13807,3.964,15.753,16589,4904,11685,4.187,14.165,1860,1.588,28.33,481,481,3390
2013,7112,3375,3553,128775,127033,430,12.04,467,13.076,15454,3082,12372,2.426,12.165,11934,2383,9551,1.876,9.394,3520,2.771,18.789,368,369,1992
2013,7113,5654,5985,149927,145760,697,11.821,520,8.819,26305,7144,19161,4.901,18.047,17817,5152,12665,3.535,12.224,8488,5.823,24.447,376,376,1726
2013,7114,2893,3004,17502,17159,404,13.555,357,11.978,2955,1275,1680,7.431,17.222,2237,1086,1151,6.329,13.037,718,4.185,26.075,242,242,709
2013,7115,14130,14168,42472,42344,2588,18.453,2301,16.407,10427,5463,4964,12.901,24.625,10155,4558,5597,10.764,23.982,272,0.642,47.964,1338,1338,2633
2013,7121,6514,6981,139730,138298,383,5.527,279,4.027,10709,1999,8710,1.445,7.743,7793,958,6835,0.693,5.635,2916,2.108,11.27,173,173,638
2013,7131,2392,2730,172380,168094,342,12.505,352,12.87,19277,4436,14841,2.639,11.468,10972,2563,8409,1.525,6.527,8305,4.941,13.055,281,282,2134
2013,7132,1870,2808,166369,160883,246,8.816,211,7.561,24195,11477,12718,7.134,15.039,13012,3327,9685,2.068,8.088,11183,6.951,16.176,154,154,2734
2013,7139,48747,55860,1177574,1172585,6180,11.126,5553,9.997,153135,59747,93388,5.095,13.06,142819,44683,98136,3.811,12.18,10316,0.88,24.36,4043,4068,30066
2013,7211,39261,50131,1901581,1896790,4121,8.23,4000,7.989,198624,78303,120321,4.128,10.472,188708,84102,104606,4.434,9.949,9916,0.523,19.898,2405,2467,37014
2013,7212,5348,5932,41755,41596,438,7.384,438,7.384,6217,1255,4962,3.017,14.946,5846,1324,4522,3.183,14.054,371,0.892,28.109,274,279,899
2013,7213,1854,1978,11031,11009,100,5.029,121,6.085,1717,709,1008,6.44,15.597,1684,457,1227,4.151,15.297,33,0.3,30.595,76,76,218
2013,7223,14094,38782,713880,691713,8537,23.259,4382,11.939,171175,102076,69099,14.757,24.747,125791,57854,67937,8.364,18.185,45384,6.561,36.371,1490,1533,9045
2013,7224,38964,39828,365744,358486,5192,13.172,4372,11.091,76663,41438,35225,11.559,21.385,62009,26657,35352,7.436,17.297,14654,4.088,34.595,3556,3565,22356
2013,7225,347139,476600,9352466,9190883,49863,10.523,44325,9.355,1480850,651841,829009,7.092,16.112,1153164,440224,712940,4.79,12.547,327686,3.565,25.094,34422,35336,306887
2013,8111,134105,146832,826382,821176,12384,8.442,12103,8.251,119543,44596,74947,5.431,14.558,109469,40281,69188,4.905,13.331,10074,1.227,26.662,8826,8934,29992
2013,8112,9901,11166,101082,102390,1181,10.5,1345,11.958,12698,4226,8472,4.127,12.402,15110,6270,8840,6.124,14.757,-2412,-2.356,24.803,923,930,3066
2013,8113,17703,19451,193455,191507,1909,9.884,1635,8.465,34063,13978,20085,7.299,17.787,29579,12257,17322,6.4,15.445,4484,2.341,30.891,1083,1091,4523
2013,8114,16993,17601,66589,66313,2017,11.483,1945,11.073,11000,4734,6266,7.139,16.588,10359,4525,5834,6.824,15.621,641,0.967,31.243,1424,1426,3168
2013,8121,91489,107921,655420,648059,13369,12.5,11438,10.694,117592,54344,63248,8.386,18.145,102690,41510,61180,6.405,15.846,14902,2.299,31.692,8802,8943,32083
2013,8122,14248,19591,135119,137870,637,3.211,1128,5.686,11798,2360,9438,1.712,8.557,17061,5971,11090,4.331,12.375,-5263,-3.817,17.115,481,499,2000
2013,8123,28262,33487,293419,293485,2484,7.376,2861,8.496,39644,11134,28510,3.794,13.508,39352,16293,23059,5.552,13.409,292,0.099,26.817,2061,2136,10058
2013,8129,24723,34217,261454,256973,5690,16.899,4599,13.658,55141,23999,31142,9.339,21.458,45725,21667,24058,8.432,17.794,9416,3.664,35.587,2025,2045,7455
2013,8131,176969,177301,1684103,1685311,7697,4.348,7131,4.028,139734,22391,117343,1.329,8.291,142577,25930,116647,1.539,8.46,-2843,-0.169,16.583,4493,4493,11930
2013,8132,16039,18044,176495,175993,1267,7.04,1171,6.507,18194,4330,13864,2.46,10.338,16882,4171,12711,2.37,9.592,1312,0.745,19.185,742,746,2554
2013,8133,13700,16139,155045,153662,1208,7.516,1076,6.694,21268,5966,15302,3.883,13.841,18484,5117,13367,3.33,12.029,2784,1.812,24.058,675,675,2844
2013,8134,22759,24631,237124,236981,1226,4.97,1298,5.262,26523,5341,21182,2.254,11.192,26294,4965,21329,2.095,11.095,229,0.097,22.191,869,871,3127
2013,8139,54536,56677,487808,491386,2455,4.314,2914,5.121,44281,8701,35580,1.771,9.011,51296,10573,40723,2.152,10.439,-7015,-1.428,18.023,2019,2022,6982
2014,1131,362,410,3005,3034,29,7.117,24,5.89,467,70,397,2.307,15.392,515,99,416,3.263,16.974,-48,-1.582,30.784,14,14,21
2014,1132,123,139,1459,1523,17,12.734,6,4.494,165,41,124,2.693,10.837,279,8,271,0.525,18.325,-114,-7.488,21.675,(D),(D),(D)
2014,1133,7039,7128,49700,49565,697,9.775,702,9.845,7046,2003,5043,4.041,14.216,6796,2242,4554,4.523,13.711,250,0.504,27.423,505,506,1549
2014,1141,1204,1215,5957,5951,206,17.004,199,16.426,893,366,527,6.151,15.007,879,294,585,4.941,14.772,14,0.235,29.544,122,122,175
2014,1142,274,274,1474,1441,41,15.679,16,6.119,207,88,119,6.107,14.365,144,31,113,2.151,9.993,63,4.372,19.986,13,13,27
2014,1151,3534,3861,64139,63071,367,9.495,375,9.702,10278,2834,7444,4.493,16.296,8016,3211,4805,5.091,12.709,2262,3.586,25.419,263,263,2824
2014,1152,3687,3789,19159,18743,470,12.475,427,11.334,3246,1712,1534,9.134,17.318,2431,969,1462,5.17,12.97,815,4.348,25.94,325,325,785
2014,1153,1246,1318,10443,10357,149,11.378,132,10.08,1767,453,1314,4.374,17.062,1642,669,973,6.46,15.855,125,1.207,31.71,67,67,436
2014,2111,5834,7390,136102,133175,679,9.233,607,8.254,24364,8756,15608,6.575,18.295,18331,6097,12234,4.578,13.765,6033,4.53,27.529,375,388,2725
2014,2121,465,852,74748,79662,72,8.131,139,15.697,10009,4185,5824,5.253,12.564,19480,9226,10254,11.582,24.453,-9471,-11.889,25.129,54,54,890
2014,2122,253,322,42410,41867,42,12.844,52,15.902,4182,1089,3093,2.601,9.989,3103,574,2529,1.371,7.412,1079,2.577,14.823,46,46,562
2014,2123,2701,4783,78219,77741,250,5.206,289,6.018,8425,1646,6779,2.117,10.837,7448,2198,5250,2.827,9.581,977,1.257,19.161,144,144,1357
2014,2131,10834,13494,423417,410268,1803,13.635,1261,9.536,81622,25624,55998,6.246,19.895,55562,18138,37424,4.421,13.543,26060,6.352,27.086,860,878,8655
2014,2211,1707,10429,507152,509325,478,4.591,443,4.255,32325,5837,26488,1.146,6.347,36281,8476,27805,1.664,7.123,-3956,-0.777,12.693,64,74,701
2014,2212,432,2503,85320,84056,160,6.452,114,4.597,9227,3551,5676,4.225,10.977,6708,1824,4884,2.17,7.98,2519,2.997,15.961,22,22,216
2014,2213,3475,4606,42426,42248,223,4.853,201,4.374,3224,888,2336,2.102,7.631,2904,884,2020,2.092,6.874,320,0.757,13.747,101,102,371
2014,2361,125545,126805,595941,574655,23490,18.829,19385,15.539,154230,62972,91258,10.958,26.839,111405,50513,60892,8.79,19.386,42825,7.452,38.773,12385,12389,33587
2014,2362,35317,36670,576922,570191,3594,9.771,3818,10.38,100741,21175,79566,3.714,17.668,87116,21245,65871,3.726,15.278,13625,2.39,30.557,2618,2620,12894
2014,2371,16066,17681,540263,531633,1587,9.012,1446,8.211,102633,27743,74890,5.218,19.305,85028,17201,67827,3.236,15.994,17605,3.311,31.988,912,915,6981
2014,2372,4455,4521,24270,24153,411,8.946,557,12.125,4026,1285,2741,5.32,16.669,3766,1834,1932,7.593,15.593,260,1.076,31.185,420,420,1321
2014,2373,7989,8779,260511,256925,625,7.075,735,8.32,42059,9565,32494,3.723,16.37,35358,7510,27848,2.923,13.762,6701,2.608,27.524,454,483,4228
2014,2379,3499,3635,80239,80892,400,11.068,358,9.906,12160,2570,9590,3.177,15.032,13395,3555,9840,4.395,16.559,-1235,-1.527,30.065,230,230,1655
2014,2381,69343,70089,708008,691182,9263,13.256,8842,12.653,154400,38199,116201,5.527,22.339,120913,35392,85521,5.121,17.494,33487,4.845,34.987,5261,5271,23617
2014,2382,151904,156111,1737100,1702796,15018,9.686,12907,8.324,282875,60788,222087,3.57,16.612,214365,52646,161719,3.092,12.589,68510,4.023,25.178,8921,8938,36065
2014,2383,87561,88571,662145,646969,11875,13.5,10664,12.123,139750,37239,102511,5.756,21.601,108773,35587,73186,5.501,16.813,30977,4.788,33.625,6927,6932,23162
2014,2389,51931,52644,515637,498664,6780,12.982,5945,11.383,108113,28672,79441,5.75,21.681,74423,24955,49468,5.004,14.924,33690,6.756,29.849,3562,3562,14273
2014,3111,1040,1628,47025,46584,78,4.787,81,4.971,4852,1597,3255,3.428,10.416,3976,1434,2542,3.078,8.535,876,1.88,17.07,49,50,429
2014,3112,475,823,56850,56060,55,6.761,36,4.425,4367,583,3784,1.04,7.79,2721,692,2029,1.234,4.854,1646,2.936,9.707,24,24,253
2014,3113,1630,1799,75562,74740,137,7.658,117,6.54,7427,993,6434,1.329,9.937,5619,780,4839,1.044,7.518,1808,2.419,15.036,92,92,596
2014,3114,1351,1713,157654,157523,166,9.899,94,5.605,12138,2942,9196,1.868,7.706,11867,3242,8625,2.058,7.534,271,0.172,15.067,65,65,896
2014,3115,1098,1591,136938,136060,131,8.368,80,5.11,10688,1582,9106,1.163,7.855,8986,3275,5711,2.407,6.604,1702,1.251,13.209,41,41,675
2014,3116,2802,3394,467424,472542,151,4.429,181,5.309,27211,6035,21176,1.277,5.758,36806,7764,29042,1.643,7.789,-9595,-2.031,11.517,123,123,2081
2014,3117,469,559,32292,32016,46,8.364,28,5.091,3368,608,2760,1.899,10.52,2716,617,2099,1.927,8.483,652,2.037,16.967,14,14,156
2014,3118,9449,10158,280441,276416,999,9.904,857,8.496,32279,8929,23350,3.23,11.678,24121,7178,16943,2.597,8.726,8158,2.951,17.453,692,694,4475
2014,3119,2778,3229,183699,180104,362,11.529,184,5.86,20110,7615,12495,4.228,11.166,13167,2226,10941,1.236,7.311,6943,3.855,14.622,137,137,1102
2014,3121,4979,5596,155282,151121,960,18.194,321,6.084,19012,5649,13363,3.738,12.581,10590,1840,8750,1.218,7.008,8422,5.573,14.015,242,242,1274
2014,3122,102,125,14610,14531,22,18.644,8,6.78,1072,209,863,1.438,7.377,885,68,817,0.468,6.09,187,1.287,12.181,7,7,52
2014,3131,239,303,25044,25031,18,5.921,20,6.579,1366,162,1204,0.647,5.457,1382,162,1220,0.647,5.521,-16,-0.064,10.915,13,13,30
2014,3132,812,890,50388,50664,43,4.834,42,4.722,3515,667,2848,1.317,6.938,3965,920,3045,1.816,7.826,-450,-0.888,13.876,24,24,148
2014,3133,909,956,28586,28791,49,5.01,93,9.509,2303,298,2005,1.035,7.999,2646,961,1685,3.338,9.19,-343,-1.191,15.998,68,68,716
2014,3141,1638,1749,53726,53425,80,4.507,132,7.437,4662,817,3845,1.529,8.726,4108,1355,2753,2.536,7.689,554,1.037,15.379,102,103,555
2014,3149,3837,3933,59125,59411,321,8.127,355,8.987,6141,1523,4618,2.564,10.337,6653,2305,4348,3.88,11.198,-512,-0.862,20.673,279,279,1798
2014,3151,220,231,12127,12155,14,5.882,28,11.765,1078,112,966,0.921,8.869,1108,278,830,2.287,9.116,-30,-0.247,17.738,22,24,267
2014,3152,4933,4980,85863,88279,887,18.03,766,15.571,14353,6757,7596,7.654,16.259,19168,6798,12370,7.701,21.713,-4815,-5.454,32.518,656,657,5772
2014,3159,510,516,8613,8619,71,13.935,58,11.384,907,260,647,3.017,10.524,922,314,608,3.643,10.698,-15,-0.174,21.048,45,45,142
2014,3161,170,180,3381,3477,6,3.306,9,4.959,140,12,128,0.345,4.026,326,20,306,0.575,9.376,-186,-5.349,8.053,4,4,11
2014,3162,202,219,11443,11540,40,19.324,16,7.729,1078,292,786,2.53,9.342,1244,236,1008,2.045,10.78,-166,-1.439,18.684,12,12,130
2014,3169,650,654,10635,10585,69,10.632,59,9.091,1241,561,680,5.3,11.724,1078,319,759,3.014,10.184,163,1.54,20.368,51,51,266
2014,3211,2582,2975,80089,78488,212,7.105,230,7.708,9342,3301,6041,4.206,11.902,6147,2033,4114,2.59,7.832,3195,4.071,15.664,180,180,1444
2014,3212,1064,1358,68288,66307,83,6.13,75,5.539,8656,2496,6160,3.764,13.054,4641,1194,3447,1.801,6.999,4015,6.055,13.999,53,54,488
2014,3219,7528,8485,217229,214738,688,8.144,613,7.257,26862,6255,20607,2.913,12.509,21703,5834,15869,2.717,10.107,5159,2.402,20.214,434,437,3413
2014,3221,222,439,106944,107349,18,4.11,16,3.653,4504,1070,3434,0.997,4.196,5314,619,4695,0.577,4.95,-810,-0.755,8.391,5,5,182
2014,3222,2461,3735,244626,244416,130,3.445,208,5.511,17681,4131,13550,1.69,7.234,17396,7295,10101,2.985,7.117,285,0.117,14.235,114,118,1922
2014,3231,23680,24909,458115,460898,1348,5.352,1908,7.575,38372,10121,28251,2.196,8.325,43838,17260,26578,3.745,9.511,-5466,-1.186,16.651,1530,1541,10376
2014,3241,921,2101,101897,100029,136,6.473,136,6.473,8674,1444,7230,1.444,8.672,5009,1145,3864,1.145,5.008,3665,3.664,10.015,39,41,147
2014,3251,1292,2363,159030,158635,95,4.003,115,4.846,13145,1369,11776,0.863,8.286,12174,2020,10154,1.273,7.674,971,0.612,15.348,68,69,904
2014,3252,1049,1388,95600,93561,51,3.678,48,3.462,9291,2567,6724,2.744,9.93,5375,1483,3892,1.585,5.745,3916,4.186,11.49,28,28,475
2014,3253,623,868,28567,28224,61,7.02,63,7.25,2973,806,2167,2.856,10.534,2229,654,1575,2.317,7.898,744,2.636,15.795,35,35,335
2014,3254,1602,2052,235119,233590,166,8.145,138,6.771,20243,3382,16861,1.448,8.666,17443,5571,11872,2.385,7.467,2800,1.199,14.935,91,91,1770
2014,3255,1264,1597,56564,56020,73,4.568,75,4.693,5936,1399,4537,2.497,10.596,4869,1580,3289,2.82,8.692,1067,1.905,17.383,43,43,528
2014,3256,1860,2054,94974,94709,114,5.527,131,6.352,7538,1084,6454,1.145,7.959,6934,2576,4358,2.72,7.321,604,0.638,14.643,92,92,797
2014,3259,1704,2176,77980,78954,107,4.878,142,6.474,6266,1419,4847,1.797,7.936,8254,2216,6038,2.807,10.454,-1988,-2.518,15.873,94,97,1285
2014,3261,7962,10205,594638,587194,386,3.763,489,4.768,54422,10250,44172,1.746,9.268,39533,12187,27346,2.075,6.733,14889,2.536,13.465,299,303,4853
2014,3262,1433,1856,129692,128876,87,4.688,87,4.688,8832,1457,7375,1.131,6.853,7055,1336,5719,1.037,5.474,1777,1.379,10.949,57,57,589
2014,3271,890,1068,33028,32830,63,5.833,87,8.056,3335,305,3030,0.929,10.159,2908,1159,1749,3.53,8.858,427,1.301,17.716,62,62,523
2014,3272,1373,1637,85698,85520,117,7.138,121,7.383,6959,1730,5229,2.023,8.137,6555,1442,5113,1.686,7.665,404,0.472,15.33,81,83,726
2014,3273,3948,8171,154803,152720,408,4.953,540,6.556,21194,4440,16754,2.907,13.878,17184,5489,11695,3.594,11.252,4010,2.626,22.504,194,205,2324
2014,3274,155,285,13320,12757,8,2.749,20,6.873,1554,344,1210,2.697,12.182,446,144,302,1.129,3.496,1108,8.686,6.993,11,11,56
2014,3279,2496,2951,72225,71301,143,4.802,197,6.615,7506,1823,5683,2.557,10.527,5720,1495,4225,2.097,8.022,1786,2.505,16.045,120,120,690
2014,3311,322,477,101430,101134,42,8.898,32,6.78,4760,754,4006,0.746,4.707,4399,820,3579,0.811,4.35,361,0.357,8.699,20,20,167
2014,3312,505,630,48798,48564,30,4.736,37,5.841,3808,570,3238,1.174,7.841,3429,889,2540,1.831,7.061,379,0.78,14.122,22,23,258
2014,3313,400,526,55239,55949,15,2.825,25,4.708,3106,414,2692,0.74,5.552,4645,621,4024,1.11,8.302,-1539,-2.751,11.103,11,11,143
2014,3314,759,953,60713,61052,29,3.024,41,4.275,3788,775,3013,1.269,6.205,4463,982,3481,1.608,7.31,-675,-1.106,12.409,30,30,596
2014,3315,1523,1728,125238,125271,56,3.213,86,4.934,8347,1787,6560,1.427,6.663,8354,1601,6753,1.278,6.669,-7,-0.006,13.326,66,66,759
2014,3321,2196,2425,113919,113536,71,2.912,97,3.979,8677,873,7804,0.769,7.643,7849,1420,6429,1.251,6.913,828,0.729,13.827,71,71,942
2014,3322,1053,1130,35142,35447,53,4.674,61,5.379,2266,479,1787,1.351,6.393,2891,1085,1806,3.061,8.156,-625,-1.763,12.785,33,33,199
2014,3323,10762,11694,332599,330399,594,5.059,690,5.876,33785,5465,28320,1.654,10.226,29360,8657,20703,2.62,8.886,4425,1.339,17.772,488,491,5802
2014,3324,1202,1509,91496,90936,66,4.39,55,3.658,7616,1254,6362,1.379,8.375,6364,1511,4853,1.662,6.998,1252,1.377,13.997,32,32,713
2014,3325,518,567,25867,25573,32,5.634,34,5.986,2464,206,2258,0.806,9.635,1825,794,1031,3.105,7.137,639,2.499,14.273,23,23,182
2014,3326,1063,1199,38840,38825,43,3.555,64,5.291,3346,568,2778,1.463,8.618,3384,1069,2315,2.753,8.716,-38,-0.098,17.236,45,46,644
2014,3327,21664,22187,390932,389439,951,4.262,1205,5.4,35937,8200,27737,2.106,9.228,32979,7954,25025,2.042,8.468,2958,0.76,16.937,920,921,5166
2014,3328,5000,5547,128133,126929,238,4.288,245,4.414,13408,2727,10681,2.148,10.563,10882,2643,8239,2.082,8.573,2526,1.99,17.147,189,189,1436
2014,3329,5651,6187,265089,262924,438,7.129,351,5.713,24236,4990,19246,1.898,9.218,19982,4851,15131,1.845,7.6,4254,1.618,15.2,255,256,2838
2014,3331,2554,2957,216703,216135,173,5.893,130,4.429,18500,4201,14299,1.944,8.559,17848,3781,14067,1.749,8.258,652,0.302,16.516,93,97,1021
2014,3332,2939,3096,100997,100366,147,4.726,176,5.658,8817,1182,7635,1.178,8.785,7501,2414,5087,2.405,7.474,1316,1.311,14.947,129,129,1276
2014,3333,1804,1924,75825,75655,108,5.6,117,6.067,6169,1175,4994,1.553,8.154,5991,1528,4463,2.02,7.919,178,0.235,15.838,81,84,674
2014,3334,1451,1719,127163,127217,76,4.385,104,6.001,10375,1683,8692,1.323,8.155,10609,3153,7456,2.478,8.339,-234,-0.184,16.311,72,72,1241
2014,3335,6134,6358,146921,146626,210,3.28,298,4.655,12047,2709,9338,1.848,8.216,11513,4606,6907,3.141,7.852,534,0.364,15.704,235,235,2330
2014,3336,828,1038,102177,101890,53,5.096,57,5.481,9084,2941,6143,2.886,8.916,8565,2960,5605,2.905,8.406,519,0.509,16.812,42,43,531
2014,3339,5161,5817,291453,288822,199,3.41,235,4.027,24317,3920,20397,1.357,8.419,19097,3877,15220,1.342,6.612,5220,1.807,13.224,155,155,1230
2014,3341,957,988,43231,52355,87,8.846,78,7.931,4017,1764,2253,3.369,7.673,21799,5232,16567,9.993,41.637,-17782,-33.964,15.345,50,50,601
2014,3342,1182,1309,97397,99215,82,6.184,116,8.748,7194,3184,4010,3.209,7.251,11167,1802,9365,1.816,11.255,-3973,-4.004,14.502,82,83,1332
2014,3343,428,437,9341,9040,39,9.028,29,6.713,1319,332,987,3.673,14.591,745,93,652,1.029,8.241,574,6.35,16.482,23,23,73
2014,3344,3429,3877,270193,271796,201,5.144,262,6.705,25377,4333,21044,1.594,9.337,28026,8905,19121,3.276,10.311,-2649,-0.975,18.674,195,196,2497
2014,3345,4357,5024,387560,386481,258,5.117,294,5.831,31439,6914,24525,1.789,8.135,28738,7639,21099,1.977,7.436,2701,0.699,14.872,190,190,2193
2014,3346,465,474,11756,12772,51,10.526,72,14.861,705,385,320,3.015,5.52,2667,1166,1501,9.13,20.882,-1962,-15.362,11.04,52,52,326
2014,3351,969,1033,41822,42379,81,7.803,91,8.767,3752,858,2894,2.025,8.853,4813,1894,2919,4.469,11.357,-1061,-2.504,17.707,62,63,445
2014,3352,224,266,47317,45667,23,8.696,20,7.561,4643,634,4009,1.388,10.167,1382,206,1176,0.451,3.026,3261,7.141,6.053,18,18,204
2014,3353,1781,2060,117399,116872,80,3.854,112,5.395,7931,1203,6728,1.029,6.786,6832,1945,4887,1.664,5.846,1099,0.94,11.691,74,74,815
2014,3359,1761,2036,130684,130732,98,4.796,113,5.53,11211,2443,8768,1.869,8.576,11441,3037,8404,2.323,8.752,-230,-0.176,17.151,74,74,833
2014,3361,261,315,170360,166101,26,8.241,27,8.558,12662,107,12555,0.064,7.623,4369,304,4065,0.183,2.63,8293,4.993,5.261,25,25,215
2014,3362,1543,1810,128698,124568,109,6.009,117,6.45,17583,2558,15025,2.054,14.115,9310,3850,5460,3.091,7.474,8273,6.641,14.948,85,85,1310
2014,3363,3991,4890,511530,500432,227,4.647,217,4.442,54142,8400,45742,1.679,10.819,31222,7961,23261,1.591,6.239,22920,4.58,12.478,149,150,3386
2014,3364,1275,1684,370849,367955,91,5.41,87,5.172,33189,6213,26976,1.689,9.02,26585,4176,22409,1.135,7.225,6604,1.795,14.45,58,58,397
2014,3365,157,238,30657,30797,15,6.41,7,2.991,3148,442,2706,1.435,10.222,3440,52,3388,0.169,11.17,-292,-0.948,20.444,4,4,24
2014,3366,1293,1413,138762,139161,126,8.971,109,7.761,13494,1884,11610,1.354,9.697,14480,8783,5697,6.311,10.405,-986,-0.709,19.393,67,67,699
2014,3369,793,821,32414,32357,82,10.031,75,9.174,3321,512,2809,1.582,10.264,3110,580,2530,1.793,9.612,211,0.652,19.223,64,64,364
2014,3371,10093,10363,215266,210940,766,7.338,918,8.794,29133,5490,23643,2.603,13.811,20289,9775,10514,4.634,9.618,8844,4.193,19.237,680,682,6658
2014,3372,3326,3491,108197,106554,180,5.101,255,7.227,13111,2391,10720,2.244,12.305,9847,3111,6736,2.92,9.241,3264,3.063,18.483,191,191,2301
2014,3379,642,731,31222,31302,25,3.369,47,6.334,2931,403,2528,1.287,9.364,3099,1145,1954,3.658,9.9,-168,-0.537,18.728,36,36,459
2014,3391,9496,10424,281855,283151,611,5.809,798,7.587,23587,4179,19408,1.476,8.33,25918,7096,18822,2.506,9.153,-2331,-0.823,16.66,628,629,2825
2014,3399,14319,14705,260127,258342,1475,10.077,1341,9.161,27928,8447,19481,3.27,10.81,24251,8125,16126,3.145,9.387,3677,1.423,18.774,1058,1060,6200
2014,4231,15797,23419,379512,374847,1440,6.143,1483,6.327,42194,11398,30796,3.041,11.256,32545,9276,23269,2.475,8.682,9649,2.574,17.364,997,1038,6173
2014,4232,9877,11668,148439,146208,846,7.234,901,7.704,17747,3159,14588,2.161,12.138,13349,4574,8775,3.128,9.13,4398,3.008,18.26,602,611,3071
2014,4233,9496,16010,204924,199880,1211,7.624,960,6.044,27978,8768,19210,4.387,13.997,17563,6283,11280,3.143,8.787,10415,5.211,17.574,570,610,3703
2014,4234,21625,33367,654353,661677,3562,10.681,3526,10.573,79909,20609,59300,3.115,12.077,95429,44087,51342,6.663,14.422,-15520,-2.346,24.153,1610,1640,9943
2014,4235,7191,9872,153414,152476,423,4.241,628,6.296,15440,2550,12890,1.672,10.126,13550,5287,8263,3.467,8.887,1890,1.24,17.773,358,369,1989
2014,4236,18338,28129,522608,517525,1914,6.806,1901,6.76,69610,14429,55181,2.788,13.451,59412,16740,42672,3.235,11.48,10198,1.971,22.96,1075,1122,6167
2014,4237,10069,18790,229021,228336,823,4.376,856,4.552,22786,4747,18039,2.079,9.979,21264,8960,12304,3.924,9.313,1522,0.667,18.625,387,411,2406
2014,4238,38785,56036,757314,746197,2903,5.169,3152,5.612,84651,22902,61749,3.069,11.344,62474,21871,40603,2.931,8.372,22177,2.972,16.745,1764,1818,9706
2014,4239,27980,31381,336239,337263,2949,9.376,3094,9.837,40471,12326,28145,3.655,12,42269,15129,27140,4.486,12.533,-1798,-0.533,24,2221,2302,9440
2014,4241,7464,9639,147183,147308,429,4.397,663,6.796,13080,3374,9706,2.29,8.879,13270,5669,7601,3.848,9.008,-190,-0.129,17.759,430,441,1983
2014,4242,6075,9348,298893,296761,833,8.972,706,7.604,31043,7152,23891,2.41,10.461,26720,7221,19499,2.433,9.004,4323,1.457,18.008,443,452,3569
2014,4243,13510,14679,200946,198793,1672,11.465,1481,10.155,28013,8281,19732,4.166,14.092,23557,6043,17514,3.04,11.85,4456,2.242,23.7,1124,1150,4436
2014,4244,24687,31725,795006,785493,2681,8.475,2500,7.903,91327,22582,68745,2.875,11.627,71241,26442,44799,3.366,9.07,20086,2.557,18.139,1679,1698,12553
2014,4245,3230,6027,62032,61325,306,5.096,262,4.363,6616,1524,5092,2.485,10.788,5222,1072,4150,1.748,8.515,1394,2.273,17.031,144,150,599
2014,4246,8054,12344,156161,154941,658,5.297,814,6.553,21260,4605,16655,2.972,13.721,18837,5577,13260,3.599,12.158,2423,1.564,24.315,350,355,1619
2014,4247,4179,6446,102075,102303,361,5.616,325,5.056,12189,2867,9322,2.802,11.915,12980,2722,10258,2.661,12.688,-791,-0.773,23.829,198,201,1574
2014,4248,3251,4188,193437,190747,321,7.709,273,6.556,16177,2801,13376,1.468,8.481,10709,3073,7636,1.611,5.614,5468,2.867,11.228,205,207,2076
2014,4249,20247,26688,332285,330085,2216,8.319,2117,7.947,39574,9766,29808,2.959,11.989,35366,12805,22561,3.879,10.714,4208,1.275,21.428,1492,1540,8250
2014,4251,35017,37391,288416,286195,4121,10.921,4809,12.744,48365,16054,32311,5.609,16.899,44090,17007,27083,5.942,15.406,4275,1.494,30.811,3742,3767,11877
2014,4411,37475,43023,1190210,1164863,3698,8.635,3304,7.715,128851,41082,87769,3.527,11.061,78119,29393,48726,2.523,6.706,50732,4.355,13.413,2553,2580,22725
2014,4412,11338,12908,133545,130307,902,6.977,941,7.279,18414,5518,12896,4.235,14.131,11966,4849,7117,3.721,9.183,6448,4.948,18.366,684,692,3557
2014,4413,26833,55506,507601,500322,2964,5.36,2545,4.602,50724,16673,34051,3.332,10.138,36237,10334,25903,2.065,7.243,14487,2.896,14.485,1684,1737,6178
2014,4421,13245,22319,197276,195835,1876,8.412,1839,8.246,24735,8705,16030,4.445,12.631,21899,8565,13334,4.374,11.182,2836,1.448,22.365,1119,1189,4761
2014,4422,17946,25691,230493,229963,1611,6.222,2009,7.76,24117,7408,16709,3.221,10.487,23033,7849,15184,3.413,10.016,1084,0.471,20.032,1224,1241,3402
2014,4431,22444,42228,399008,401813,3378,7.775,5814,13.382,47173,14963,32210,3.724,11.74,54223,25172,29051,6.265,13.495,-7050,-1.755,23.48,2683,3023,11139
2014,4441,35163,57336,1118117,1103459,2546,4.436,2665,4.643,88716,17831,70885,1.616,8.04,59037,12634,46403,1.145,5.35,29679,2.69,10.7,1853,1889,7424
2014,4442,12565,16216,142407,143575,933,5.721,1115,6.838,16202,4702,11500,3.275,11.285,18810,4442,14368,3.094,13.101,-2608,-1.816,22.569,775,793,3036
2014,4451,59875,86321,2743363,2671369,8281,9.626,7698,8.948,297450,139529,157921,5.223,11.135,159165,57628,101537,2.157,5.958,138285,5.177,11.916,5815,5901,28654
2014,4452,16264,19966,150211,148677,2242,11.27,2097,10.541,26656,10876,15780,7.315,17.929,23713,9130,14583,6.141,15.949,2943,1.979,31.899,1619,1638,7190
2014,4453,27248,31108,157151,156766,2700,8.758,2143,6.951,21919,8634,13285,5.508,13.982,21139,6604,14535,4.213,13.484,780,0.498,26.969,1679,1700,5285
2014,4461,39758,88240,1014385,1010900,5577,6.343,4954,5.634,98122,31320,66802,3.098,9.706,91920,26229,65691,2.595,9.093,6202,0.614,18.186,3118,3410,15750
2014,4471,61506,107176,901502,893217,7136,6.634,7916,7.359,119411,42252,77159,4.73,13.369,102640,38463,64177,4.306,11.491,16771,1.878,22.982,4977,5225,22294
2014,4481,32276,92847,1387215,1385450,7952,8.608,7021,7.6,178568,70296,108272,5.074,12.889,178148,42765,135383,3.087,12.858,420,0.03,25.717,3633,4085,13815
2014,4482,5313,24457,223661,216298,1513,6.206,1359,5.574,38266,12598,25668,5.824,17.691,24387,7724,16663,3.571,11.275,13879,6.417,22.549,475,507,1834
2014,4483,15399,22309,130236,130934,1406,6.258,1722,7.665,16086,5166,10920,3.946,12.286,17456,6401,11055,4.889,13.332,-1370,-1.046,24.571,1124,1149,3900
2014,4511,24576,35155,457201,450735,2860,8.109,3092,8.766,57447,21058,36389,4.672,12.745,45477,12973,32504,2.878,10.09,11970,2.656,20.179,2151,2232,7907
2014,4512,3486,7593,98900,94868,379,4.903,654,8.46,17063,2342,14721,2.469,17.986,8937,2877,6060,3.033,9.42,8126,8.566,18.841,362,362,1215
2014,4522,19,4934,571226,573118,26,0.521,138,2.766,23779,1966,21813,0.343,4.149,26308,7347,18961,1.282,4.59,-2529,-0.441,8.298,10,10,26
2014,4523,7108,44976,2267767,2244492,2939,6.651,1365,3.089,120298,24731,95567,1.102,5.36,70190,7921,62269,0.353,3.127,50108,2.232,6.254,954,988,2921
2014,4531,12170,12718,60574,61165,847,6.552,1266,9.793,8413,2367,6046,3.87,13.755,9534,3490,6044,5.706,15.587,-1121,-1.833,27.509,1032,1037,2894
2014,4532,17933,27788,238013,240175,2112,7.46,3158,11.155,29887,10643,19244,4.431,12.444,34639,10936,23703,4.553,14.422,-4752,-1.979,24.888,2020,2055,6604
2014,4533,12883,18687,193274,188939,1704,9.161,1533,8.241,27984,9376,18608,4.962,14.811,19184,5662,13522,2.997,10.154,8800,4.658,20.307,1172,1193,3204
2014,4539,29511,39306,254757,248389,5154,13.41,3411,8.875,41242,18669,22573,7.516,16.604,28260,10579,17681,4.259,11.377,12982,5.226,22.755,2593,2648,8224
2014,4541,26708,27867,416150,403082,4834,17.877,3182,11.767,72611,21138,51473,5.244,18.014,45795,15938,29857,3.954,11.361,26816,6.653,22.722,2509,2525,9868
2014,4542,3100,3528,39292,39892,327,9.121,441,12.301,5262,1157,4105,2.9,13.191,6431,3328,3103,8.343,16.121,-1169,-2.93,26.381,326,344,2099
2014,4543,20754,26021,174479,172523,2885,11.11,2780,10.705,27805,9449,18356,5.477,16.117,23826,10149,13677,5.883,13.81,3979,2.306,27.621,1628,1660,5556
2014,4811,415,2455,392485,388614,144,5.818,184,7.434,25967,3151,22816,0.811,6.682,18383,5399,12984,1.389,4.73,7584,1.952,9.461,40,40,416
2014,4812,1867,2060,35705,36491,216,10.392,253,12.172,4731,1827,2904,5.007,12.965,6077,1896,4181,5.196,16.654,-1346,-3.689,25.93,171,173,1309
2014,4831,625,952,47149,46755,140,15.094,91,9.811,6504,1717,4787,3.672,13.911,5704,1644,4060,3.516,12.2,800,1.711,24.4,47,47,284
2014,4832,419,482,21912,21575,49,10.082,57,11.728,2074,572,1502,2.651,9.613,1456,450,1006,2.086,6.749,618,2.864,13.497,35,35,153
2014,4841,49241,59020,928695,919729,9055,15.535,7587,13.017,109644,31977,77667,3.477,11.921,92330,36008,56322,3.915,10.039,17314,1.883,20.078,5579,5615,23754
2014,4842,37364,41175,478716,469772,4979,12.116,4815,11.717,80040,26124,53916,5.561,17.038,62080,22604,39476,4.812,13.215,17960,3.823,26.43,3269,3294,13529
2014,4851,494,771,51485,51428,71,9.103,89,11.41,5470,922,4548,1.793,10.636,5290,3723,1567,7.239,10.286,180,0.35,20.572,53,55,421
2014,4852,288,490,14067,14792,56,11.802,25,5.269,1196,358,838,2.42,8.086,2755,294,2461,1.988,18.626,-1559,-10.54,16.171,12,12,82
2014,4853,6785,6944,76308,75107,1147,16.868,859,12.632,11945,4715,7230,6.278,15.904,9607,4537,5070,6.041,12.791,2338,3.113,25.582,688,688,3080
2014,4854,2547,4042,220227,217873,267,6.582,296,7.297,40239,15673,24566,7.194,18.469,35581,7598,27983,3.487,16.331,4658,2.138,32.662,193,195,2907
2014,4855,1160,1277,33226,33312,115,8.998,117,9.155,3995,1057,2938,3.173,11.993,4167,1167,3000,3.503,12.509,-172,-0.516,23.985,91,92,674
2014,4859,3507,3970,84601,82969,569,14.447,506,12.848,13225,3866,9359,4.66,15.94,9917,4349,5568,5.242,11.953,3308,3.987,23.905,386,390,2724
2014,4861,62,747,12259,13566,96,13.061,72,9.796,2252,1006,1246,7.416,16.601,5048,3601,1447,26.545,37.212,-2796,-20.611,33.202,3,3,11
2014,4862,116,2559,34158,32896,482,19.827,226,9.297,7210,4778,2432,14.525,21.918,4625,1667,2958,5.068,14.06,2585,7.858,28.119,9,9,15
2014,4869,65,677,7008,6878,81,12.539,19,2.941,1168,609,559,8.854,16.982,915,181,734,2.632,13.303,253,3.678,26.607,3,4,34
2014,4871,498,545,10362,10041,91,17.383,48,9.169,1526,312,1214,3.107,15.198,892,348,544,3.466,8.884,634,6.314,17.767,33,34,255
2014,4872,1185,1228,12680,12553,158,12.908,150,12.255,1659,360,1299,2.868,13.216,1399,346,1053,2.756,11.145,260,2.071,22.29,98,98,239
2014,4879,165,183,2264,2170,22,12.36,12,6.742,317,91,226,4.194,14.608,141,37,104,1.705,6.498,176,8.111,12.995,8,8,33
2014,4881,3746,5509,176024,175922,465,8.415,499,9.03,20677,5418,15259,3.08,11.754,20385,7639,12746,4.342,11.588,292,0.166,23.175,259,269,1951
2014,4882,492,1397,36783,36062,131,9.52,89,6.468,5014,1876,3138,5.202,13.904,3644,996,2648,2.762,10.105,1370,3.799,20.21,26,26,280
2014,4883,1779,2324,98758,98353,183,7.898,169,7.294,9882,1239,8643,1.26,10.047,8982,1032,7950,1.049,9.132,900,0.915,18.265,85,87,315
2014,4884,8819,10178,91350,87884,1307,12.97,1105,10.966,18707,6190,12517,7.043,21.286,11707,4778,6929,5.437,13.321,7000,7.965,26.642,805,806,2914
2014,4885,13591,19019,237724,234626,1683,8.894,1490,7.874,34190,12398,21792,5.284,14.572,28247,8301,19946,3.538,12.039,5943,2.533,24.078,907,964,4439
2014,4889,1269,1396,15963,15819,198,14.39,158,11.483,3272,890,2382,5.626,20.685,2968,1088,1880,6.878,18.763,304,1.922,37.526,117,118,642
2014,4921,4077,8780,504257,496932,946,10.912,724,8.352,42424,12881,29543,2.592,8.537,28110,9630,18480,1.938,5.657,14314,2.88,11.313,428,430,1880
2014,4922,3689,4090,36646,35286,474,11.515,527,12.802,8322,2872,5450,8.139,23.585,5776,3070,2706,8.7,16.369,2546,7.215,32.739,426,426,2712
2014,4931,6985,14226,752974,737621,1158,8.226,859,6.102,93074,24672,68402,3.345,12.618,61547,16528,45019,2.241,8.344,31527,4.274,16.688,311,344,3183
2014,5111,11795,16807,430110,435642,986,5.777,1509,8.841,44575,18244,26331,4.188,10.232,56095,16978,39117,3.897,12.876,-11520,-2.644,20.464,792,805,4982
2014,5112,5877,8736,446645,437797,1117,13.115,679,7.972,59288,18423,40865,4.208,13.542,41033,12359,28674,2.823,9.373,18255,4.17,18.745,358,365,4661
2014,5121,13556,16780,340819,326796,2372,14.273,2049,12.33,65621,14635,50986,4.478,20.08,38106,10789,27317,3.301,11.661,27515,8.42,23.321,1296,1314,6655
2014,5122,2755,2963,28287,25478,351,11.729,410,13.701,8436,806,7630,3.164,33.111,3087,1528,1559,5.997,12.116,5349,20.995,24.233,233,241,1051
2014,5151,4008,8621,213398,217413,427,4.932,500,5.775,21999,7775,14224,3.576,10.119,30468,7999,22469,3.679,14.014,-8469,-3.895,20.237,225,253,2528
2014,5152,384,748,53407,54748,58,7.811,47,6.33,5675,1014,4661,1.852,10.366,8532,1239,7293,2.263,15.584,-2857,-5.218,20.731,19,19,111
2014,5173,4268,46249,989611,1000342,8886,20.062,4973,11.228,134799,72690,62109,7.267,13.475,156434,56751,99683,5.673,15.638,-21635,-2.163,26.951,331,355,2504
2014,5174,349,438,8320,8379,56,12.655,65,14.689,1460,400,1060,4.774,17.425,1524,815,709,9.727,18.188,-64,-0.764,34.849,40,40,226
2014,5179,3343,3946,55433,56211,651,16.592,606,15.445,11120,2856,8264,5.081,19.783,12543,4317,8226,7.68,22.314,-1423,-2.532,39.565,436,439,2329
2014,5182,8749,12984,534703,522286,1568,11.825,2120,15.988,119489,35517,83972,6.8,22.878,92092,32892,59200,6.298,17.632,27397,5.246,35.265,715,728,6006
2014,5191,8077,10189,247164,233788,1629,16.275,1270,12.688,57911,13993,43918,5.985,24.771,30178,7099,23079,3.037,12.908,27733,11.862,25.817,939,946,4063
2014,5211,12,58,18786,18644,(D),(D),0,0,523,(D),453,(D),2.805,211,0,211,0,1.132,312,1.674,2.264,0,0,0
2014,5221,12269,120280,1968701,1991275,3764,3.104,5702,4.703,154201,31878,122323,1.601,7.744,200487,48105,152382,2.416,10.068,-46286,-2.324,15.488,373,518,4330
2014,5222,13492,41261,564984,568616,5680,14.086,3807,9.441,99282,41087,58195,7.226,17.46,106900,34992,71908,6.154,18.8,-7618,-1.34,34.921,1122,1231,8937
2014,5223,11654,27263,258485,254565,2573,9.46,2442,8.979,42440,14671,27769,5.763,16.672,34787,9827,24960,3.86,13.665,7653,3.006,27.331,1227,1283,3818
2014,5231,11328,41637,398500,401353,4341,10.454,4117,9.915,51706,28561,23145,7.116,12.883,56947,13588,43359,3.386,14.189,-5241,-1.306,25.766,773,802,2774
2014,5232,13,32,6194,5967,(D),(D),(D),(D),669,(D),63,(D),11.212,270,(D),269,(D),4.525,399,6.687,9.05,(D),(D),(D)
2014,5239,41088,47595,482404,473083,6586,14.147,4505,9.677,77905,33079,44826,6.992,16.468,59596,22886,36710,4.838,12.597,18309,3.87,25.195,3171,3195,10890
2014,5241,4599,31391,1440084,1445484,4110,13.346,2918,9.476,194844,73948,120896,5.116,13.48,206865,69809,137056,4.829,14.311,-12021,-0.832,26.959,338,343,2449
2014,5242,118471,133017,931741,921742,11089,8.364,10210,7.701,128643,46793,81850,5.077,13.957,109225,38904,70321,4.221,11.85,19418,2.107,23.7,7060,7140,20659
2014,5259,646,669,6840,6319,159,24.036,144,21.769,2193,1758,435,27.823,34.708,1092,825,267,13.057,17.283,1101,17.425,34.565,125,125,719
2014,5311,86872,113538,563022,552707,11193,9.958,8921,7.937,92202,41796,50406,7.562,16.682,71501,30529,40972,5.524,12.937,20701,3.745,25.873,6420,6527,19742
2014,5312,62942,73658,273267,266068,11955,16.62,8504,11.822,55136,24965,30171,9.383,20.723,40516,18700,21816,7.028,15.228,14620,5.495,30.455,4780,4825,9821
2014,5313,63523,78424,649545,641391,9726,12.551,7867,10.152,96155,39660,56495,6.183,14.992,80089,34286,45803,5.346,12.487,16066,2.505,24.974,4619,4740,20075
2014,5321,3477,14457,146911,145093,2529,18.174,1446,10.391,35626,20235,15391,13.946,24.554,32359,15090,17269,10.4,22.302,3267,2.252,44.604,332,338,1278
2014,5322,7219,18575,144468,147356,1090,5.692,2241,11.702,22759,4902,17857,3.327,15.445,27243,15193,12050,10.31,18.488,-4484,-3.043,30.89,841,924,3930
2014,5323,2247,2703,17962,17597,170,6.252,202,7.429,2782,739,2043,4.2,15.81,2004,779,1225,4.427,11.388,778,4.421,22.777,139,143,506
2014,5324,7236,13577,182372,176268,1203,8.962,897,6.682,34620,9483,25137,5.38,19.641,21538,6334,15204,3.593,12.219,13082,7.422,24.438,547,567,3112
2014,5331,2034,2213,33041,34431,224,10.076,244,10.976,4370,966,3404,2.806,12.692,7294,3596,3698,10.444,21.184,-2924,-8.492,25.384,169,169,931
2014,5411,159210,170576,1147823,1154085,13517,7.921,13642,7.995,113244,36486,76758,3.161,9.812,126146,38965,87181,3.376,10.93,-12902,-1.118,19.625,9793,9866,28231
2014,5412,99224,118611,1283428,1250311,13786,11.82,9827,8.426,214891,62666,152225,5.012,17.187,149546,49046,100500,3.923,11.961,65345,5.226,23.921,6377,6602,30574
2014,5413,80056,97664,1428958,1423302,10499,10.885,8087,8.384,189092,54022,135070,3.796,13.285,176892,43493,133399,3.056,12.428,12200,0.857,24.857,4924,4998,19007
2014,5414,24804,25087,107671,105525,3531,14.182,3151,12.656,19661,7874,11787,7.462,18.632,15477,6950,8527,6.586,14.667,4184,3.965,29.333,2177,2178,4978
2014,5415,94966,113278,1621061,1606199,17288,15.343,16082,14.273,333834,121048,212786,7.536,20.784,299601,115795,183806,7.209,18.653,34233,2.131,37.306,10188,10241,38006
2014,5416,117518,127455,1140480,1107994,23232,18.567,18577,14.846,238658,99803,138855,9.008,21.54,173144,77757,95387,7.018,15.627,65514,5.913,31.254,13161,13212,40680
2014,5417,12323,15917,662362,644379,2219,14.163,1720,10.978,95167,33123,62044,5.14,14.769,60496,15817,44679,2.455,9.388,34671,5.381,18.777,1092,1101,5821
2014,5418,29372,32818,466030,461715,3594,10.957,3561,10.856,72643,24244,48399,5.251,15.733,64281,19329,44952,4.186,13.922,8362,1.811,27.844,2589,2650,13524
2014,5419,52105,58446,585163,581020,6211,10.454,8139,13.7,87185,33006,54179,5.681,15.006,79987,34197,45790,5.886,13.767,7198,1.239,27.533,3503,3558,17872
2014,5511,26231,52420,3255502,3253500,4219,8.058,4094,7.819,447916,134108,313808,4.122,13.767,438582,149159,289423,4.585,13.48,9334,0.287,26.961,693,722,11133
2014,5611,25131,27354,425920,414142,3306,12.146,3035,11.151,82287,28797,53490,6.953,19.869,58841,27032,31809,6.527,14.208,23446,5.661,28.416,2141,2169,18516
2014,5612,1802,5641,249300,249202,1152,21.447,613,11.412,37592,12295,25297,4.934,15.085,36744,15679,21065,6.292,14.745,848,0.34,29.489,85,86,1211
2014,5613,24098,45281,5288446,5135282,5143,11.436,4524,10.06,1179809,276080,903729,5.376,22.975,885076,275534,609542,5.366,17.235,294733,5.739,34.47,2200,2330,102314
2014,5614,23471,29967,765966,759558,2941,9.756,3301,10.95,115906,34399,81507,4.529,15.26,102201,35796,66405,4.713,13.455,13705,1.804,26.911,2370,2425,16725
2014,5615,12775,23429,230628,222777,4476,20.178,1983,8.939,37616,14738,22878,6.616,16.885,22777,8717,14060,3.913,10.224,14839,6.661,20.448,906,916,3165
2014,5616,17517,23421,894146,887810,2133,8.954,2933,12.313,141176,29074,112102,3.275,15.902,126986,52622,74364,5.927,14.303,14190,1.598,28.607,1460,1493,15149
2014,5617,141210,148203,1761448,1733475,20088,13.656,17890,12.161,283268,88171,195097,5.086,16.341,226343,78092,148251,4.505,13.057,56925,3.284,26.114,11748,11776,46000
2014,5619,15350,17158,267161,266000,1627,9.487,1612,9.399,38790,9802,28988,3.685,14.583,35890,10481,25409,3.94,13.492,2900,1.09,26.985,1068,1072,6285
2014,5621,7258,10509,196776,195413,786,7.489,759,7.232,21264,5456,15808,2.792,10.882,18365,6114,12251,3.129,9.398,2899,1.484,18.796,489,492,3371
2014,5622,1227,2502,52685,52638,200,8.089,141,5.703,4498,1109,3389,2.107,8.545,4498,763,3735,1.45,8.545,0,0,17.09,85,85,425
2014,5629,8048,9452,129255,129580,848,9.022,743,7.905,19880,5045,14835,3.893,15.342,20696,6643,14053,5.127,15.972,-816,-0.63,30.684,482,489,2426
2014,6111,18767,21595,970814,958116,981,4.543,979,4.534,80605,17142,63463,1.789,8.413,54859,15419,39440,1.609,5.726,25746,2.687,11.451,686,698,11373
2014,6112,472,1058,83000,84699,25,2.343,43,4.03,5158,290,4868,0.342,6.09,8368,996,7372,1.176,9.88,-3210,-3.79,12.18,14,17,223
2014,6113,2349,4568,1842161,1835193,268,5.877,253,5.548,109063,18803,90260,1.025,5.943,94561,8638,85923,0.471,5.153,14502,0.79,10.305,61,62,3187
2014,6114,6573,6940,59504,59293,704,10.055,827,11.812,8584,2630,5954,4.436,14.477,8125,2924,5201,4.931,13.703,459,0.774,27.406,529,529,1996
2014,6115,6012,7653,111982,111842,653,8.537,646,8.445,13657,4410,9247,3.943,12.211,13413,4385,9028,3.921,11.993,244,0.218,23.986,432,465,2849
2014,6116,38689,41473,387437,384416,5379,13.175,4088,10.013,69181,24694,44487,6.424,17.996,63318,23813,39505,6.195,16.471,5863,1.525,32.942,2912,2933,14866
2014,6117,5533,6376,105148,98710,1004,16.009,795,12.676,29052,18381,10671,18.621,29.432,15375,4690,10685,4.751,15.576,13677,13.856,31.152,533,534,2473
2014,6211,164221,203907,2304276,2276478,15790,7.744,15750,7.725,308020,117731,190289,5.172,13.531,251384,93447,157937,4.105,11.043,56636,2.488,22.085,11259,11627,59321
2014,6212,119607,128429,894931,886975,6715,5.242,6033,4.71,102713,33229,69484,3.746,11.58,86535,27649,58886,3.117,9.756,16178,1.824,19.512,4831,4890,22716
2014,6213,116077,132582,806414,791884,11447,8.695,9590,7.284,124622,41210,83412,5.204,15.737,94769,29701,65068,3.751,11.968,29853,3.77,23.935,6652,6743,19835
2014,6214,15635,36914,852670,832342,3441,9.501,2048,5.655,113415,45751,67664,5.497,13.626,72460,20731,51729,2.491,8.706,40955,4.92,17.411,923,1002,9931
2014,6215,7041,12755,250697,249661,1170,9.197,1103,8.67,29135,8546,20589,3.423,11.67,27247,8500,18747,3.405,10.914,1888,0.756,21.827,627,645,4206
2014,6216,19540,28086,1298432,1283221,3178,11.368,2919,10.441,191288,47864,143424,3.73,14.907,160107,48940,111167,3.814,12.477,31181,2.43,24.954,1914,1944,24644
2014,6219,6155,9547,291125,290303,780,8.117,904,9.408,37596,11180,26416,3.851,12.951,35871,12074,23797,4.159,12.356,1725,0.594,24.713,443,501,5960
2014,6221,2706,5061,5127947,5139572,129,2.557,96,1.903,170702,37634,133068,0.732,3.321,193311,29783,163528,0.579,3.761,-22609,-0.44,6.643,51,53,14344
2014,6222,433,635,230265,229630,46,7.461,9,1.46,5605,1655,3950,0.721,2.441,4348,1210,3138,0.527,1.893,1257,0.547,3.787,7,7,661
2014,6223,413,973,282315,280560,69,7.161,50,5.189,16140,3692,12448,1.316,5.753,12544,4447,8097,1.585,4.471,3596,1.282,8.942,18,18,1670
2014,6231,8275,16189,1673083,1676204,899,5.574,779,4.83,126098,51449,74649,3.069,7.523,131607,51784,79823,3.089,7.851,-5509,-0.329,15.046,455,488,34081
2014,6232,9465,39080,744626,724221,4240,11.247,1480,3.926,117870,45060,72810,6.222,16.275,76760,14869,61891,2.053,10.599,41110,5.676,21.198,343,454,6090
2014,6233,15814,22338,871865,858043,1919,8.678,1471,6.652,92462,31484,60978,3.669,10.776,65510,24732,40778,2.882,7.635,26952,3.141,15.27,1043,1061,15545
2014,6239,2951,4950,130837,134112,354,7.044,505,10.049,13673,3172,10501,2.365,10.195,20794,9836,10958,7.334,15.505,-7121,-5.31,20.39,184,201,2172
2014,6241,52627,69417,1550988,1519127,9963,14.877,5063,7.56,212535,64597,147938,4.252,13.991,148611,38336,110275,2.524,9.783,63924,4.208,19.565,3273,3378,20795
2014,6242,9949,13943,180533,177288,612,4.393,588,4.221,20982,4977,16005,2.807,11.835,14442,3633,10809,2.049,8.146,6540,3.689,16.292,285,315,1614
2014,6243,3968,7514,330702,330873,402,5.352,397,5.285,35458,8066,27392,2.438,10.717,35756,7875,27881,2.38,10.807,-298,-0.09,21.433,147,160,2371
2014,6244,54904,69847,871444,868324,6148,8.783,6451,9.216,107849,39226,68623,4.517,12.42,101528,37569,63959,4.327,11.692,6321,0.728,23.385,4625,4775,27681
2014,7111,6969,7107,120875,119871,819,11.543,795,11.205,19764,5508,14256,4.595,16.488,17792,4737,13055,3.952,14.843,1972,1.645,29.685,533,533,3311
2014,7112,3205,3376,126968,125600,427,12.637,433,12.814,14463,3311,11152,2.636,11.515,11675,2817,8858,2.243,9.295,2788,2.22,18.591,327,328,2316
2014,7113,5849,6207,158578,154001,765,12.494,597,9.75,23883,5153,18730,3.346,15.508,14710,5551,9159,3.605,9.552,9173,5.956,19.104,423,426,2406
2014,7114,2930,3040,19925,18973,445,14.747,400,13.256,4883,2038,2845,10.742,25.737,3045,1209,1836,6.372,16.049,1838,9.687,32.098,289,291,894
2014,7115,14663,14703,45927,44113,2794,19.35,2267,15.7,12995,6702,6293,15.193,29.459,9338,4714,4624,10.686,21.169,3657,8.29,42.337,1393,1393,2984
2014,7121,6525,6995,142617,141060,312,4.469,285,4.082,11100,1293,9807,0.917,7.869,8038,1267,6771,0.898,5.698,3062,2.171,11.397,178,178,725
2014,7131,2320,2663,183226,177532,335,12.46,386,14.357,25883,5216,20667,2.938,14.579,13975,3900,10075,2.197,7.872,11908,6.708,15.744,324,327,3201
2014,7132,1752,2738,156137,153341,221,7.987,279,10.083,19077,9230,9847,6.019,12.441,13461,6401,7060,4.174,8.778,5616,3.662,17.557,212,217,5518
2014,7139,49707,57388,1213689,1199487,6521,11.489,5261,9.269,159771,64572,95199,5.383,13.32,130490,42818,87672,3.57,10.879,29281,2.441,21.758,3928,3997,31111
2014,7211,39828,50760,1947714,1934346,4372,8.662,3799,7.527,208832,84655,124177,4.376,10.796,180335,73245,107090,3.787,9.323,28497,1.473,18.646,2594,2685,42106
2014,7212,5260,5846,41984,41743,393,6.697,438,7.464,5836,1403,4433,3.361,13.981,5351,1457,3894,3.49,12.819,485,1.162,25.638,263,263,828
2014,7213,1834,1984,13242,12355,101,5.055,129,6.456,3420,1914,1506,15.492,27.682,1515,636,879,5.148,12.263,1905,15.419,24.525,84,85,198
2014,7223,13408,37025,721763,712423,4445,11.905,5071,13.581,132324,41439,90885,5.817,18.574,112777,45960,66817,6.451,15.83,19547,2.744,31.66,1670,1686,10043
2014,7224,36897,37806,359078,357214,3624,9.48,4465,11.68,63690,29239,34451,8.185,17.83,60250,25917,34333,7.255,16.867,3440,0.963,33.733,3767,3770,21989
2014,7225,354313,487103,9700741,9537752,52408,10.851,44138,9.139,1477506,706241,771265,7.405,15.491,1152374,428244,724130,4.49,12.082,325132,3.409,24.164,35454,36455,322690
2014,8111,133798,146953,848033,837038,12066,8.218,11793,8.032,126727,47694,79033,5.698,15.14,104761,40606,64155,4.851,12.516,21966,2.624,25.031,8724,8831,30514
2014,8112,9631,10917,97709,97776,1098,10.013,1195,10.898,12538,3494,9044,3.573,12.823,12806,4352,8454,4.451,13.097,-268,-0.274,25.647,900,904,2600
2014,8113,18039,20008,208130,206545,1754,8.808,1564,7.854,28313,10677,17636,5.169,13.708,25237,6865,18372,3.324,12.219,3076,1.489,24.437,1105,1114,4334
2014,8114,17072,17803,67997,66817,2064,11.658,1867,10.545,12000,5278,6722,7.899,17.96,9665,4584,5081,6.861,14.465,2335,3.495,28.93,1365,1365,3405
2014,8121,93192,110114,657713,656008,13934,12.783,11706,10.739,112972,57806,55166,8.812,17.221,109401,41621,67780,6.345,16.677,3571,0.544,33.354,9154,9252,32531
2014,8122,14216,20039,138782,136993,1043,5.261,614,3.097,13675,5538,8137,4.043,9.982,10081,2368,7713,1.729,7.359,3594,2.624,14.718,405,407,1633
2014,8123,27951,33319,292152,292055,2630,7.874,2795,8.368,37038,18863,18175,6.459,12.682,36323,13210,23113,4.523,12.437,715,0.245,24.874,2148,2190,9100
2014,8129,26096,36702,284424,273263,5699,16.063,3251,9.163,64070,32702,31368,11.967,23.446,41742,17428,24314,6.378,15.275,22328,8.171,30.551,2242,2336,8592
2014,8131,177253,177584,1676738,1679867,7640,4.305,7394,4.167,135233,21897,113336,1.303,8.05,141120,21851,119269,1.301,8.401,-5887,-0.35,16.1,4792,4792,13980
2014,8132,16219,18230,181784,179640,1248,6.888,1024,5.652,18986,3688,15298,2.053,10.569,14661,3796,10865,2.113,8.161,4325,2.408,16.323,718,726,1992
2014,8133,13771,16244,160517,157397,1185,7.331,1026,6.347,20851,4732,16119,3.006,13.247,14606,3676,10930,2.336,9.28,6245,3.968,18.559,667,669,2298
2014,8134,22663,24545,231573,231004,1236,5.028,1315,5.349,23464,4341,19123,1.879,10.157,22338,5218,17120,2.259,9.67,1126,0.487,19.34,905,913,3674
2014,8139,54403,56580,490016,488662,2629,4.645,2666,4.71,46031,9437,36594,1.931,9.42,43220,10088,33132,2.064,8.845,2811,0.575,17.689,1836,1840,7274
2015,1131,373,418,4000,3504,40,9.685,30,7.264,1471,215,1256,6.137,41.987,546,169,377,4.824,15.584,925,26.402,31.169,20,20,37
2015,1132,129,145,1331,1376,22,15.827,10,7.194,165,51,114,3.706,11.991,270,24,246,1.744,19.622,-105,-7.631,23.983,6,6,16
2015,1133,7125,7211,51083,50293,739,10.342,608,8.509,7988,2272,5716,4.518,15.883,6436,1757,4679,3.494,12.797,1552,3.086,25.594,439,439,1348
2015,1141,1238,1250,5969,5947,225,18.3,184,14.965,936,396,540,6.659,15.739,888,380,508,6.39,14.932,48,0.807,29.864,105,105,229
2015,1142,285,288,1583,1528,34,12.057,22,7.801,277,165,112,10.802,18.134,168,78,90,5.106,10.998,109,7.136,21.997,15,15,59
2015,1151,3587,3912,64270,63931,428,11.088,324,8.394,9613,2973,6640,4.65,15.037,8839,2741,6098,4.287,13.826,774,1.211,27.652,227,229,2366
2015,1152,3761,3858,19390,19198,518,13.635,400,10.529,3137,1377,1760,7.173,16.341,2712,1157,1555,6.027,14.127,425,2.214,28.254,282,282,917
2015,1153,1262,1336,11553,10963,163,12.325,136,10.284,2565,817,1748,7.452,23.397,1448,398,1050,3.63,13.208,1117,10.189,26.416,87,87,273
2015,2111,5682,7148,134258,134389,549,7.557,782,10.765,21674,7955,13719,5.919,16.128,22301,9932,12369,7.39,16.594,-627,-0.467,32.256,457,460,3959
2015,2121,439,827,69590,72733,66,7.843,95,11.289,9383,3361,6022,4.621,12.901,15671,5972,9699,8.211,21.546,-6288,-8.645,25.801,46,46,1332
2015,2122,213,284,40264,41375,20,6.579,60,19.737,2187,597,1590,1.443,5.286,4491,1099,3392,2.656,10.854,-2304,-5.569,10.572,50,50,1011
2015,2123,2672,4801,81020,79788,332,6.926,317,6.613,11197,3509,7688,4.398,14.033,8941,2323,6618,2.911,11.206,2256,2.827,22.412,162,162,826
2015,2131,10929,13814,418285,422836,1824,13.348,1525,11.16,64252,24833,39419,5.873,15.195,73541,16493,57048,3.901,17.392,-9289,-2.197,30.391,1095,1108,7897
2015,2211,1699,10465,511762,510039,634,6.067,603,5.771,36633,7858,28775,1.541,7.182,33336,6220,27116,1.22,6.536,3297,0.646,13.072,85,86,487
2015,2212,421,2498,86761,86297,109,4.354,120,4.793,8567,2840,5727,3.291,9.927,7619,2142,5477,2.482,8.829,948,1.099,17.658,25,25,132
2015,2213,3478,4565,42679,42433,177,3.86,217,4.733,3512,971,2541,2.288,8.277,2962,1111,1851,2.618,6.98,550,1.296,13.961,114,114,400
2015,2361,130386,131757,640688,617082,23789,18.433,18395,14.253,157571,63835,93736,10.345,25.535,110068,50492,59576,8.182,17.837,47503,7.698,35.674,12005,12014,34231
2015,2362,35520,36938,602955,590505,3589,9.727,3511,9.515,106515,21859,84656,3.702,18.038,81722,18400,63322,3.116,13.839,24793,4.199,27.679,2438,2442,12670
2015,2371,16100,17699,559043,550759,1492,8.416,1551,8.749,111517,29178,82339,5.298,20.248,96259,19764,76495,3.589,17.478,15258,2.77,34.955,942,943,6887
2015,2372,4374,4451,24820,24306,453,10.131,494,11.048,4511,1490,3021,6.13,18.559,3442,1623,1819,6.677,14.161,1069,4.398,28.322,379,379,1170
2015,2373,7941,8743,262191,260989,611,6.975,644,7.352,37221,6387,30834,2.447,14.262,34367,5398,28969,2.068,13.168,2854,1.094,26.336,418,419,3249
2015,2379,3589,3717,84867,82609,416,11.315,335,9.112,15197,2685,12512,3.25,18.396,11000,3239,7761,3.921,13.316,4197,5.081,26.631,205,205,1971
2015,2381,71446,72276,757568,733799,9946,13.956,7926,11.122,166203,41801,124402,5.697,22.65,118404,33831,84573,4.61,16.136,47799,6.514,32.272,4992,4997,23455
2015,2382,154250,158656,1824878,1781068,15422,9.799,12864,8.174,301929,67691,234238,3.801,16.952,214819,57758,157061,3.243,12.061,87110,4.891,24.122,8907,8927,37675
2015,2383,90232,91323,705803,685094,12566,13.94,10209,11.325,146695,41638,105057,6.078,21.412,105230,32840,72390,4.794,15.36,41465,6.052,30.72,6774,6778,22985
2015,2389,53523,54262,546558,530428,7072,13.247,5316,9.958,104802,25978,78824,4.898,19.758,72447,20686,51761,3.9,13.658,32355,6.1,27.316,3329,3332,12946
2015,3111,1088,1693,54983,50898,121,7.278,60,3.609,12136,8099,4037,15.912,23.844,4366,871,3495,1.711,8.578,7770,15.266,17.156,42,43,420
2015,3112,470,817,57520,56831,42,5.138,43,5.26,4055,395,3660,0.695,7.135,2635,426,2209,0.75,4.637,1420,2.499,9.273,30,30,189
2015,3113,1646,1821,76178,75033,145,8.02,119,6.582,8016,1236,6780,1.647,10.683,5698,1380,4318,1.839,7.594,2318,3.089,15.188,89,90,497
2015,3114,1369,1727,156200,157014,136,7.935,110,6.418,12756,1748,11008,1.113,8.124,14324,4662,9662,2.969,9.123,-1568,-0.999,16.248,73,76,1776
2015,3115,1085,1582,141417,139630,112,7.1,103,6.529,12424,2231,10193,1.598,8.898,8619,2440,6179,1.747,6.173,3805,2.725,12.346,67,67,451
2015,3116,2768,3376,484676,477095,178,5.261,193,5.704,39610,4857,34753,1.018,8.302,24033,4442,19591,0.931,5.037,15577,3.265,10.075,139,139,1818
2015,3117,435,526,30815,31303,39,7.31,54,10.122,2006,582,1424,1.859,6.408,2890,972,1918,3.105,9.232,-884,-2.824,12.817,38,38,468
2015,3118,9402,10152,286353,283481,904,8.919,872,8.603,28943,8145,20798,2.873,10.21,23065,7130,15935,2.515,8.136,5878,2.074,16.273,706,710,4704
2015,3119,2904,3365,192168,187011,383,11.675,214,6.523,21772,3887,17885,2.078,11.642,11228,3170,8058,1.695,6.004,10544,5.638,12.008,149,150,1330
2015,3121,5833,6460,167934,161617,1141,18.813,351,5.787,23370,6221,17149,3.849,14.46,10620,3778,6842,2.338,6.571,12750,7.889,13.142,257,261,2615
2015,3122,127,149,14077,14373,35,25.271,14,10.108,665,207,458,1.44,4.627,1233,157,1076,1.092,8.579,-568,-3.952,9.254,10,10,119
2015,3131,243,305,25091,24944,20,6.579,18,5.921,1457,624,833,2.502,5.841,1169,255,914,1.022,4.686,288,1.155,9.373,11,11,75
2015,3132,794,876,50143,50725,39,4.402,59,6.659,3699,681,3018,1.343,7.292,4968,1120,3848,2.208,9.794,-1269,-2.502,14.585,49,49,383
2015,3133,858,904,28399,28598,43,4.649,85,9.189,2088,386,1702,1.35,7.301,2452,527,1925,1.843,8.574,-364,-1.273,14.602,69,69,368
2015,3141,1591,1708,54008,53896,98,5.686,129,7.485,5133,2714,2419,5.036,9.524,4853,923,3930,1.713,9.004,280,0.52,18.009,106,106,495
2015,3149,3824,3929,59907,59669,314,7.995,311,7.919,6151,1488,4663,2.494,10.309,5636,1601,4035,2.683,9.445,515,0.863,18.891,233,233,961
2015,3151,217,227,12451,12166,19,8.389,18,7.947,1211,297,914,2.441,9.954,647,110,537,0.904,5.318,564,4.636,10.636,15,15,35
2015,3152,4953,4999,83170,84195,910,18.312,851,17.124,14346,7588,6758,9.012,17.039,16357,8582,7775,10.193,19.428,-2011,-2.389,34.078,750,751,7702
2015,3159,537,542,7827,8045,71,13.396,47,8.868,714,212,502,2.635,8.875,1133,297,836,3.692,14.083,-419,-5.208,17.75,39,39,284
2015,3161,165,175,3656,3519,11,6.25,13,7.386,446,83,363,2.359,12.676,178,26,152,0.739,5.059,268,7.617,10.118,12,12,25
2015,3162,189,206,11835,11639,26,12.411,33,15.752,1382,454,928,3.901,11.874,1009,457,552,3.927,8.67,373,3.205,17.339,25,26,435
2015,3169,680,685,10780,10527,86,12.865,53,7.928,1625,662,963,6.289,15.437,1105,420,685,3.99,10.497,520,4.94,20.995,47,47,410
2015,3211,2604,3021,84493,82696,216,7.199,175,5.832,8927,2287,6640,2.766,10.795,5295,1607,3688,1.943,6.403,3632,4.392,12.806,128,129,1000
2015,3212,1043,1356,70172,69285,61,4.485,69,5.074,7312,1356,5956,1.957,10.554,5598,1853,3745,2.674,8.08,1714,2.474,16.159,44,44,762
2015,3219,7741,8718,225415,220755,772,8.951,586,6.794,27203,6218,20985,2.817,12.323,17857,6074,11783,2.751,8.089,9346,4.234,16.178,434,437,3954
2015,3221,222,441,105545,106480,17,3.842,20,4.52,4760,855,3905,0.803,4.47,6707,1367,5340,1.284,6.299,-1947,-1.829,8.941,13,13,383
2015,3222,2414,3685,245105,244696,115,3.098,169,4.553,17774,4506,13268,1.841,7.264,17004,5401,11603,2.207,6.949,770,0.315,13.898,100,103,2891
2015,3231,23092,24362,452438,455699,1298,5.262,1907,7.731,38051,8700,29351,1.909,8.35,44476,14065,30411,3.086,9.76,-6425,-1.41,16.7,1532,1536,9438
2015,3241,915,2061,102306,101999,113,5.435,149,7.167,6012,1550,4462,1.52,5.894,5434,1217,4217,1.193,5.328,578,0.567,10.655,39,40,355
2015,3251,1279,2360,158601,158106,81,3.426,90,3.806,10359,2041,8318,1.291,6.552,9261,1566,7695,0.99,5.857,1098,0.694,11.715,50,51,661
2015,3252,1039,1367,94395,95055,36,2.615,55,3.996,6274,716,5558,0.753,6.6,7618,1439,6179,1.514,8.014,-1344,-1.414,13.201,30,30,384
2015,3253,641,891,28740,28645,72,8.191,48,5.461,2868,723,2145,2.524,10.012,2615,488,2127,1.704,9.129,253,0.883,18.258,22,25,273
2015,3254,1629,2141,241852,238312,217,10.338,133,6.336,32183,15276,16907,6.41,13.505,25034,6581,18453,2.762,10.505,7149,3,21.009,90,92,1996
2015,3255,1291,1641,59058,58240,97,5.958,71,4.361,6507,1212,5295,2.081,11.173,4742,1764,2978,3.029,8.142,1765,3.031,16.284,38,38,292
2015,3256,1841,2036,96139,95936,134,6.554,151,7.386,7873,1402,6471,1.461,8.207,7581,3051,4530,3.18,7.902,292,0.304,15.804,106,106,812
2015,3259,1690,2166,78886,78681,139,6.404,148,6.819,7376,2288,5088,2.908,9.375,6919,2371,4548,3.013,8.794,457,0.581,17.587,96,100,1043
2015,3261,7869,10161,608856,599770,411,4.035,459,4.507,56742,9649,47093,1.609,9.461,38374,10267,28107,1.712,6.398,18368,3.063,12.796,328,331,5319
2015,3262,1392,1812,131202,129852,53,2.901,83,4.543,8627,811,7816,0.625,6.644,5898,1143,4755,0.88,4.542,2729,2.102,9.084,56,56,458
2015,3271,876,1052,33801,33447,58,5.456,80,7.526,2889,616,2273,1.842,8.638,2213,599,1614,1.791,6.616,676,2.021,13.233,54,55,419
2015,3272,1360,1613,86410,85653,115,7.079,138,8.495,7166,1439,5727,1.68,8.366,5647,2124,3523,2.48,6.593,1519,1.773,13.186,92,93,676
2015,3273,3916,8261,161707,158383,498,6.058,417,5.073,22765,5391,17374,3.404,14.373,16214,4601,11613,2.905,10.237,6551,4.136,20.474,191,193,2366
2015,3274,159,288,13174,13088,14,4.895,10,3.497,895,95,800,0.726,6.838,730,63,667,0.481,5.578,165,1.261,11.155,8,8,60
2015,3279,2515,2966,74878,73676,196,6.605,199,6.706,8157,1311,6846,1.779,11.072,5762,1654,4108,2.245,7.821,2395,3.251,15.642,124,124,838
2015,3311,309,468,102672,101911,27,5.732,33,7.006,5362,771,4591,0.757,5.261,3914,551,3363,0.541,3.841,1448,1.421,7.681,18,18,183
2015,3312,511,632,48915,48888,32,5.063,32,5.063,4478,345,4133,0.706,9.16,4404,800,3604,1.636,9.008,74,0.151,18.017,20,20,334
2015,3313,378,507,57839,56533,16,3.113,30,5.837,5052,386,4666,0.683,8.936,2578,1057,1521,1.87,4.56,2474,4.376,9.12,22,22,391
2015,3314,752,942,60969,61237,43,4.541,53,5.597,3542,236,3306,0.385,5.784,4070,1325,2745,2.164,6.646,-528,-0.862,11.568,37,37,262
2015,3315,1513,1723,127069,126161,72,4.173,77,4.462,10004,1778,8226,1.409,7.93,8263,2212,6051,1.753,6.55,1741,1.38,13.099,56,56,1314
2015,3321,2145,2392,116759,115866,60,2.492,91,3.78,10035,2045,7990,1.765,8.661,8158,1297,6861,1.119,7.041,1877,1.62,14.082,66,66,831
2015,3322,1054,1128,35817,35552,61,5.415,58,5.149,2663,402,2261,1.131,7.491,2101,838,1263,2.357,5.91,562,1.581,11.819,41,42,466
2015,3323,10736,11691,342547,337339,615,5.249,664,5.668,37899,7288,30611,2.16,11.235,27379,7516,19863,2.228,8.116,10520,3.119,16.232,481,483,4306
2015,3324,1205,1531,92884,91903,88,5.789,66,4.342,8529,1339,7190,1.457,9.28,6574,2213,4361,2.408,7.153,1955,2.127,14.306,42,42,514
2015,3325,513,559,27762,26992,35,6.228,41,7.295,3207,864,2343,3.201,11.881,1663,545,1118,2.019,6.161,1544,5.72,12.322,24,24,157
2015,3326,1016,1154,38943,38814,28,2.388,65,5.544,3140,730,2410,1.881,8.09,2837,766,2071,1.974,7.309,303,0.781,14.619,50,50,243
2015,3327,21462,22008,390811,390148,961,4.341,1219,5.507,34696,7199,27497,1.845,8.893,33343,10773,22570,2.761,8.546,1353,0.347,17.092,962,963,7652
2015,3328,4949,5514,130081,129366,248,4.479,294,5.31,12469,3126,9343,2.416,9.639,11109,3118,7991,2.41,8.587,1360,1.051,17.175,221,221,1933
2015,3329,5659,6201,269407,267343,403,6.52,363,5.873,23812,4395,19417,1.644,8.907,19657,4053,15604,1.516,7.353,4155,1.554,14.705,272,272,2678
2015,3331,2560,2977,215725,216611,150,5.037,152,5.104,18944,3636,15308,1.679,8.746,20539,2963,17576,1.368,9.482,-1595,-0.736,17.491,111,111,1679
2015,3332,2937,3098,105685,103801,164,5.278,183,5.889,11111,2276,8835,2.193,10.704,7426,2192,5234,2.112,7.154,3685,3.55,14.308,138,138,1587
2015,3333,1788,1915,76920,76268,115,5.983,129,6.712,6750,1450,5300,1.901,8.85,5466,977,4489,1.281,7.167,1284,1.684,14.334,99,99,514
2015,3334,1425,1701,128872,128037,73,4.253,104,6.059,10167,1419,8748,1.108,7.941,8396,1939,6457,1.514,6.557,1771,1.383,13.115,78,78,1310
2015,3335,6042,6273,148451,147001,206,3.264,283,4.484,12433,2143,10290,1.458,8.458,9501,2852,6649,1.94,6.463,2932,1.995,12.926,225,225,1517
2015,3336,808,1029,103569,103500,34,3.282,48,4.633,8383,1001,7382,0.967,8.1,8477,1364,7113,1.318,8.19,-94,-0.091,16.199,38,38,549
2015,3339,5185,5854,300333,297649,233,3.98,235,4.014,24065,3499,20566,1.176,8.085,18517,3070,15447,1.031,6.221,5548,1.864,12.442,165,165,1428
2015,3341,944,984,42169,42650,96,9.776,92,9.369,4273,815,3458,1.911,10.019,5297,2712,2585,6.359,12.42,-1024,-2.401,20.038,67,67,916
2015,3342,1164,1282,91169,91029,75,5.787,103,7.948,7571,905,6666,0.994,8.317,7471,3189,4282,3.503,8.207,100,0.11,16.415,75,76,1205
2015,3343,426,438,9306,9093,44,10.023,46,10.478,1167,285,882,3.134,12.835,751,271,480,2.98,8.26,416,4.575,16.519,37,37,222
2015,3344,3352,3792,257904,259763,182,4.751,259,6.762,20657,2579,18078,0.993,7.952,25118,12129,12989,4.669,9.67,-4461,-1.717,15.904,182,185,2919
2015,3345,4313,4976,383336,386537,272,5.448,305,6.109,28186,7153,21033,1.851,7.292,34660,8184,26476,2.117,8.967,-6474,-1.675,14.584,199,199,2718
2015,3346,438,447,9776,10759,34,7.456,52,11.404,866,298,568,2.77,8.049,2740,421,2319,3.913,25.468,-1874,-17.419,16.099,42,42,366
2015,3351,974,1036,42978,42525,80,7.711,83,8,4522,909,3613,2.138,10.634,3532,1687,1845,3.967,8.306,990,2.328,16.612,56,56,577
2015,3352,239,282,47504,47288,30,10.909,16,5.818,3975,880,3095,1.861,8.406,3485,264,3221,0.558,7.37,490,1.036,14.74,11,11,48
2015,3353,1763,2033,120896,120101,89,4.339,125,6.095,9657,994,8663,0.828,8.041,8104,2358,5746,1.963,6.748,1553,1.293,13.495,91,92,1199
2015,3359,1780,2054,134249,132275,129,6.299,117,5.713,11865,1731,10134,1.309,8.97,7871,2278,5593,1.722,5.95,3994,3.019,11.901,82,82,787
2015,3361,272,324,187191,179238,28,8.682,25,7.752,19927,2738,17189,1.528,11.118,4463,310,4153,0.173,2.49,15464,8.628,4.98,21,21,80
2015,3362,1552,1835,137753,132674,138,7.591,104,5.721,17487,3294,14193,2.483,13.18,7319,2082,5237,1.569,5.517,10168,7.664,11.033,78,79,1266
2015,3363,3995,4939,541144,527206,268,5.447,230,4.675,61908,11690,50218,2.217,11.743,34088,8158,25930,1.547,6.466,27820,5.277,12.932,156,157,2965
2015,3364,1289,1725,367106,371579,118,6.886,95,5.544,26518,2985,23533,0.803,7.137,34355,10178,24177,2.739,9.246,-7837,-2.109,14.273,52,52,635
2015,3365,155,237,32901,31611,8,3.368,9,3.789,4097,220,3877,0.696,12.961,1426,134,1292,0.424,4.511,2671,8.45,9.022,5,5,41
2015,3366,1289,1418,143408,141584,113,8.014,97,6.879,13997,2170,11827,1.533,9.886,10260,1257,9003,0.888,7.247,3737,2.639,14.493,78,78,592
2015,3369,782,806,31319,31337,74,9.108,87,10.708,2617,243,2374,0.775,8.351,2581,636,1945,2.03,8.236,36,0.115,16.473,64,64,242
2015,3371,9858,10124,218895,217380,690,6.747,897,8.77,22371,4602,17769,2.117,10.291,19624,6155,13469,2.831,9.028,2747,1.264,18.055,668,671,4176
2015,3372,3294,3451,110215,109406,167,4.804,217,6.243,10089,1644,8445,1.503,9.222,8535,2439,6096,2.229,7.801,1554,1.42,15.603,158,159,1493
2015,3379,634,725,31143,31417,44,6.015,57,7.792,3471,879,2592,2.798,11.048,4000,1581,2419,5.032,12.732,-529,-1.684,22.097,43,48,1262
2015,3391,9220,10178,277014,277336,640,6.223,852,8.285,27080,7911,19169,2.852,9.764,28301,7378,20923,2.66,10.205,-1221,-0.44,19.529,661,667,3369
2015,3399,14774,15148,262937,260461,1590,10.641,1179,7.89,29591,9337,20254,3.585,11.361,24447,6921,17526,2.657,9.386,5144,1.975,18.772,911,918,5024
2015,4231,15492,23151,393378,386450,1439,6.185,1666,7.161,46568,10889,35679,2.818,12.05,32675,12840,19835,3.323,8.455,13893,3.595,16.91,1128,1172,7521
2015,4232,9798,11611,151425,149965,881,7.572,929,7.985,17366,4347,13019,2.899,11.58,14279,5271,9008,3.515,9.522,3087,2.058,19.043,668,689,3764
2015,4233,9442,16023,214533,210381,1034,6.447,1063,6.628,29275,6821,22454,3.242,13.915,21029,8158,12871,3.878,9.996,8246,3.92,19.991,578,605,3604
2015,4234,21341,32045,641594,645152,2635,8.054,3982,12.17,72746,23306,49440,3.612,11.276,78281,33258,45023,5.155,12.134,-5535,-0.858,22.552,1516,1551,9956
2015,4235,7045,9699,157142,155511,425,4.343,600,6.131,16398,3126,13272,2.01,10.545,13175,4253,8922,2.735,8.472,3223,2.073,16.944,383,394,2024
2015,4236,18166,27994,549819,538701,2092,7.48,2041,7.297,81921,21507,60414,3.992,15.207,58184,18057,40127,3.352,10.801,23737,4.406,21.602,1197,1234,7148
2015,4237,10002,18755,235339,232273,777,4.137,834,4.44,23601,4664,18937,2.008,10.161,17621,5104,12517,2.197,7.586,5980,2.575,15.173,429,443,2088
2015,4238,38501,56137,770085,761609,2985,5.317,2998,5.34,82114,19324,62790,2.537,10.782,65368,19763,45605,2.595,8.583,16746,2.199,17.166,1883,1949,9599
2015,4239,27711,31085,332296,335343,2790,8.934,3079,9.859,38196,10790,27406,3.218,11.39,44365,15222,29143,4.539,13.23,-6169,-1.84,22.78,2302,2346,10471
2015,4241,7250,9565,146638,147296,595,6.2,660,6.877,13663,5291,8372,3.592,9.276,14740,3641,11099,2.472,10.007,-1077,-0.731,18.552,447,458,2289
2015,4242,6165,9539,300580,298390,882,9.327,717,7.582,40042,9766,30276,3.273,13.419,36043,6753,29290,2.263,12.079,3999,1.34,24.158,497,498,3349
2015,4243,13450,14620,200874,200347,1449,9.885,1527,10.417,25371,6556,18815,3.272,12.664,24393,9052,15341,4.518,12.175,978,0.488,24.351,1246,1252,6762
2015,4244,24784,32425,808020,801771,3391,10.562,2752,8.572,87730,31132,56598,3.883,10.942,75216,36142,39074,4.508,9.381,12514,1.561,18.762,1831,1853,11640
2015,4245,3280,6111,63902,63078,344,5.649,302,4.959,7176,1997,5179,3.166,11.376,5561,1486,4075,2.356,8.816,1615,2.56,17.632,153,157,773
2015,4246,7876,12170,157814,157465,634,5.165,842,6.86,17829,4904,12925,3.114,11.323,17420,6567,10853,4.17,11.063,409,0.26,22.126,437,466,2471
2015,4247,4063,6352,101587,101717,307,4.797,404,6.312,12809,3229,9580,3.175,12.593,13001,5397,7604,5.306,12.782,-192,-0.189,25.186,203,214,1545
2015,4248,3230,4173,198694,196022,303,7.253,312,7.469,16407,4258,12149,2.172,8.37,11005,3463,7542,1.767,5.614,5402,2.756,11.228,245,250,2331
2015,4249,20297,26889,339350,336145,2330,8.687,2195,8.184,42332,12411,29921,3.692,12.593,35785,12787,22998,3.804,10.646,6547,1.948,21.291,1575,1633,7290
2015,4251,34669,37069,293085,289036,3979,10.707,4169,11.218,44442,17298,27144,5.985,15.376,36023,14401,21622,4.982,12.463,8419,2.913,24.926,3160,3185,8421
2015,4411,37565,43425,1243730,1217146,3658,8.464,3240,7.497,138332,45728,92604,3.757,11.365,84982,30846,54136,2.534,6.982,53350,4.383,13.964,2573,2603,24340
2015,4412,11243,12871,138525,136038,852,6.615,869,6.747,17169,4890,12279,3.595,12.621,12164,4538,7626,3.336,8.942,5005,3.679,17.883,639,656,3620
2015,4413,26564,56071,525849,516499,3007,5.391,2415,4.33,54379,19273,35106,3.731,10.528,36013,10362,25651,2.006,6.973,18366,3.556,13.945,1611,1653,6189
2015,4421,13050,22419,202170,199394,1837,8.207,1766,7.89,26853,9610,17243,4.82,13.467,21469,8014,13455,4.019,10.767,5384,2.7,21.534,1093,1348,5660
2015,4422,17622,25418,244218,237256,1543,6.043,1776,6.955,35869,10056,25813,4.238,15.118,21371,7066,14305,2.978,9.008,14498,6.111,18.015,1187,1211,3540
2015,4431,21897,41263,392041,395064,3305,7.932,4115,9.876,41499,14446,27053,3.657,10.504,48387,18746,29641,4.745,12.248,-6888,-1.744,21.009,2557,2857,11780
2015,4441,34555,56974,1128249,1122710,2328,4.077,2577,4.513,73911,13616,60295,1.213,6.583,62207,12009,50198,1.07,5.541,11704,1.042,11.082,1802,1856,8024
2015,4442,12536,16382,147497,145024,998,6.107,920,5.629,18076,5083,12993,3.505,12.464,12985,3200,9785,2.207,8.954,5091,3.51,17.907,672,684,2336
2015,4451,59888,86630,2807277,2762619,8686,10.066,8005,9.277,307908,123750,184158,4.479,11.146,221160,100196,120964,3.627,8.005,86748,3.14,16.011,5838,5949,29640
2015,4452,16380,20252,158126,154519,2395,11.916,2088,10.389,30459,12877,17582,8.334,19.712,23344,9092,14252,5.884,15.108,7115,4.605,30.215,1579,1621,7075
2015,4453,27453,31363,162133,159651,2501,8.01,2219,7.107,24043,8409,15634,5.267,15.06,18963,6638,12325,4.158,11.878,5080,3.182,23.756,1790,1828,5538
2015,4461,39722,88699,1035695,1024075,5429,6.142,4825,5.458,98075,29134,68941,2.845,9.577,74577,24914,49663,2.433,7.282,23498,2.295,14.565,3112,3223,15046
2015,4471,61280,107141,920132,910402,7157,6.671,7433,6.929,120989,45119,75870,4.956,13.29,101745,36868,64877,4.05,11.176,19244,2.114,22.352,5157,5392,24766
2015,4481,32012,93022,1357896,1368037,8345,8.98,8158,8.779,197905,85363,112542,6.24,14.466,221622,58955,162667,4.309,16.2,-23717,-1.734,28.933,3775,4992,26983
2015,4482,5137,24438,234321,229074,1294,5.294,1305,5.339,34403,9219,25184,4.024,15.018,23727,7238,16489,3.16,10.358,10676,4.661,20.716,489,516,1867
2015,4483,14951,21966,128659,129419,1267,5.722,1617,7.303,15548,4889,10659,3.778,12.014,17082,4936,12146,3.814,13.199,-1534,-1.185,24.027,1137,1155,3153
2015,4511,24550,35376,479240,468257,2913,8.254,2743,7.773,65067,21981,43086,4.694,13.896,42288,11496,30792,2.455,9.031,22779,4.865,18.062,2014,2078,7489
2015,4512,3384,7473,97165,98059,437,5.803,552,7.33,9781,1712,8069,1.746,9.975,11377,2778,8599,2.833,11.602,-1596,-1.628,19.949,323,334,1203
2015,4522,23,4934,560727,566033,35,0.709,36,0.73,18343,3771,14572,0.666,3.241,28877,2352,26525,0.416,5.102,-10534,-1.861,6.481,(D),(D),(D)
2015,4523,7169,46359,2333665,2301269,2937,6.426,1627,3.56,144084,76991,67093,3.346,6.261,77050,8815,68235,0.383,3.348,67034,2.913,6.696,867,896,2814
2015,4531,11827,12379,59561,60048,904,7.204,1244,9.913,8368,2568,5800,4.277,13.936,9377,3406,5971,5.672,15.616,-1009,-1.68,27.871,996,998,2749
2015,4532,17100,26593,229102,233444,1812,6.668,2977,10.955,27823,7855,19968,3.365,11.919,36003,12542,23461,5.373,15.423,-8180,-3.504,23.837,1957,2051,6655
2015,4533,12839,18903,197988,195870,1741,9.251,1576,8.374,27686,10484,17202,5.353,14.135,23539,6044,17495,3.086,12.018,4147,2.117,24.035,1239,1252,3855
2015,4539,31062,41248,266592,260605,5534,13.734,3628,9.004,43809,21465,22344,8.237,16.81,31849,11164,20685,4.284,12.221,11960,4.589,24.442,2648,2712,8441
2015,4541,28323,29752,460111,437146,5586,19.426,3593,12.495,103151,50458,52693,11.543,23.596,56684,20097,36587,4.597,12.967,46467,10.63,25.934,2858,2873,12335
2015,4542,3043,3452,39521,39393,321,9.2,395,11.321,5764,3336,2428,8.469,14.632,5443,1733,3710,4.399,13.817,321,0.815,27.634,295,296,868
2015,4543,20668,25760,175253,174507,2584,10.011,2686,10.406,25336,10024,15312,5.744,14.519,23486,10324,13162,5.916,13.458,1850,1.06,26.917,1839,1868,6214
2015,4811,410,2197,416620,404294,161,6.908,428,18.365,61202,4248,56954,1.051,15.138,36072,16565,19507,4.097,8.922,25130,6.216,17.844,39,73,271
2015,4812,1871,2064,36309,36006,221,10.731,212,10.294,4774,1119,3655,3.108,13.259,4119,2015,2104,5.596,11.44,655,1.819,22.88,151,156,629
2015,4831,637,970,44740,45413,100,10.384,86,8.93,3593,734,2859,1.616,7.912,5018,672,4346,1.48,11.05,-1425,-3.138,15.824,45,47,378
2015,4832,419,481,22664,22405,58,12.058,58,12.058,1566,369,1197,1.647,6.99,1071,395,676,1.763,4.78,495,2.209,9.561,44,44,153
2015,4841,52391,62751,961711,945593,11127,18.291,7290,11.984,137364,46851,90513,4.955,14.527,104161,38366,65795,4.057,11.015,33203,3.511,22.031,5319,5360,21348
2015,4842,38100,41974,491946,484879,5181,12.448,4473,10.747,81641,26835,54806,5.534,16.837,67450,21830,45620,4.502,13.911,14191,2.927,27.821,3240,3252,13492
2015,4851,463,750,53027,52191,70,9.229,87,11.47,6043,2446,3597,4.687,11.579,4573,2131,2442,4.083,8.762,1470,2.817,17.524,53,53,645
2015,4852,283,485,12667,13320,29,5.979,29,5.979,996,101,895,0.758,7.477,2381,469,1912,3.521,17.875,-1385,-10.398,14.955,20,21,147
2015,4853,6882,7036,77454,76817,1159,16.597,1053,15.079,11808,3807,8001,4.956,15.372,10635,4869,5766,6.338,13.845,1173,1.527,27.689,844,854,3934
2015,4854,2511,4132,228579,224752,412,10.075,327,7.996,31347,14487,16860,6.446,13.947,23386,10714,12672,4.767,10.405,7961,3.542,20.81,170,171,2250
2015,4855,1134,1260,33939,33618,100,7.855,126,9.898,4579,1069,3510,3.18,13.621,4005,893,3112,2.656,11.913,574,1.707,23.827,105,107,761
2015,4859,3672,4149,87378,85962,655,16.127,480,11.818,14655,4737,9918,5.511,17.048,11997,5243,6754,6.099,13.956,2658,3.092,27.912,371,373,3476
2015,4861,71,768,14056,13187,81,10.75,52,6.901,3133,1416,1717,10.738,23.758,1348,288,1060,2.184,10.222,1785,13.536,20.444,5,5,20
2015,4862,118,2133,29107,31544,83,3.542,503,21.468,2375,759,1616,2.406,7.529,7449,6155,1294,19.513,23.615,-5074,-16.086,15.059,7,7,31
2015,4869,65,698,7902,7692,29,4.149,31,4.435,1004,245,759,3.185,13.053,574,109,465,1.417,7.463,430,5.591,14.926,(D),(D),(D)
2015,4871,527,576,11323,10876,93,16.475,70,12.4,1841,491,1350,4.515,16.927,964,326,638,2.997,8.864,877,8.064,17.727,53,53,270
2015,4872,1208,1253,13019,12929,167,13.441,146,11.751,1774,505,1269,3.906,13.721,1606,451,1155,3.488,12.422,168,1.299,24.843,101,102,336
2015,4879,156,176,2344,2305,22,12.222,30,16.667,290,68,222,2.951,12.584,203,111,92,4.817,8.809,87,3.775,17.618,18,18,74
2015,4881,3708,5421,175511,175492,402,7.346,505,9.228,25593,6404,19189,3.649,14.584,25974,10895,15079,6.208,14.801,-381,-0.217,29.167,279,282,2093
2015,4882,493,1384,39484,38093,102,7.362,105,7.578,5876,1702,4174,4.468,15.426,3088,1117,1971,2.932,8.107,2788,7.319,16.213,26,26,195
2015,4883,1803,2362,97654,98657,201,8.586,159,6.792,12500,1518,10982,1.539,12.67,14026,6714,7312,6.805,14.217,-1526,-1.547,25.34,105,107,396
2015,4884,9002,10376,94494,92891,1295,12.602,1095,10.656,16233,5239,10994,5.64,17.475,13225,5375,7850,5.786,14.237,3008,3.238,28.474,758,760,3372
2015,4885,13582,19627,253600,245733,2194,11.355,1585,8.203,39648,17824,21824,7.253,16.135,24406,9830,14576,4,9.932,15242,6.203,19.864,926,948,4364
2015,4889,1322,1454,16807,16449,210,14.742,151,10.6,2724,1098,1626,6.675,16.561,1999,733,1266,4.456,12.153,725,4.408,24.306,118,118,507
2015,4921,4009,9705,553610,529187,1693,18.327,758,8.206,68513,23344,45169,4.411,12.947,19452,5622,13830,1.062,3.676,49061,9.271,7.352,423,441,1868
2015,4922,3682,4083,39283,38086,486,11.831,536,13.048,7896,3470,4426,9.111,20.732,5660,2848,2812,7.478,14.861,2236,5.871,29.723,413,413,1818
2015,4931,7169,14769,786925,771523,1445,9.936,993,6.828,103759,38034,65725,4.93,13.449,72650,21611,51039,2.801,9.416,31109,4.032,18.833,338,355,3811
2015,5111,11521,16222,407396,417487,915,5.542,1494,9.048,36751,9124,27627,2.185,8.803,57637,15020,42617,3.598,13.806,-20886,-5.003,17.606,851,914,6538
2015,5112,6312,9201,488764,478391,1299,14.398,941,10.43,69041,15491,53550,3.238,14.432,47946,14990,32956,3.133,10.022,21095,4.41,20.045,468,470,5145
2015,5121,13688,16944,360320,350598,2332,13.827,2175,12.896,52199,18402,33797,5.249,14.889,33647,11158,22489,3.183,9.597,18552,5.292,19.194,1431,1449,6140
2015,5122,2742,2955,28700,28553,404,13.69,396,13.419,3798,2431,1367,8.514,13.302,3510,1589,1921,5.565,12.293,288,1.009,24.586,272,272,778
2015,5151,3961,7773,217589,215953,489,5.959,1356,16.523,35625,11941,23684,5.529,16.497,32079,13026,19053,6.032,14.855,3546,1.642,29.709,218,266,2898
2015,5152,380,723,52671,53233,61,8.402,67,9.229,5306,1041,4265,1.956,9.968,6479,1075,5404,2.019,12.171,-1173,-2.204,19.935,27,28,236
2015,5173,4499,47487,976023,984312,4520,9.617,3543,7.539,110040,37362,72678,3.796,11.179,124737,29360,95377,2.983,12.673,-14697,-1.493,22.359,308,324,3375
2015,5174,345,428,8493,8425,51,11.86,55,12.791,1076,189,887,2.243,12.772,912,288,624,3.419,10.826,164,1.947,21.651,39,39,219
2015,5179,3378,4023,57102,55817,677,17.055,570,14.359,12913,6568,6345,11.767,23.135,10400,5392,5008,9.66,18.632,2513,4.502,37.265,435,435,2071
2015,5182,8810,13103,543639,530169,1637,12.591,1433,11.022,99091,21878,77213,4.127,18.69,71254,26434,44820,4.986,13.44,27837,5.251,26.88,793,921,15060
2015,5191,8289,10420,258478,252104,1579,15.322,1350,13.1,50504,12031,38473,4.772,20.033,36517,17288,19229,6.858,14.485,13987,5.548,28.97,932,941,4813
2015,5211,12,58,19188,18987,0,0,0,0,653,0,653,0,3.439,270,0,270,0,1.422,383,2.017,2.844,0,0,0
2015,5221,11852,118703,1909040,1938087,4431,3.709,5937,4.97,184436,44855,139581,2.314,9.516,238907,46422,192485,2.395,12.327,-54471,-2.811,19.033,342,498,4968
2015,5222,13437,41488,581696,570596,5187,12.537,4957,11.981,105236,27123,78113,4.753,18.443,84354,30629,53725,5.368,14.784,20882,3.66,29.567,1038,1258,6625
2015,5223,11612,27371,273671,270593,2532,9.265,2450,8.965,46616,13405,33211,4.954,17.227,40378,13345,27033,4.932,14.922,6238,2.305,29.844,1181,1280,5434
2015,5231,11119,39705,401264,400134,3144,7.734,5041,12.4,60995,16039,44956,4.008,15.244,58472,19209,39263,4.801,14.613,2523,0.631,29.226,765,774,2938
2015,5232,13,31,5997,6108,0,0,(D),(D),512,0,512,0,8.382,760,(D),666,(D),12.443,-248,-4.06,16.765,0,0,0
2015,5239,42481,48518,484712,483728,6374,13.246,5578,11.592,72177,25536,46641,5.279,14.921,69997,30930,39067,6.394,14.47,2180,0.451,28.941,3293,3316,11981
2015,5241,4617,31339,1490545,1467116,5157,16.429,5257,16.748,201129,66013,135116,4.5,13.709,153415,48807,104608,3.327,10.457,47714,3.252,20.914,298,304,1920
2015,5242,118934,134115,929775,917740,11733,8.789,10498,7.864,128057,47925,80132,5.222,13.954,104489,40654,63835,4.43,11.385,23568,2.568,22.771,7257,7366,23663
2015,5259,684,710,10308,8570,192,28.235,132,19.412,5431,5028,403,58.67,63.372,2270,1648,622,19.23,26.488,3161,36.884,52.975,112,113,1564
2015,5311,86892,114609,573650,569489,11170,9.803,9853,8.647,90885,41572,49313,7.3,15.959,82101,35961,46140,6.315,14.417,8784,1.542,28.833,6970,7213,23047
2015,5312,67198,78171,280565,276380,13328,17.551,8865,11.674,54215,26882,27333,9.726,19.616,45966,23929,22037,8.658,16.631,8249,2.985,33.263,4880,4936,10463
2015,5313,64755,80288,661259,656718,9348,11.771,7598,9.568,94774,36408,58366,5.544,14.431,85833,37377,48456,5.691,13.07,8941,1.361,26.14,4816,4864,20339
2015,5321,3524,15047,164462,155520,1479,10.03,877,5.947,29222,10311,18911,6.63,18.79,11772,3979,7793,2.559,7.569,17450,11.22,15.139,334,404,2214
2015,5322,7170,18249,142061,143300,1233,6.695,1568,8.514,15949,4913,11036,3.428,11.13,18625,7992,10633,5.577,12.997,-2676,-1.867,22.26,707,742,3406
2015,5323,2219,2654,18550,18135,188,7.101,175,6.61,2716,740,1976,4.081,14.977,1900,568,1332,3.132,10.477,816,4.5,20.955,125,131,414
2015,5324,7292,13667,183941,183255,1329,9.722,1335,9.766,31700,9856,21844,5.378,17.298,30471,10849,19622,5.92,16.628,1229,0.671,33.255,516,525,4119
2015,5331,2033,2208,34050,33430,242,10.988,231,10.488,4305,987,3318,2.952,12.878,3000,935,2065,2.797,8.974,1305,3.904,17.948,173,173,618
2015,5411,157951,169357,1139308,1143735,13009,7.654,14200,8.355,112863,36424,76439,3.185,9.868,121924,36781,85143,3.216,10.66,-9061,-0.792,19.736,10203,10275,26505
2015,5412,99242,119306,1344781,1311548,10249,8.618,9487,7.977,221211,61640,159571,4.7,16.866,155168,49653,105515,3.786,11.831,66043,5.036,23.662,6408,6584,35840
2015,5413,80561,100655,1455056,1438517,11649,11.748,8651,8.725,247556,109847,137709,7.636,17.209,213420,50916,162504,3.539,14.836,34136,2.373,29.672,5012,5088,18053
2015,5414,25381,25700,113073,110389,3776,14.86,3198,12.585,20581,8584,11997,7.776,18.644,15228,7272,7956,6.588,13.795,5353,4.849,27.59,2229,2232,5281
2015,5415,96735,116587,1687720,1656328,20238,17.604,16986,14.775,338976,128104,210872,7.734,20.466,274918,111051,163867,6.705,16.598,64058,3.867,33.196,10367,10403,39835
2015,5416,120848,130821,1186512,1160194,23050,17.868,19416,15.051,253580,93687,159893,8.075,21.857,200532,86170,114362,7.427,17.284,53048,4.572,34.569,13889,13927,48453
2015,5417,12517,16096,658217,650136,1943,12.121,1811,11.298,84042,23166,60876,3.563,12.927,67096,20218,46878,3.11,10.32,16946,2.607,20.641,1073,1082,7885
2015,5418,29234,32838,463397,464884,3621,11.016,3685,11.211,67254,22013,45241,4.735,14.467,70051,24233,45818,5.213,15.068,-2797,-0.602,28.934,2704,2750,15290
2015,5419,53239,59517,608881,598024,6538,11.087,5442,9.229,93718,36136,57582,6.043,15.671,71299,28748,42551,4.807,11.922,22419,3.749,23.845,3596,3626,17574
2015,5511,26666,53070,3355890,3313588,4532,8.594,3866,7.331,505061,158858,346203,4.794,15.242,419616,92519,327097,2.792,12.663,85445,2.579,25.327,688,724,11301
2015,5611,25196,27346,432402,426740,3277,12.011,3152,11.553,77001,28115,48886,6.588,18.044,65795,26851,38944,6.292,15.418,11206,2.626,30.836,2242,2253,17038
2015,5612,1814,6271,257516,251424,1590,26.613,997,16.688,44698,19031,25667,7.569,17.778,33221,14001,19220,5.569,13.213,11477,4.565,26.426,109,117,1509
2015,5613,24191,47140,5601541,5478796,7664,16.597,5736,12.422,1034238,224963,809275,4.106,18.877,790569,264592,525977,4.829,14.43,243669,4.447,28.859,2148,2232,102338
2015,5614,23067,29617,786097,777598,2787,9.355,3137,10.53,116595,28107,88488,3.615,14.994,98829,30767,68062,3.957,12.71,17766,2.285,25.419,2274,2330,17117
2015,5615,12741,21642,230597,230660,2031,9.022,3770,16.747,45492,24483,21009,10.614,19.723,47188,28919,18269,12.538,20.458,-1696,-0.735,39.445,856,862,3733
2015,5616,17617,23506,909924,901711,2327,9.916,2247,9.576,119088,22343,96745,2.478,13.207,101417,34141,67276,3.786,11.247,17671,1.96,22.494,1419,1427,15570
2015,5617,144054,151114,1799432,1781979,20422,13.648,17453,11.664,277527,84952,192575,4.767,15.574,242521,86570,155951,4.858,13.61,35006,1.964,27.219,11719,11771,55719
2015,5619,15524,17361,270779,268386,1833,10.612,1657,9.593,44743,11963,32780,4.457,16.671,39769,19300,20469,7.191,14.818,4974,1.853,29.636,1128,1131,9140
2015,5621,7148,10483,200216,198492,629,5.988,673,6.406,20556,4975,15581,2.506,10.356,16568,4827,11741,2.432,8.347,3988,2.009,16.694,486,491,2865
2015,5622,1228,2501,50331,50299,131,5.246,123,4.926,4752,1143,3609,2.272,9.448,4771,1835,2936,3.648,9.485,-19,-0.038,18.895,61,62,628
2015,5629,8176,9628,132140,130292,870,9.116,702,7.355,23626,5716,17910,4.387,18.133,20227,4603,15624,3.533,15.524,3399,2.609,31.049,449,462,2858
2015,6111,19011,21846,1006999,989999,1228,5.643,1057,4.857,84338,18584,65754,1.877,8.519,50703,15321,35382,1.548,5.122,33635,3.397,10.243,610,634,10462
2015,6112,462,1019,78790,81337,25,2.4,70,6.721,3387,600,2787,0.738,4.164,8555,1500,7055,1.844,10.518,-5168,-6.354,8.328,21,34,658
2015,6113,2380,4571,1871829,1854161,325,7.101,337,7.363,97313,2452,94861,0.132,5.248,61609,9169,52440,0.495,3.323,35704,1.926,6.645,57,57,1018
2015,6114,6488,6911,59279,58538,801,11.573,821,11.862,9947,3301,6646,5.639,16.993,8471,3400,5071,5.808,14.471,1476,2.521,28.942,569,583,2652
2015,6115,5997,7692,109976,110154,691,9.013,641,8.361,15125,5835,9290,5.297,13.731,15573,3990,11583,3.622,14.137,-448,-0.407,27.462,422,446,2309
2015,6116,40069,43041,401933,394322,5699,13.483,4150,9.819,72273,26934,45339,6.83,18.328,57194,17722,39472,4.494,14.504,15079,3.824,29.009,3061,3192,13518
2015,6117,5884,6831,107793,107982,1098,16.536,716,10.783,20981,5519,15462,5.111,19.43,21621,3978,17643,3.684,20.023,-640,-0.593,38.86,544,544,2485
2015,6211,160959,206419,2410141,2358298,19127,9.328,16396,7.996,367719,156492,211227,6.636,15.593,260033,98576,161457,4.18,11.026,107686,4.566,22.053,11420,11767,56402
2015,6212,119249,128632,906083,900560,6682,5.198,6513,5.067,106678,33900,72778,3.764,11.846,96209,34455,61754,3.826,10.683,10469,1.162,21.366,5382,5437,26955
2015,6213,117296,135244,821722,814759,12751,9.521,10120,7.556,132483,47036,85447,5.773,16.26,120265,40379,79886,4.956,14.761,12218,1.5,29.522,7022,7099,23268
2015,6214,15932,39662,916841,886771,4436,11.564,1833,4.778,137854,66121,71733,7.456,15.546,78244,17976,60268,2.027,8.823,59610,6.722,17.647,908,975,7480
2015,6215,7047,16247,279726,267173,4603,31.726,1126,7.761,69141,43844,25297,16.41,25.879,42761,10939,31822,4.094,16.005,26380,9.874,32.01,594,636,5323
2015,6216,19832,28991,1369171,1333930,3600,12.612,2708,9.487,257597,82822,174775,6.209,19.311,186404,62106,124298,4.656,13.974,71193,5.337,27.948,1716,1762,24923
2015,6219,6170,9686,297036,293211,798,8.305,643,6.692,40952,11683,29269,3.985,13.967,33154,8406,24748,2.867,11.307,7798,2.66,22.614,439,455,5365
2015,6221,2565,5053,5109018,5122391,129,2.564,84,1.67,205595,44892,160703,0.876,4.014,232806,18809,213997,0.367,4.545,-27211,-0.531,8.027,47,48,5995
2015,6222,406,615,224905,227121,17,2.785,8,1.31,7050,1779,5271,0.783,3.104,11085,208,10877,0.092,4.881,-4035,-1.777,6.208,6,6,151
2015,6223,351,941,285321,283951,42,4.473,38,4.047,15161,3494,11667,1.23,5.339,12498,2722,9776,0.959,4.401,2663,0.938,8.803,20,20,1625
2015,6231,8400,16313,1676568,1676889,1031,6.339,934,5.743,155388,70560,84828,4.208,9.266,156347,63367,92980,3.779,9.324,-959,-0.057,18.533,518,543,39440
2015,6232,9613,39923,753510,749054,2807,7.097,2064,5.219,108066,29388,78678,3.923,14.427,98068,24324,73744,3.247,13.092,9998,1.335,26.184,381,467,4907
2015,6233,16136,22780,904171,887793,1977,8.765,1527,6.77,110937,35451,75486,3.993,12.496,77280,23275,54005,2.622,8.705,33657,3.791,17.409,1067,1087,16017
2015,6239,2971,4906,132214,131099,364,7.4,390,7.928,17570,5656,11914,4.314,13.402,15311,4885,10426,3.726,11.679,2259,1.723,23.358,152,172,1592
2015,6241,55943,73147,1630990,1592213,9356,13.099,5915,8.281,231318,66001,165317,4.145,14.528,154561,41427,113134,2.602,9.707,76757,4.821,19.415,4027,4087,26175
2015,6242,10003,14092,187935,183812,631,4.497,512,3.649,22833,3330,19503,1.812,12.422,14886,3114,11772,1.694,8.098,7947,4.323,16.197,296,312,1845
2015,6243,3953,7487,325815,328458,388,5.174,413,5.507,37763,4514,33249,1.374,11.497,43718,7155,36563,2.178,13.31,-5955,-1.813,22.994,140,149,3189
2015,6244,55008,70093,892959,882351,6455,9.223,6248,8.927,117497,40293,77204,4.567,13.316,96265,37183,59082,4.214,10.91,21232,2.406,21.82,4493,4567,25977
2015,7111,7132,7273,122792,122225,837,11.624,692,9.61,17542,5053,12489,4.134,14.352,16541,4643,11898,3.799,13.533,1001,0.819,27.066,462,463,3711
2015,7112,3214,3389,128461,127061,403,11.909,393,11.613,17048,4216,12832,3.318,13.417,14187,3140,11047,2.471,11.166,2861,2.252,22.331,308,309,2634
2015,7113,6067,6485,163533,161234,836,13.135,595,9.349,23085,6125,16960,3.799,14.318,18289,3754,14535,2.328,11.343,4796,2.975,22.686,389,392,1969
2015,7114,2970,3095,20010,19972,421,13.74,359,11.717,3063,1204,1859,6.028,15.336,2977,1398,1579,7,14.906,86,0.431,29.812,263,264,1187
2015,7115,15150,15187,46866,46000,2867,19.193,2369,15.859,12607,6506,6101,14.143,27.407,10874,5119,5755,11.128,23.639,1733,3.767,47.278,1448,1448,3214
2015,7121,6587,7067,145791,144348,341,4.85,269,3.826,10718,1877,8841,1.3,7.425,7763,1066,6697,0.738,5.378,2955,2.047,10.756,155,155,766
2015,7131,2289,2644,198451,190852,325,12.246,345,12.999,24670,5092,19578,2.668,12.926,9619,4226,5393,2.214,5.04,15051,7.886,10.08,277,280,2127
2015,7132,1763,2840,157779,156886,299,10.707,204,7.305,12527,4604,7923,2.935,7.985,10606,4224,6382,2.692,6.76,1921,1.224,13.521,163,164,2949
2015,7139,50883,58799,1249488,1228197,7004,12.053,5627,9.683,171228,65736,105492,5.352,13.941,128239,47535,80704,3.87,10.441,42989,3.5,20.882,4146,4201,34359
2015,7211,40315,51384,1971759,1960231,4713,9.226,4118,8.061,218868,98152,120716,5.007,11.165,195935,83633,112302,4.266,9.996,22933,1.17,19.991,2829,2868,50080
2015,7212,5335,5925,43302,42642,461,7.807,421,7.13,6462,1529,4933,3.586,15.154,5268,1485,3783,3.483,12.354,1194,2.8,24.708,263,263,862
2015,7213,1718,1915,11236,11513,142,7.29,208,10.678,1625,706,919,6.132,14.114,2215,1081,1134,9.389,19.239,-590,-5.125,28.229,148,148,816
2015,7223,14008,33771,712557,718454,4099,11.58,7350,20.765,150312,43031,107281,5.989,20.922,159437,93711,65726,13.043,22.192,-9125,-1.27,41.843,1539,1573,9080
2015,7224,36437,37384,362866,361902,3609,9.572,4245,11.259,63860,28386,35474,7.844,17.646,62018,26201,35817,7.24,17.137,1842,0.509,34.273,3518,3529,21991
2015,7225,359156,496738,10104732,9898876,53108,10.798,43256,8.795,1621720,787876,833844,7.959,16.383,1215514,453932,761582,4.586,12.279,406206,4.104,24.559,34630,35816,355428
2015,8111,134038,147719,865124,856890,12441,8.443,11722,7.955,123728,46001,77727,5.368,14.439,106733,44864,61869,5.236,12.456,16995,1.983,24.912,8688,8797,30540
2015,8112,9685,10982,98686,98783,1252,11.403,1247,11.358,14967,6010,8957,6.084,15.151,15413,6117,9296,6.192,15.603,-446,-0.451,30.303,853,860,2757
2015,8113,18167,20071,209748,209579,1653,8.243,1618,8.068,29315,7289,22026,3.478,13.988,29202,8558,20644,4.083,13.934,113,0.054,27.867,1114,1118,4905
2015,8114,17278,18014,69789,68714,2131,11.912,1881,10.515,11576,5047,6529,7.345,16.847,9431,4128,5303,6.008,13.725,2145,3.122,27.45,1388,1389,3114
2015,8121,95512,112289,670248,663950,14047,12.634,11842,10.651,114813,55633,59180,8.379,17.292,102998,43278,59720,6.518,15.513,11815,1.78,31.026,8949,9162,31581
2015,8122,14166,20109,138928,138878,722,3.597,645,3.214,12674,3106,9568,2.237,9.126,12403,2217,10186,1.596,8.931,271,0.195,17.862,412,437,1573
2015,8123,27471,32731,298153,295157,2336,7.076,2901,8.787,38483,10043,28440,3.403,13.038,32769,14804,17965,5.016,11.102,5714,1.936,22.204,2177,2272,8876
2015,8129,27707,37748,295254,289545,6541,17.574,5485,14.737,62110,27637,34473,9.545,21.451,50453,29329,21124,10.129,17.425,11657,4.026,34.85,2425,2452,9929
2015,8131,177637,177978,1680762,1680331,7865,4.426,7292,4.104,131422,22549,108873,1.342,7.821,130603,20433,110170,1.216,7.772,819,0.049,15.545,4685,4685,13143
2015,8132,16474,18400,185667,183005,1299,7.096,1112,6.074,19597,3891,15706,2.126,10.708,14111,3818,10293,2.086,7.711,5486,2.998,15.421,765,785,2112
2015,8133,13972,16489,171624,166390,1171,7.139,999,6.09,25874,10764,15110,6.469,15.55,15067,3252,11815,1.954,9.055,10807,6.495,18.111,642,643,2153
2015,8134,22519,24428,238176,238192,1242,5.069,1385,5.653,23477,4586,18891,1.925,9.856,23483,5880,17603,2.469,9.859,-6,-0.003,19.713,904,910,3553
2015,8139,53596,55733,486945,488203,2260,4.028,3008,5.361,43135,8205,34930,1.681,8.835,45509,12570,32939,2.575,9.322,-2374,-0.486,17.671,2111,2116,7873
2016,1131,378,423,4249,4084,37,8.81,31,7.381,836,119,717,2.914,20.473,502,348,154,8.522,12.293,334,8.179,24.587,23,23,52
2016,1132,123,139,1265,1291,18,12.811,21,14.947,183,50,133,3.874,14.181,249,115,134,8.911,19.295,-66,-5.114,28.361,14,14,62
2016,1133,7251,7362,50343,50771,783,10.723,663,9.08,7375,2828,4547,5.57,14.526,8275,2091,6184,4.118,16.299,-900,-1.773,29.052,477,477,1642
2016,1141,1288,1307,5453,5698,243,19.036,182,14.258,936,536,400,9.407,16.427,1447,833,614,14.619,25.395,-511,-8.968,32.854,97,97,176
2016,1142,293,296,1670,1623,31,10.616,23,7.877,290,69,221,4.253,17.874,200,50,150,3.082,12.327,90,5.547,24.653,18,18,37
2016,1151,3674,4025,65161,64676,466,11.707,377,9.471,10081,3930,6151,6.076,15.587,9211,2975,6236,4.6,14.242,870,1.345,28.484,267,267,2500
2016,1152,3839,3935,19930,19663,524,13.472,433,11.133,3135,1388,1747,7.059,15.944,2620,1211,1409,6.159,13.325,515,2.619,26.65,344,344,926
2016,1153,1310,1383,11652,11685,163,11.88,141,10.277,1728,527,1201,4.51,14.788,1793,492,1301,4.211,15.344,-65,-0.556,29.576,99,99,369
2016,2111,5108,6637,119197,126422,481,7.034,884,12.927,13857,7833,6024,6.196,10.961,28148,8434,19714,6.671,22.265,-14291,-11.304,21.922,594,594,2421
2016,2121,390,747,54326,62263,42,5.31,130,16.435,4092,2180,1912,3.501,6.572,19773,7100,12673,11.403,31.757,-15681,-25.185,13.144,57,74,3812
2016,2122,209,279,38183,39262,26,9.204,33,11.681,2531,377,2154,0.96,6.446,4568,669,3899,1.704,11.635,-2037,-5.188,12.893,21,21,347
2016,2123,2646,4776,80219,80494,245,5.121,261,5.456,8201,2015,6186,2.503,10.188,8614,1414,7200,1.757,10.701,-413,-0.513,20.377,153,154,757
2016,2131,9842,12537,293164,355833,1150,8.696,2524,19.087,25227,13518,11709,3.799,7.09,150366,25023,125343,7.032,42.257,-125139,-35.168,14.179,1605,1615,11675
2016,2211,1703,10681,513294,511296,671,6.367,385,3.653,32997,8930,24067,1.747,6.454,29064,4736,24328,0.926,5.684,3933,0.769,11.369,90,95,955
2016,2212,411,2507,87351,87609,124,4.951,119,4.751,5861,2104,3757,2.402,6.69,6321,1899,4422,2.168,7.215,-460,-0.525,13.38,23,24,112
2016,2213,3477,4611,43492,43176,278,6.052,243,5.29,5481,2175,3306,5.038,12.695,4898,1846,3052,4.276,11.344,583,1.35,22.689,138,138,382
2016,2361,133141,134487,661724,641518,24109,18.338,18070,13.745,155026,65334,89692,10.184,24.166,114424,48850,65574,7.615,17.836,40602,6.329,35.673,12261,12265,34321
2016,2362,36586,38063,637814,622731,3776,9.986,3279,8.671,109683,22134,87549,3.554,17.613,80058,17705,62353,2.843,12.856,29625,4.757,25.712,2326,2328,11364
2016,2371,16278,17949,564476,562292,1549,8.662,1417,7.924,94366,19466,74900,3.462,16.782,89403,18705,70698,3.327,15.9,4963,0.883,31.8,982,985,8865
2016,2372,4253,4338,25127,24884,398,9.088,481,10.983,4111,1270,2841,5.104,16.521,3676,1821,1855,7.318,14.773,435,1.748,29.546,368,368,1421
2016,2373,7938,8771,276821,269181,620,7.077,599,6.838,45165,6507,38658,2.417,16.779,29613,4957,24656,1.842,11.001,15552,5.778,22.002,399,401,3340
2016,2379,3609,3738,87673,86384,376,10.121,330,8.883,13814,2208,11606,2.556,15.991,11343,3115,8228,3.606,13.131,2471,2.86,26.262,211,212,1998
2016,2381,75216,76119,815541,789099,10603,14.201,7689,10.298,172461,43800,128661,5.551,21.855,119648,34296,85352,4.346,15.163,52813,6.693,30.325,5079,5086,24890
2016,2382,157866,162461,1919047,1872986,15769,9.815,12184,7.583,307524,68546,238978,3.66,16.419,215527,58679,156848,3.133,11.507,91997,4.912,23.014,8646,8670,38851
2016,2383,94880,96009,754588,733523,13706,14.55,10092,10.713,151310,41697,109613,5.684,20.628,108941,33557,75384,4.575,14.852,42369,5.776,29.704,6827,6845,24641
2016,2389,55283,56065,575719,559463,7511,13.671,5262,9.578,114991,27332,87659,4.885,20.554,82533,21920,60613,3.918,14.752,32458,5.802,29.504,3473,3473,14149
2016,3111,1087,1710,53429,54226,93,5.472,72,4.237,5767,1092,4675,2.014,10.635,6988,830,6158,1.531,12.887,-1221,-2.252,21.27,49,49,406
2016,3112,473,817,55419,55635,33,4.039,33,4.039,2897,281,2616,0.505,5.207,3274,995,2279,1.788,5.885,-377,-0.678,10.414,20,21,138
2016,3113,1658,1831,80018,77997,152,8.336,137,7.513,9323,2310,7013,2.962,11.953,5266,981,4285,1.258,6.752,4057,5.201,13.503,109,110,659
2016,3114,1396,1752,157419,156386,157,9.052,122,7.034,14374,1800,12574,1.151,9.191,12246,3148,9098,2.013,7.831,2128,1.361,15.661,90,90,1649
2016,3115,1064,1563,144793,142920,98,6.288,89,5.711,10639,1113,9526,0.779,7.444,6679,1008,5671,0.705,4.673,3960,2.771,9.347,68,68,393
2016,3116,2748,3358,494626,489347,163,4.845,175,5.202,28831,2739,26092,0.56,5.892,18754,2712,16042,0.554,3.832,10077,2.059,7.665,128,128,1127
2016,3117,428,518,30953,30865,39,7.565,34,6.596,3689,418,3271,1.354,11.952,3534,421,3113,1.364,11.45,155,0.502,22.9,23,23,121
2016,3118,9613,10388,290645,288358,1002,9.707,871,8.438,33765,10412,23353,3.611,11.709,28584,8265,20319,2.866,9.913,5181,1.797,19.825,724,726,5419
2016,3119,2941,3405,196018,194053,349,10.376,266,7.908,21102,4652,16450,2.397,10.874,17027,4772,12255,2.459,8.774,4075,2.1,17.549,207,207,2025
2016,3121,6522,7169,182673,175099,1186,17.509,395,5.832,25448,7445,18003,4.252,14.534,10276,2402,7874,1.372,5.869,15172,8.665,11.737,306,306,1396
2016,3122,125,151,13538,13867,22,14.765,18,12.081,615,312,303,2.25,4.435,1228,119,1109,0.858,8.856,-613,-4.421,8.87,16,16,57
2016,3131,251,311,25006,25047,24,7.754,21,6.785,1540,102,1438,0.407,6.148,1529,341,1188,1.361,6.105,11,0.044,12.209,17,17,72
2016,3132,756,841,48435,48223,35,4.094,63,7.368,3655,541,3114,1.122,7.579,3212,968,2244,2.007,6.661,443,0.919,13.321,52,52,758
2016,3133,812,857,28224,28038,34,3.899,64,7.339,2320,265,2055,0.945,8.275,1892,383,1509,1.366,6.748,428,1.527,13.496,52,52,289
2016,3141,1531,1644,53918,53881,82,4.904,138,8.254,3848,590,3258,1.095,7.142,3747,1262,2485,2.342,6.954,101,0.187,13.908,106,106,700
2016,3149,3803,3906,58790,59036,326,8.351,321,8.223,5619,1438,4181,2.436,9.518,6120,1900,4220,3.218,10.367,-501,-0.849,19.036,256,256,1289
2016,3151,212,221,11850,12149,16,7.111,24,10.667,596,97,499,0.798,4.906,1225,228,997,1.877,10.083,-629,-5.177,9.812,19,19,164
2016,3152,4604,4650,76331,79105,668,14.069,864,18.197,14354,6476,7878,8.187,18.146,19993,7954,12039,10.055,25.274,-5639,-7.129,36.291,779,779,7184
2016,3159,496,502,8080,7875,45,8.763,68,13.242,1152,170,982,2.159,14.63,749,325,424,4.127,9.512,403,5.118,19.023,54,54,222
2016,3161,165,174,3583,3607,14,8.046,14,8.046,269,48,221,1.331,7.458,326,29,297,0.804,9.038,-57,-1.58,14.915,8,8,16
2016,3162,183,201,11435,11559,23,11.414,24,11.911,351,106,245,0.917,3.037,582,92,490,0.796,5.035,-231,-1.999,6.073,20,20,86
2016,3169,686,691,10883,10875,61,8.821,62,8.966,1084,237,847,2.179,9.968,1065,238,827,2.189,9.794,19,0.175,19.587,52,52,218
2016,3211,2611,3054,85269,85377,194,6.361,186,6.098,7073,1646,5427,1.928,8.284,7311,1411,5900,1.653,8.563,-238,-0.279,16.569,141,141,984
2016,3212,1037,1367,75439,73482,75,5.511,63,4.629,8040,1756,6284,2.39,10.941,4155,1016,3139,1.383,5.654,3885,5.287,11.309,45,45,655
2016,3219,7852,8872,232623,228611,825,9.396,641,7.301,27221,6973,20248,3.05,11.907,19004,6284,12720,2.749,8.313,8217,3.594,16.626,496,496,4633
2016,3221,208,427,103231,104312,8,1.854,17,3.94,3428,151,3277,0.145,3.286,5379,995,4384,0.954,5.157,-1951,-1.87,6.573,12,12,105
2016,3222,2342,3605,246556,246063,116,3.189,180,4.949,16661,3246,13415,1.319,6.771,15717,5001,10716,2.032,6.387,944,0.384,12.775,114,116,2200
2016,3231,22711,24135,451598,451375,1542,6.348,1854,7.632,46929,16459,30470,3.646,10.397,46535,18852,27683,4.177,10.31,394,0.087,20.619,1499,1506,10213
2016,3241,905,2089,106425,104507,130,6.248,113,5.431,10100,2037,8063,1.949,9.664,6470,1927,4543,1.844,6.191,3630,3.473,12.382,45,45,674
2016,3251,1240,2450,156166,157700,189,7.87,92,3.831,13069,4032,9037,2.557,8.287,16024,3307,12717,2.097,10.161,-2955,-1.874,16.575,62,64,2242
2016,3252,1034,1363,95615,95814,58,4.246,64,4.685,6993,1438,5555,1.501,7.299,7344,1176,6168,1.227,7.665,-351,-0.366,14.597,41,42,395
2016,3253,662,918,29777,29387,69,7.624,43,4.751,2619,405,2214,1.378,8.912,1819,519,1300,1.766,6.19,800,2.722,12.38,29,29,256
2016,3254,1695,2208,249332,247216,184,8.442,127,5.827,22417,5832,16585,2.359,9.068,18468,3886,14582,1.572,7.47,3949,1.597,14.941,83,83,1648
2016,3255,1299,1659,60363,60033,86,5.181,88,5.301,5455,1767,3688,2.943,9.087,4862,1499,3363,2.497,8.099,593,0.988,16.198,56,56,576
2016,3256,1867,2067,96970,97224,143,6.932,135,6.544,7513,1696,5817,1.744,7.728,7981,2588,5393,2.662,8.209,-468,-0.481,15.455,92,92,677
2016,3259,1689,2176,80359,80385,143,6.581,137,6.305,7538,1371,6167,1.706,9.377,7533,1853,5680,2.305,9.371,5,0.006,18.742,99,100,710
2016,3261,7776,10083,619054,612545,373,3.685,449,4.436,53972,7689,46283,1.255,8.811,40667,8503,32164,1.388,6.639,13305,2.172,13.278,321,327,5010
2016,3262,1378,1788,133071,131846,63,3.503,84,4.671,9125,729,8396,0.553,6.921,6568,1399,5169,1.061,4.982,2557,1.939,9.963,55,56,895
2016,3271,868,1046,33504,33545,68,6.489,72,6.87,2838,716,2122,2.134,8.46,2909,593,2316,1.768,8.672,-71,-0.212,16.921,60,61,461
2016,3272,1340,1590,90545,88241,95,5.938,115,7.188,9170,1080,8090,1.224,10.392,4405,1750,2655,1.983,4.992,4765,5.4,9.984,76,76,536
2016,3273,3943,8500,170110,165845,513,6.106,315,3.75,23944,5746,18198,3.465,14.438,15483,3469,12014,2.092,9.336,8461,5.102,18.672,154,162,1593
2016,3274,169,303,13513,13486,18,6.01,11,3.673,681,90,591,0.667,5.05,625,39,586,0.289,4.634,56,0.415,9.269,8,8,36
2016,3279,2591,3046,75939,75766,190,6.275,154,5.086,7503,1271,6232,1.678,9.903,7145,1502,5643,1.982,9.43,358,0.473,18.861,113,113,950
2016,3311,301,456,92090,96922,20,4.348,28,6.087,2050,160,1890,0.165,2.115,11308,543,10765,0.56,11.667,-9258,-9.552,4.23,20,20,86
2016,3312,498,626,46460,48304,33,5.222,45,7.12,3422,1194,2228,2.472,7.084,7173,1357,5816,2.809,14.85,-3751,-7.765,14.169,35,35,849
2016,3313,379,510,57816,58067,16,3.131,18,3.523,4305,328,3977,0.565,7.414,4713,139,4574,0.239,8.117,-408,-0.703,14.828,15,15,134
2016,3314,732,922,59954,60267,25,2.682,45,4.828,3386,494,2892,0.82,5.618,3904,1221,2683,2.026,6.478,-518,-0.86,11.237,31,32,303
2016,3315,1501,1699,119600,123184,56,3.271,82,4.79,6001,968,5033,0.786,4.872,13096,2070,11026,1.68,10.631,-7095,-5.76,9.743,55,58,1116
2016,3321,2122,2381,109999,112157,72,3.011,92,3.848,6553,804,5749,0.717,5.843,10887,1475,9412,1.315,9.707,-4334,-3.864,11.685,65,65,885
2016,3322,1028,1105,35145,35316,66,5.922,85,7.627,2937,805,2132,2.279,8.316,3297,1155,2142,3.271,9.336,-360,-1.019,16.633,66,66,408
2016,3323,10972,11943,347081,344637,765,6.444,621,5.231,35730,7796,27934,2.262,10.367,30886,7581,23305,2.2,8.962,4844,1.406,17.924,465,468,4784
2016,3324,1193,1505,84760,88953,49,3.227,76,5.005,4447,830,3617,0.933,4.999,12724,1929,10795,2.169,14.304,-8277,-9.305,9.999,51,51,931
2016,3325,513,556,27658,27440,35,6.329,29,5.244,1928,325,1603,1.184,7.026,1479,366,1113,1.334,5.39,449,1.636,10.78,20,20,158
2016,3326,992,1136,38285,38695,29,2.535,45,3.934,2326,333,1993,0.861,6.011,3126,635,2491,1.641,8.079,-800,-2.067,12.022,35,36,552
2016,3327,21188,21766,371787,381308,1057,4.819,1396,6.364,30351,9279,21072,2.433,7.96,49317,10259,39058,2.69,12.934,-18966,-4.974,15.919,1053,1062,6858
2016,3328,4911,5468,126937,128258,257,4.674,318,5.783,11287,2668,8619,2.08,8.8,13881,3493,10388,2.723,10.823,-2594,-2.022,17.6,245,245,2275
2016,3329,5617,6155,262198,266226,352,5.699,396,6.411,18518,3547,14971,1.332,6.956,26899,4686,22213,1.76,10.104,-8381,-3.148,13.912,282,285,1799
2016,3331,2493,2912,189266,203847,114,3.853,207,6.997,8281,1642,6639,0.806,4.062,37496,4730,32766,2.32,18.394,-29215,-14.332,8.125,147,148,1916
2016,3332,2891,3058,105523,105989,146,4.739,191,6.2,8167,1521,6646,1.435,7.706,9202,2343,6859,2.211,8.682,-1035,-0.977,15.411,144,144,1022
2016,3333,1745,1867,73178,74150,99,5.26,129,6.854,5179,1109,4070,1.496,6.984,6997,1800,5197,2.428,9.436,-1818,-2.452,13.969,89,89,754
2016,3334,1410,1683,127128,127995,77,4.558,90,5.327,8618,1622,6996,1.267,6.733,10310,3978,6332,3.108,8.055,-1692,-1.322,13.466,62,62,925
2016,3335,5979,6232,147590,147966,250,3.994,305,4.873,11753,2503,9250,1.692,7.943,12352,2675,9677,1.808,8.348,-599,-0.405,15.886,237,237,1735
2016,3336,795,1007,96677,99163,34,3.355,47,4.637,4858,291,4567,0.293,4.899,10136,1284,8852,1.295,10.222,-5278,-5.323,9.798,30,30,844
2016,3339,5133,5813,294946,297949,257,4.407,295,5.058,20576,4748,15828,1.594,6.906,26608,5027,21581,1.687,8.93,-6032,-2.025,13.812,202,202,1921
2016,3341,917,955,42325,41996,66,6.85,83,8.614,4718,937,3781,2.231,11.234,4066,1205,2861,2.869,9.682,652,1.553,19.364,60,61,885
2016,3342,1159,1276,85179,86670,89,6.969,91,7.126,6893,1265,5628,1.46,7.953,10044,2295,7749,2.648,11.589,-3151,-3.636,15.906,66,67,1128
2016,3343,444,456,9723,9850,50,11.123,37,8.231,830,145,685,1.472,8.426,1054,530,524,5.381,10.701,-224,-2.274,16.853,27,27,160
2016,3344,3333,3768,263833,265356,174,4.595,212,5.598,18548,2817,15731,1.062,6.99,21525,5236,16289,1.973,8.112,-2977,-1.122,13.98,156,157,2563
2016,3345,4227,4887,375147,376064,253,5.134,334,6.778,24484,3040,21444,0.808,6.511,26048,6776,19272,1.802,6.926,-1564,-0.416,13.021,231,233,1916
2016,3346,416,426,9638,9621,39,9.007,53,12.24,1026,333,693,3.461,10.664,1029,581,448,6.039,10.695,-3,-0.031,21.328,41,41,465
2016,3351,976,1036,43429,43208,70,6.737,76,7.315,3667,743,2924,1.72,8.487,3200,865,2335,2.002,7.406,467,1.081,14.812,55,55,554
2016,3352,243,287,48544,47974,23,8,24,8.348,3862,533,3329,1.111,8.05,2800,451,2349,0.94,5.836,1062,2.214,11.673,20,20,434
2016,3353,1716,1986,116173,118035,77,3.836,120,5.978,5642,1128,4514,0.956,4.78,9501,1752,7749,1.484,8.049,-3859,-3.269,9.56,82,82,606
2016,3359,1761,2037,135577,135713,97,4.734,121,5.905,10300,1451,8849,1.069,7.59,10562,2302,8260,1.696,7.783,-262,-0.193,15.179,91,91,876
2016,3361,265,320,198251,191724,22,6.875,22,6.875,19609,353,19256,0.184,10.228,6543,298,6245,0.155,3.413,13066,6.815,6.825,13,13,159
2016,3362,1532,1819,144928,141792,111,6.082,123,6.74,15181,2078,13103,1.466,10.707,9085,2415,6670,1.703,6.407,6096,4.299,12.815,87,87,828
2016,3363,3904,4861,561718,552999,209,4.278,259,5.301,49885,5398,44487,0.976,9.021,32441,7380,25061,1.335,5.866,17444,3.154,11.733,171,181,3408
2016,3364,1307,1752,367678,367421,103,5.904,88,5.044,23948,3958,19990,1.077,6.518,23513,8488,15025,2.31,6.399,435,0.118,12.799,56,56,590
2016,3365,150,232,29217,31086,7,2.979,13,5.532,1593,61,1532,0.196,5.125,5356,1669,3687,5.369,17.23,-3763,-12.105,10.249,4,4,43
2016,3366,1276,1412,140237,141616,108,7.651,107,7.581,10814,2205,8609,1.557,7.636,13773,2467,11306,1.742,9.726,-2959,-2.089,15.272,77,78,1579
2016,3369,787,819,34469,33802,90,11.084,76,9.36,4472,887,3585,2.624,13.23,3064,1170,1894,3.461,9.065,1408,4.165,18.129,64,64,391
2016,3371,9799,10067,225181,221858,656,6.483,760,7.511,24613,5265,19348,2.373,11.094,17950,6593,11357,2.972,8.091,6663,3.003,16.182,568,572,4121
2016,3372,3260,3425,113746,111964,195,5.655,242,7.018,11247,1879,9368,1.678,10.045,7728,2679,5049,2.393,6.902,3519,3.143,13.804,186,187,1705
2016,3379,612,707,31645,31541,32,4.463,52,7.252,2346,346,2000,1.097,7.438,2158,502,1656,1.592,6.842,188,0.596,13.684,42,42,303
2016,3391,8929,9877,280358,278456,551,5.502,827,8.258,27590,5033,22557,1.807,9.908,23559,7042,16517,2.529,8.461,4031,1.448,16.921,640,642,3651
2016,3399,15142,15539,263231,263214,1498,9.759,1120,7.296,26049,7137,18912,2.711,9.897,25916,8383,17533,3.185,9.846,133,0.051,19.692,858,858,5436
2016,4231,15244,22973,400574,397205,1483,6.442,1577,6.851,40831,11797,29034,2.97,10.28,33718,11144,22574,2.806,8.489,7113,1.791,16.978,1039,1056,5896
2016,4232,9867,11787,154860,153079,985,8.395,878,7.483,18041,4932,13109,3.222,11.785,14533,5152,9381,3.366,9.494,3508,2.292,18.988,648,655,3522
2016,4233,9441,16372,230430,222454,1335,8.249,958,5.92,36139,13755,22384,6.183,16.246,20521,7570,12951,3.403,9.225,15618,7.021,18.45,568,590,3916
2016,4234,21309,32516,651050,650528,2929,9.044,2672,8.25,78028,22305,55723,3.429,11.995,76058,27988,48070,4.302,11.692,1970,0.303,23.383,1476,1503,8439
2016,4235,6854,9550,151824,154743,394,4.076,626,6.476,11803,2753,9050,1.779,7.628,17686,4209,13477,2.72,11.429,-5883,-3.802,15.255,401,413,2544
2016,4236,17986,27966,563961,558560,1857,6.634,1910,6.823,76704,21171,55533,3.79,13.732,65602,22298,43304,3.992,11.745,11102,1.988,23.49,1190,1229,7486
2016,4237,9925,18800,243105,238858,1012,5.391,958,5.103,28750,9582,19168,4.012,12.036,20329,8816,11513,3.691,8.511,8421,3.526,17.022,492,502,3105
2016,4238,38144,56133,762458,765215,2995,5.33,3119,5.55,70801,20205,50596,2.64,9.252,76605,20561,56044,2.687,10.011,-5804,-0.758,18.505,1923,2043,11138
2016,4239,27073,30491,323593,329074,2738,8.904,3256,10.589,36249,12390,23859,3.765,11.015,47059,15054,32005,4.575,14.3,-10810,-3.285,22.031,2493,2527,10731
2016,4241,7002,9447,152378,150566,686,7.202,842,8.84,21429,10727,10702,7.124,14.232,18628,8923,9705,5.926,12.372,2801,1.86,24.744,471,592,5368
2016,4242,6258,9679,318183,315758,874,9.057,816,8.456,38948,13120,25828,4.155,12.335,33466,9743,23723,3.086,10.599,5482,1.736,21.197,523,527,4042
2016,4243,13207,14334,200458,200600,1368,9.465,1605,11.105,24128,6614,17514,3.297,12.028,24325,9223,15102,4.598,12.126,-197,-0.098,24.056,1281,1293,6305
2016,4244,24808,32647,812407,809682,2726,8.381,2486,7.643,76863,20055,56808,2.477,9.493,70738,26333,44405,3.252,8.737,6125,0.756,17.473,1841,1866,12499
2016,4245,3214,6090,64180,64043,284,4.653,311,5.095,6512,1582,4930,2.47,10.168,6323,1531,4792,2.391,9.873,189,0.295,19.746,166,171,888
2016,4246,7753,12279,159585,158421,753,6.161,639,5.228,17065,5763,11302,3.638,10.772,14844,3660,11184,2.31,9.37,2221,1.402,18.74,428,446,2242
2016,4247,3975,6306,98074,99932,346,5.461,406,6.408,12193,4273,7920,4.276,12.201,15979,3853,12126,3.856,15.99,-3786,-3.789,24.403,196,247,1821
2016,4248,3230,4255,202271,200470,380,9.027,289,6.865,19474,5577,13897,2.782,9.714,15803,3154,12649,1.573,7.883,3671,1.831,15.766,228,229,2101
2016,4249,20208,26650,351534,348527,2058,7.674,2392,8.92,38909,10256,28653,2.943,11.164,33339,10669,22670,3.061,9.566,5570,1.598,19.131,1533,1546,6234
2016,4251,34022,36410,293336,291999,3640,9.923,4185,11.409,40828,9783,31045,3.35,13.982,38076,14577,23499,4.992,13.04,2752,0.942,26.08,3241,3276,10381
2016,4411,37605,43781,1296936,1272374,3764,8.639,3341,7.668,139254,46634,92620,3.665,10.944,90435,32361,58074,2.543,7.108,48819,3.837,14.215,2623,2675,25683
2016,4412,11195,12881,144684,141687,891,6.919,885,6.872,18560,5703,12857,4.025,13.099,12640,4988,7652,3.52,8.921,5920,4.178,17.842,657,669,3835
2016,4413,26236,55934,528992,527946,2682,4.788,2854,5.095,45084,14116,30968,2.674,8.54,42825,14000,28825,2.652,8.112,2259,0.428,16.223,1726,1772,7031
2016,4421,12905,22361,209308,205815,1408,6.288,1471,6.569,25839,7589,18250,3.687,12.554,18667,5933,12734,2.883,9.07,7172,3.485,18.14,998,1087,4210
2016,4422,17513,25607,247401,246592,1740,6.769,1934,7.524,27887,11689,16198,4.74,11.309,25888,9794,16094,3.972,10.498,1999,0.811,20.997,1195,1218,3792
2016,4431,20297,39354,379008,384470,2266,5.659,3646,9.105,34382,9092,25290,2.365,8.943,45108,17545,27563,4.563,11.733,-10726,-2.79,17.885,2508,2841,13695
2016,4441,34167,56452,1172486,1148658,2459,4.354,2499,4.425,97957,17121,80836,1.491,8.528,50784,12886,37898,1.122,4.421,47173,4.107,8.842,1770,1838,8355
2016,4442,12476,16511,154030,150755,991,6.02,894,5.431,20120,5004,15116,3.319,13.346,13633,3350,10283,2.222,9.043,6487,4.303,18.086,686,699,2441
2016,4451,60019,86579,2836376,2821214,8249,9.554,7771,9,265553,103883,161670,3.682,9.413,234693,83053,151640,2.944,8.319,30860,1.094,16.638,5674,5732,27425
2016,4452,16498,20324,166597,162368,2524,12.472,2350,11.612,33523,14508,19015,8.935,20.646,24939,10116,14823,6.23,15.36,8584,5.287,30.719,1564,1606,7723
2016,4453,27738,31744,166450,164120,2620,8.311,2181,6.918,24125,9268,14857,5.647,14.7,19420,6911,12509,4.211,11.833,4705,2.867,23.666,1751,1771,5615
2016,4461,39766,92783,1044461,1039897,10062,11.105,5713,6.305,167273,63995,103278,6.154,16.086,157728,47778,109950,4.594,15.168,9545,0.918,30.335,3173,3353,16874
2016,4471,61871,107531,947558,937457,7176,6.678,7035,6.547,126189,46730,79459,4.985,13.461,106149,36384,69765,3.881,11.323,20040,2.138,22.646,4626,4919,23429
2016,4481,32088,91944,1376468,1367339,6815,7.368,7912,8.554,179060,58967,120093,4.313,13.096,163803,50080,113723,3.663,11.98,15257,1.116,23.959,3491,4972,22226
2016,4482,4995,24366,239859,237098,1129,4.625,1214,4.974,31832,8985,22847,3.79,13.426,25870,7789,18081,3.285,10.911,5962,2.515,21.822,437,505,2566
2016,4483,14569,21596,126544,128234,1191,5.471,1538,7.065,11602,4159,7443,3.243,9.048,14955,4891,10064,3.814,11.662,-3353,-2.615,18.095,1071,1092,2744
2016,4511,24572,35638,475867,476850,2860,8.044,2690,7.566,50173,19009,31164,3.986,10.522,53371,12105,41266,2.539,11.192,-3198,-0.671,21.044,2084,2130,7722
2016,4512,3287,7135,88776,91605,416,5.749,617,8.527,7910,2211,5699,2.414,8.635,13667,4174,9493,4.557,14.92,-5757,-6.285,17.27,310,312,986
2016,4522,24,4881,526909,543998,14,0.285,67,1.365,23681,1378,22303,0.253,4.353,59429,3586,55843,0.659,10.924,-35748,-6.571,8.706,(D),(D),(D)
2016,4523,7106,47185,2392578,2363985,2239,4.789,1377,2.945,156472,36791,119681,1.556,6.619,97920,11880,86040,0.503,4.142,58552,2.477,8.284,881,1066,5459
2016,4531,11599,12145,59108,59120,950,7.751,1174,9.578,8439,2769,5670,4.684,14.274,8516,3161,5355,5.347,14.405,-77,-0.13,28.549,944,952,2633
2016,4532,16735,26469,227492,228224,2381,8.945,2680,10.068,32755,13519,19236,5.924,14.352,34377,15569,18808,6.822,15.063,-1622,-0.711,28.704,1700,1802,6082
2016,4533,12897,19145,208410,203726,1715,8.999,1540,8.081,30745,9816,20929,4.818,15.091,21037,6459,14578,3.17,10.326,9708,4.765,20.652,1231,1236,4364
2016,4539,32558,43323,283491,274515,5631,13.307,3617,8.548,48490,20946,27544,7.63,17.664,30705,11729,18976,4.273,11.185,17785,6.479,22.37,2875,2939,9153
2016,4541,30409,31768,466937,461835,5885,19.159,3781,12.31,82397,37878,44519,8.202,17.841,71498,34677,36821,7.509,15.481,10899,2.36,30.963,2877,2889,13146
2016,4542,2981,3399,39867,39692,310,9.05,363,10.597,3914,1202,2712,3.028,9.861,3580,1364,2216,3.436,9.019,334,0.841,18.039,298,304,1019
2016,4543,20961,26168,173810,172027,2835,10.945,2303,8.891,25442,10714,14728,6.228,14.79,21597,8072,13525,4.692,12.554,3845,2.235,25.109,1734,1753,5612
2016,4811,413,2169,428198,422513,152,6.974,173,7.938,60302,2527,57775,0.598,14.272,49334,35838,13496,8.482,11.676,10968,2.596,23.353,35,117,34537
2016,4812,1807,2016,37563,36980,185,9.086,225,11.051,4766,1054,3712,2.85,12.888,3645,1034,2611,2.796,9.857,1121,3.031,19.713,172,174,533
2016,4831,616,956,42900,43644,92,9.664,84,8.824,3933,1263,2670,2.894,9.012,5447,937,4510,2.147,12.481,-1514,-3.469,18.023,58,59,314
2016,4832,404,472,22566,22823,43,9.005,54,11.309,1630,306,1324,1.341,7.142,2161,237,1924,1.038,9.469,-531,-2.327,14.284,40,40,182
2016,4841,54063,64916,983467,968318,11037,17.346,8462,13.299,126604,53257,73347,5.5,13.075,97448,35029,62419,3.618,10.064,29156,3.011,20.127,6230,6266,21590
2016,4842,38723,42659,485148,489716,5306,12.491,4944,11.639,71730,23205,48525,4.738,14.647,80885,27165,53720,5.547,16.517,-9155,-1.869,29.295,3516,3532,17064
2016,4851,462,738,53209,53163,50,6.729,60,8.075,3724,538,3186,1.012,7.005,3643,1008,2635,1.896,6.853,81,0.152,13.705,35,35,364
2016,4852,282,490,13451,13056,44,9.053,36,7.407,2140,370,1770,2.834,16.391,1285,240,1045,1.838,9.842,855,6.549,19.684,24,25,215
2016,4853,6837,7001,77602,77477,1102,15.735,1107,15.806,13419,4401,9018,5.68,17.32,13552,4935,8617,6.37,17.492,-133,-0.172,34.64,907,910,3591
2016,4854,2503,4231,242913,236214,365,8.723,272,6.5,30277,8288,21989,3.509,12.818,16658,5065,11593,2.144,7.052,13619,5.766,14.104,165,165,2156
2016,4855,1112,1242,34221,34140,119,9.467,149,11.854,4530,1028,3502,3.011,13.269,4428,1483,2945,4.344,12.97,102,0.299,25.941,109,110,776
2016,4859,3915,4423,93143,90490,768,17.9,503,11.724,16282,5742,10540,6.345,17.993,10897,4632,6265,5.119,12.042,5385,5.951,24.085,385,388,3375
2016,4861,79,782,14311,14140,60,7.747,45,5.81,2176,786,1390,5.559,15.389,1813,344,1469,2.433,12.822,363,2.567,25.644,7,7,54
2016,4862,115,2154,29998,29602,72,3.35,62,2.885,2617,1264,1353,4.27,8.841,1806,432,1374,1.459,6.101,811,2.74,12.202,8,8,23
2016,4869,72,697,8480,8243,23,3.295,25,3.582,1380,205,1175,2.487,16.742,904,393,511,4.768,10.968,476,5.775,21.935,(D),(D),(D)
2016,4871,559,610,11897,11622,91,15.256,64,10.729,2133,456,1677,3.924,18.353,1534,590,944,5.077,13.199,599,5.154,26.398,44,44,544
2016,4872,1263,1306,14593,13838,181,14.064,143,11.111,2740,554,2186,4.004,19.801,1174,591,583,4.271,8.484,1566,11.317,16.968,97,97,477
2016,4879,172,194,2697,2520,32,17.391,12,6.522,658,148,510,5.873,26.111,287,54,233,2.143,11.389,371,14.722,22.778,8,8,48
2016,4881,3796,5568,182303,178302,465,8.432,358,6.492,23699,5161,18538,2.895,13.292,15401,5224,10177,2.93,8.638,8298,4.654,17.275,212,215,1425
2016,4882,505,1396,42055,40809,89,6.387,84,6.028,6299,875,5424,2.144,15.436,3890,1423,2467,3.487,9.532,2409,5.903,19.065,26,28,201
2016,4883,1806,2389,93489,95701,198,8.323,178,7.482,8236,935,7301,0.977,8.606,12803,3101,9702,3.24,13.378,-4567,-4.772,17.212,119,120,551
2016,4884,9263,10889,101675,98837,1564,14.69,1079,10.135,19768,8904,10864,9.009,20.001,13911,5549,8362,5.614,14.075,5857,5.926,28.15,771,778,3237
2016,4885,13827,19633,256294,255049,1567,7.96,1674,8.503,32162,8996,23166,3.527,12.61,29359,13954,15405,5.471,11.511,2803,1.099,23.022,903,946,5575
2016,4889,1359,1487,16567,16559,225,15.385,176,12.034,2612,1117,1495,6.746,15.774,2614,1024,1590,6.184,15.786,-2,-0.012,31.549,136,143,786
2016,4921,3826,9666,566979,561225,1043,10.751,1113,11.473,49516,21197,28319,3.777,8.823,36735,13693,23042,2.44,6.546,12781,2.277,13.091,554,556,2609
2016,4922,3565,4076,44182,41842,578,14.089,631,15.381,11177,4519,6658,10.8,26.712,6508,3140,3368,7.504,15.554,4669,11.159,31.107,542,545,2540
2016,4931,7279,15288,831609,810985,1538,10.248,979,6.523,112699,37316,75383,4.601,13.897,73395,23332,50063,2.877,9.05,39304,4.846,18.1,372,401,4135
2016,5111,11266,16076,370027,380864,1292,8.03,1318,8.192,31816,11984,19832,3.147,8.354,53552,15468,38084,4.061,14.061,-21736,-5.707,16.707,803,868,5749
2016,5112,6961,10061,526975,510120,1537,15.747,936,9.59,87894,40234,47660,7.887,17.23,54214,15236,38978,2.987,10.628,33680,6.602,21.255,527,614,5914
2016,5121,14044,17347,387904,388988,2484,14.47,2122,12.362,63198,18105,45093,4.654,16.247,63938,21997,41941,5.655,16.437,-740,-0.19,32.494,1370,1385,6583
2016,5122,2741,2947,23173,25648,355,12.032,362,12.269,2493,813,1680,3.17,9.72,7247,1597,5650,6.227,28.256,-4754,-18.536,19.44,262,262,660
2016,5151,3922,7368,213414,214973,465,6.142,871,11.504,23883,8225,15658,3.826,11.11,27336,14331,13005,6.666,12.716,-3453,-1.606,22.22,211,217,1741
2016,5152,390,716,51551,52052,46,6.393,53,7.366,3465,1245,2220,2.392,6.657,4503,1008,3495,1.937,8.651,-1038,-1.994,13.314,21,21,49
2016,5173,5081,52363,1003371,989713,7471,14.962,2609,5.225,126540,64332,62208,6.5,12.786,100299,35142,65157,3.551,10.134,26241,2.651,20.268,283,298,2059
2016,5174,321,397,8463,8487,49,12.129,63,15.594,1246,350,896,4.124,14.681,1284,464,820,5.467,15.129,-38,-0.448,29.363,43,43,142
2016,5179,3438,4165,59237,58045,756,18.45,621,15.156,12051,4517,7534,7.782,20.762,9649,3745,5904,6.452,16.623,2402,4.138,33.247,484,502,2714
2016,5182,9053,13361,486740,482050,1517,11.446,1303,9.831,66423,18455,47968,3.828,13.779,56663,23131,33532,4.798,11.755,9760,2.025,23.509,828,842,9339
2016,5191,8382,10734,285054,277848,1489,13.997,1297,12.192,45857,12408,33449,4.466,16.504,31715,9705,22010,3.493,11.415,14142,5.09,22.829,976,987,5637
2016,5211,13,59,19366,19277,(D),(D),0,0,717,(D),716,(D),3.719,513,0,513,0,2.661,204,1.058,5.322,0,0,0
2016,5221,11349,118291,1969282,1938207,3952,3.335,4354,3.675,233647,44466,189181,2.294,12.055,177285,31557,145728,1.628,9.147,56362,2.908,18.294,392,567,6219
2016,5222,13355,43250,618815,599873,5034,11.884,3256,7.686,108656,28392,80264,4.733,18.113,70792,21339,49453,3.557,11.801,37864,6.312,23.602,1062,1214,8398
2016,5223,11662,27049,287478,280268,2212,8.123,2577,9.463,45022,10322,34700,3.683,16.064,31024,12013,19011,4.286,11.069,13998,4.995,22.139,1089,1215,7025
2016,5231,10815,39747,403732,402709,3247,8.182,3121,7.865,46166,14421,31745,3.581,11.464,44505,10899,33606,2.706,11.051,1661,0.412,22.103,825,844,3144
2016,5232,10,32,6246,6166,(D),(D),(D),(D),287,(D),279,(D),4.655,139,(D),98,(D),2.254,148,2.4,4.509,0,0,0
2016,5239,43516,51890,492514,486882,8328,16.562,5113,10.169,68713,28529,40184,5.86,14.113,56718,21680,35038,4.453,11.649,11995,2.464,23.298,3550,3579,10789
2016,5241,4769,35990,1556501,1524141,8196,24.315,3631,10.772,214073,81553,132520,5.351,14.045,145905,33619,112286,2.206,9.573,68168,4.473,19.146,279,289,2238
2016,5242,119356,135306,982740,955080,11806,8.77,10421,7.741,173509,88404,85105,9.256,18.167,117371,45879,71492,4.804,12.289,56138,5.878,24.578,7351,7486,24644
2016,5259,672,697,6110,7815,141,20.244,140,20.101,1428,1019,409,13.04,18.274,4989,1082,3907,13.846,63.843,-3561,-45.569,36.547,113,113,470
2016,5311,86971,116537,577672,575680,11879,10.279,9930,8.593,91328,41365,49963,7.185,15.864,87224,38893,48331,6.756,15.151,4104,0.713,30.303,7171,7282,24687
2016,5312,72314,84452,301418,291038,15130,18.59,9005,11.064,64519,35345,29174,12.144,22.169,43812,18725,25087,6.434,15.054,20707,7.115,30.107,5116,5182,10563
2016,5313,65993,82515,676023,663502,10642,13.093,8168,10.049,114123,50174,63949,7.562,17.2,89714,37841,51873,5.703,13.521,24409,3.679,27.043,4983,5039,21450
2016,5321,3530,15396,166128,165031,1477,9.694,1159,7.606,20481,9574,10907,5.801,12.41,18617,4325,14292,2.621,11.281,1864,1.129,22.562,337,356,1621
2016,5322,7095,18005,144108,143335,1014,5.596,1241,6.849,17536,5731,11805,3.998,12.234,16063,6749,9314,4.709,11.207,1473,1.028,22.413,700,749,3485
2016,5323,2194,2640,19228,18895,169,6.391,178,6.731,2880,809,2071,4.282,15.243,2187,728,1459,3.853,11.575,693,3.668,23.15,131,132,486
2016,5324,7275,14064,181695,182062,1421,10.255,1005,7.253,28650,11159,17491,6.129,15.736,29258,7273,21985,3.995,16.07,-608,-0.334,31.473,573,602,3291
2016,5331,2020,2233,35818,34858,241,10.824,228,10.24,5831,1378,4453,3.953,16.728,4032,1188,2844,3.408,11.567,1799,5.161,23.134,180,180,1047
2016,5411,157362,169170,1137612,1138470,13301,7.858,13489,7.969,112230,35639,76591,3.13,9.858,114029,37151,76878,3.263,10.016,-1799,-0.158,19.716,10172,10265,27626
2016,5412,99589,119477,1253526,1245452,10027,8.398,9868,8.265,166388,51546,114842,4.139,13.36,149862,58535,91327,4.7,12.033,16526,1.327,24.065,6537,6726,34734
2016,5413,81384,101136,1457017,1456036,9231,9.144,8854,8.771,184132,50205,133927,3.448,12.646,183085,57796,125289,3.969,12.574,1047,0.072,25.148,5142,5193,22878
2016,5414,26174,26569,119856,117058,3859,14.735,3098,11.83,21296,8825,12471,7.539,18.193,15671,6800,8871,5.809,13.387,5625,4.805,26.775,2241,2245,5140
2016,5415,99247,122268,1826214,1779759,21176,17.703,15881,13.276,326402,108289,218113,6.084,18.34,233112,74180,158932,4.168,13.098,93290,5.242,26.196,10699,10790,43773
2016,5416,122040,132929,1238275,1204863,23466,17.821,20958,15.916,248675,104577,144098,8.68,20.639,181899,79906,101993,6.632,15.097,66776,5.542,30.194,15241,15292,54997
2016,5417,12934,16420,668399,661576,2212,13.6,1901,11.688,80110,26754,53356,4.044,12.109,66809,18111,48698,2.738,10.098,13301,2.011,20.197,1092,1108,7140
2016,5418,29209,33345,475397,468708,3973,11.99,3555,10.729,84876,35372,49504,7.547,18.109,71453,19597,51856,4.181,15.245,13423,2.864,30.489,2620,2648,12824
2016,5419,54142,61085,634055,622385,6901,11.46,5167,8.58,95636,33612,62024,5.401,15.366,72561,27416,45145,4.405,11.659,23075,3.708,23.317,3849,3891,18911
2016,5511,26881,54465,3394250,3378513,5060,9.418,3586,6.674,462147,132610,329537,3.925,13.679,432819,100141,332678,2.964,12.811,29328,0.868,25.622,704,741,12684
2016,5611,25540,28159,452690,440866,3600,12.951,2876,10.346,84008,26532,57476,6.018,19.055,60333,22009,38324,4.992,13.685,23675,5.37,27.37,2206,2234,16961
2016,5612,1832,6462,246453,251873,915,14.406,694,10.927,43012,17623,25389,6.997,17.077,52101,12168,39933,4.831,20.685,-9089,-3.609,34.154,109,112,2050
2016,5613,24406,48672,5770021,5739986,5462,11.39,4027,8.398,1070830,258855,811975,4.51,18.656,1007912,288261,719651,5.022,17.559,62918,1.096,35.119,2187,2229,114235
2016,5614,22553,29508,797170,792567,2838,9.595,2977,10.065,116182,36281,79901,4.578,14.659,107143,30041,77102,3.79,13.518,9039,1.14,27.037,2239,2272,16510
2016,5615,12750,22062,227935,229098,3035,13.897,2588,11.851,38628,18585,20043,8.112,16.861,40592,14622,25970,6.382,17.718,-1964,-0.857,33.722,938,952,4275
2016,5616,17810,23738,936107,923173,2327,9.843,2133,9.022,117571,30013,87558,3.251,12.736,91933,30205,61728,3.272,9.958,25638,2.777,19.917,1446,1478,19470
2016,5617,150982,158657,1883923,1848686,23615,15.226,16489,10.632,303104,101056,202048,5.466,16.396,230333,71581,158752,3.872,12.459,72771,3.936,24.919,11702,11721,50552
2016,5619,15603,17690,286355,278157,1884,10.755,1540,8.791,50985,15360,35625,5.522,18.33,34546,9213,25333,3.312,12.42,16439,5.91,24.839,1135,1141,6053
2016,5621,7174,11051,203909,201824,1144,10.602,622,5.765,25733,9521,16212,4.717,12.75,21844,4382,17462,2.171,10.823,3889,1.927,21.647,476,486,3415
2016,5622,1239,2536,52756,51660,158,6.267,128,5.077,6310,1417,4893,2.743,12.215,4229,1124,3105,2.176,8.186,2081,4.028,16.373,85,85,533
2016,5629,8418,9889,131544,132675,917,9.345,765,7.796,20303,5452,14851,4.109,15.303,22464,7559,14905,5.697,16.932,-2161,-1.629,30.606,512,537,4276
2016,6111,18809,21538,1023370,1008317,942,4.364,1038,4.809,86661,17026,69635,1.689,8.595,56265,16936,39329,1.68,5.58,30396,3.015,11.16,632,645,11983
2016,6112,448,993,73762,76082,29,2.891,49,4.885,4127,439,3688,0.577,5.424,8780,2455,6325,3.227,11.54,-4653,-6.116,10.849,21,34,2169
2016,6113,2364,4370,1865577,1868525,146,3.269,339,7.59,79606,3490,76116,0.187,4.26,84515,8345,76170,0.447,4.523,-4909,-0.263,8.521,72,121,5497
2016,6114,6492,6978,59407,58974,804,11.557,762,10.953,9781,2927,6854,4.963,16.585,8867,3462,5405,5.87,15.036,914,1.55,30.071,527,530,2335
2016,6115,6079,7689,109546,109997,669,8.675,715,9.271,15821,3662,12159,3.329,14.383,16603,6825,9778,6.205,15.094,-782,-0.711,28.766,415,483,5353
2016,6116,41402,44667,421425,410821,5880,13.424,4153,9.481,81648,31910,49738,7.767,19.874,60467,19646,40821,4.782,14.719,21181,5.156,29.437,3132,3165,13998
2016,6117,6372,7258,109115,107198,1225,17.345,834,11.809,22419,7146,15273,6.666,20.914,18803,9834,8969,9.174,17.54,3616,3.373,35.081,571,576,3818
2016,6211,157780,207316,2498462,2449687,17412,8.421,16294,7.881,365502,138978,226524,5.673,14.92,266146,102966,163180,4.203,10.864,99356,4.056,21.729,11633,12009,60283
2016,6212,119206,129082,922710,914480,7122,5.527,6669,5.176,110889,38280,72609,4.186,12.126,94503,32032,62471,3.503,10.334,16386,1.792,20.668,5579,5652,27194
2016,6213,119608,138973,844273,826893,13523,9.86,9870,7.197,138194,48718,89476,5.892,16.712,103635,43035,60600,5.204,12.533,34559,4.179,25.066,7019,7185,25543
2016,6214,16370,41499,976372,951874,3487,8.572,1849,4.545,126081,45315,80766,4.761,13.246,76724,21498,55226,2.258,8.06,49357,5.185,16.121,960,1039,10524
2016,6215,7024,16645,288923,284424,1550,9.425,1152,7.005,39658,12631,27027,4.441,13.943,30526,8821,21705,3.101,10.733,9132,3.211,21.465,617,630,5556
2016,6216,20720,30465,1422134,1392943,3721,12.486,2392,8.027,209249,50166,159083,3.601,15.022,149995,39561,110434,2.84,10.768,59254,4.254,21.536,1643,1675,25831
2016,6219,6220,10279,296123,296039,1358,13.59,785,7.856,45754,19064,26690,6.44,15.455,44936,15553,29383,5.254,15.179,818,0.276,30.358,489,517,6256
2016,6221,2483,5026,5205546,5157729,79,1.57,90,1.789,227905,19186,208719,0.372,4.419,134193,25335,108858,0.491,2.602,93712,1.817,5.204,36,36,5336
2016,6222,412,635,236502,232184,24,3.81,14,2.222,17777,2579,15198,1.111,7.656,9419,1594,7825,0.687,4.057,8358,3.6,8.113,9,9,756
2016,6223,348,952,291690,288543,25,2.634,19,2.002,14840,1861,12979,0.645,5.143,8468,2148,6320,0.744,2.935,6372,2.208,5.869,13,13,1337
2016,6231,8406,16463,1677080,1677092,995,6.082,788,4.817,145720,64080,81640,3.821,8.689,144423,57008,87415,3.399,8.612,1297,0.077,17.223,513,524,36622
2016,6232,9891,41641,764142,760018,2949,7.227,1279,3.134,92916,28134,64782,3.702,12.226,84610,15836,68774,2.084,11.133,8306,1.093,22.265,362,410,5006
2016,6233,16500,23434,931455,920058,2053,8.858,1537,6.632,98661,32528,66133,3.535,10.723,76894,24800,52094,2.695,8.358,21767,2.366,16.715,1138,1180,18431
2016,6239,2964,4885,131225,130459,392,8.079,326,6.719,14312,3295,11017,2.526,10.97,12774,3044,9730,2.333,9.792,1538,1.179,19.583,168,180,1298
2016,6241,58677,76757,1692465,1666014,10042,13.398,6426,8.574,238385,64841,173544,3.892,14.309,187532,42352,145180,2.542,11.256,50853,3.052,22.513,4419,4481,29496
2016,6242,10175,14333,199701,194881,764,5.369,560,3.935,29688,4951,24737,2.541,15.234,19914,3814,16100,1.957,10.219,9774,5.015,20.437,267,308,1533
2016,6243,3961,7558,319021,321928,418,5.564,328,4.366,34178,7510,26668,2.333,10.617,39867,5771,34096,1.793,12.384,-5689,-1.767,21.233,149,154,2467
2016,6244,55741,71271,931692,913946,6813,9.636,5684,8.039,128039,43667,84372,4.778,14.009,92332,35650,56682,3.901,10.103,35707,3.907,20.205,4242,4346,27191
2016,7111,7285,7430,125441,123644,886,12.045,737,10.02,19611,5206,14405,4.21,15.861,15934,4344,11590,3.513,12.887,3677,2.974,25.774,500,500,3095
2016,7112,3231,3414,135839,132121,415,12.177,403,11.825,19635,4082,15553,3.09,14.861,12165,2238,9927,1.694,9.208,7470,5.654,18.415,318,319,1876
2016,7113,6273,6715,171609,168003,804,12.143,616,9.304,23131,5770,17361,3.434,13.768,15735,3497,12238,2.082,9.366,7396,4.402,18.732,453,453,2508
2016,7114,3033,3209,20371,20131,512,16.332,364,11.611,3345,1313,2032,6.522,16.616,2844,1229,1615,6.105,14.127,501,2.489,28.255,253,255,794
2016,7115,15823,15867,46781,46839,3110,20.046,2404,15.496,11483,6566,4917,14.018,24.516,11643,5577,6066,11.907,24.857,-160,-0.342,49.032,1488,1488,3791
2016,7121,6652,7134,150807,148296,355,5.003,279,3.932,12593,1178,11415,0.794,8.492,7551,1079,6472,0.728,5.092,5042,3.4,10.184,188,188,769
2016,7131,2398,2781,204497,201591,444,16.33,320,11.769,18788,7653,11135,3.796,9.32,12589,3939,8650,1.954,6.245,6199,3.075,12.49,267,271,2987
2016,7132,1757,2886,152384,152618,263,9.185,218,7.613,9057,2761,6296,1.809,5.934,9432,2421,7011,1.586,6.18,-375,-0.246,11.869,144,157,1526
2016,7139,52695,60948,1305645,1277223,7654,12.776,5578,9.311,191629,66761,124868,5.227,15.004,133448,50562,82886,3.959,10.448,58181,4.555,20.897,4295,4332,37212
2016,7211,41112,52310,2007098,1995317,5014,9.658,4220,8.129,213437,96775,116662,4.85,10.697,190106,81663,108443,4.093,9.528,23331,1.169,19.055,2837,2880,46907
2016,7212,5387,5990,44557,44096,498,8.345,454,7.607,6761,1574,5187,3.57,15.333,5758,1677,4081,3.803,13.058,1003,2.275,26.116,317,318,1167
2016,7213,1693,1884,10919,10999,109,5.741,138,7.269,1540,256,1284,2.327,14.001,1690,498,1192,4.528,15.365,-150,-1.364,28.003,97,97,279
2016,7223,14796,37924,789707,751401,7767,21.729,3410,9.54,211046,124110,86936,16.517,28.087,136195,38362,97833,5.105,18.125,74851,9.962,36.251,1636,1651,9214
2016,7224,36561,37490,372938,368379,3907,10.414,3961,10.558,67970,32669,35301,8.868,18.451,58936,25718,33218,6.981,15.999,9034,2.452,31.998,3353,3379,22371
2016,7225,368398,510025,10486357,10296982,54074,10.741,40904,8.125,1585783,768387,817396,7.462,15.4,1208788,443196,765592,4.304,11.739,376995,3.661,23.478,32734,33737,338995
2016,8111,135154,149258,891018,878641,12856,8.652,11527,7.757,129271,47155,82116,5.367,14.713,104410,41290,63120,4.699,11.883,24861,2.829,23.766,8706,8828,31275
2016,8112,9896,11240,101433,99949,1330,11.904,1195,10.696,16980,5100,11880,5.103,16.989,13993,4612,9381,4.614,14,2987,2.989,28,909,917,3076
2016,8113,18219,20043,198063,198465,1737,8.695,1604,8.029,27606,9351,18255,4.712,13.91,28063,7739,20324,3.899,14.14,-457,-0.23,27.82,1179,1190,4164
2016,8114,17557,18344,71028,70209,2248,12.379,1881,10.358,11727,5042,6685,7.181,16.703,10105,4474,5631,6.372,14.393,1622,2.31,28.785,1428,1432,3434
2016,8121,98742,115683,699347,685221,15300,13.418,11992,10.517,128619,62279,66340,9.089,18.77,100689,43294,57395,6.318,14.694,27930,4.076,29.389,9537,9676,35336
2016,8122,14154,20196,139949,139474,714,3.542,636,3.155,11386,2476,8910,1.775,8.164,10357,2048,8309,1.468,7.426,1029,0.738,14.852,429,445,1518
2016,8123,27158,32404,295753,297655,2429,7.455,2789,8.559,33750,12083,21667,4.059,11.339,37976,17890,20086,6.01,12.758,-4226,-1.42,22.677,2162,2256,9612
2016,8129,29379,39261,309890,301828,5988,15.576,4354,11.326,59443,23309,36134,7.723,19.694,42622,18615,24007,6.167,14.121,16821,5.573,28.243,2620,2661,10009
2016,8131,178365,178912,1688326,1683545,8368,4.693,7198,4.036,141245,23687,117558,1.407,8.39,132118,22735,109383,1.35,7.848,9127,0.542,15.695,4710,4710,15664
2016,8132,16978,18988,194539,190390,1515,8.072,1074,5.723,27276,12041,15235,6.324,14.326,19145,8317,10828,4.368,10.056,8131,4.271,20.111,780,787,2112
2016,8133,14286,16905,175209,173014,1341,8.007,1026,6.126,22027,5129,16898,2.964,12.731,17518,4717,12801,2.726,10.125,4509,2.606,20.25,656,662,2369
2016,8134,22796,24742,243234,241999,1492,6.057,1272,5.164,26343,5755,20588,2.378,10.886,24028,5484,18544,2.266,9.929,2315,0.957,19.858,853,856,3409
2016,8139,53583,55759,491969,489377,2616,4.694,2570,4.611,48550,9711,38839,1.984,9.921,43491,11398,32093,2.329,8.887,5059,1.034,17.774,1889,1891,7546
2017,1131,413,448,3822,4016,58,13.303,34,7.798,417,142,275,3.536,10.383,793,358,435,8.914,19.746,-376,-9.363,20.767,20,20,74
2017,1132,121,137,1120,1194,15,10.909,16,11.636,137,50,87,4.188,11.474,285,31,254,2.596,23.869,-148,-12.395,22.948,8,8,18
2017,1133,7115,7210,48645,49523,599,8.222,749,10.281,5977,1702,4275,3.437,12.069,7740,2403,5337,4.852,15.629,-1763,-3.56,24.138,531,531,1705
2017,1141,1318,1335,5510,5320,234,17.727,204,15.455,1281,571,710,10.733,24.079,861,341,520,6.41,16.184,420,7.895,32.368,128,128,216
2017,1142,309,311,1679,1701,41,13.465,28,9.195,214,70,144,4.116,12.585,252,90,162,5.293,14.819,-38,-2.235,25.169,22,22,69
2017,1151,3754,4095,68433,66346,464,11.441,385,9.493,13759,4232,9527,6.379,20.738,9540,3455,6085,5.208,14.379,4219,6.359,28.759,253,253,2416
2017,1152,3926,4014,20411,20168,497,12.489,428,10.755,3104,1092,2012,5.415,15.391,2644,1076,1568,5.335,13.11,460,2.281,26.22,339,339,856
2017,1153,1338,1445,12240,12008,207,14.619,149,10.523,2814,973,1841,8.103,23.434,2337,536,1801,4.464,19.462,477,3.972,38.924,104,104,272
2017,2111,4605,5892,111045,113397,391,6.346,929,15.079,16947,6487,10460,5.721,14.945,21802,11184,10618,9.863,19.226,-4855,-4.281,29.89,529,547,2787
2017,2121,332,660,49847,51471,48,6.946,110,15.919,7080,3283,3797,6.378,13.755,10349,2108,8241,4.096,20.106,-3269,-6.351,27.511,54,56,609
2017,2122,181,245,37056,37562,29,11.417,47,18.504,3611,1097,2514,2.921,9.613,4672,1973,2699,5.253,12.438,-1061,-2.825,19.227,29,29,137
2017,2123,2496,4618,85891,83446,245,5.279,291,6.27,13833,1856,11977,2.224,16.577,9182,2689,6493,3.222,11.004,4651,5.574,22.007,141,143,920
2017,2131,9271,12235,298408,294680,1701,13.767,1943,15.725,63818,24674,39144,8.373,21.657,57040,22950,34090,7.788,19.357,6778,2.3,38.713,1212,1254,11353
2017,2211,1726,10868,512214,513614,686,6.361,518,4.803,37219,14054,23165,2.736,7.246,40053,7221,32832,1.406,7.798,-2834,-0.552,14.493,77,81,874
2017,2212,402,2498,90234,89156,169,6.748,182,7.267,9154,3047,6107,3.418,10.267,6836,3092,3744,3.468,7.668,2318,2.6,15.335,20,20,137
2017,2213,3448,4643,44501,44401,246,5.289,262,5.633,4895,1749,3146,3.939,11.025,4774,1250,3524,2.815,10.752,121,0.273,21.504,125,125,393
2017,2361,136464,137827,679957,664811,24166,17.86,19132,14.139,151809,65589,86220,9.866,22.835,121887,53662,68225,8.072,18.334,29922,4.501,36.668,13151,13158,37128
2017,2362,36610,38049,645125,634529,3502,9.192,3597,9.442,103395,19961,83434,3.146,16.295,82083,20178,61905,3.18,12.936,21312,3.359,25.872,2511,2513,13432
2017,2371,15951,17566,588108,588312,1373,7.775,1561,8.839,87152,14534,72618,2.47,14.814,87232,19689,67543,3.347,14.828,-80,-0.014,29.628,972,978,8510
2017,2372,3992,4093,21168,20983,393,9.55,437,10.62,3611,1377,2234,6.563,17.21,3306,1312,1994,6.253,15.756,305,1.454,31.512,322,322,990
2017,2373,7864,8718,294390,288625,501,5.712,606,6.91,43023,4663,38360,1.616,14.906,31631,5377,26254,1.863,10.959,11392,3.947,21.918,393,396,3619
2017,2379,3564,3685,66483,66155,391,10.639,371,10.095,11517,3235,8282,4.89,17.409,10908,2908,8000,4.396,16.489,609,0.921,32.977,250,253,1148
2017,2381,76926,77870,852373,840158,9724,12.582,8558,11.073,163063,40753,122310,4.851,19.409,138504,36147,102357,4.302,16.485,24559,2.923,32.971,5671,5679,24766
2017,2382,161494,166176,1981722,1949792,15927,9.678,12716,7.727,299481,59088,240393,3.03,15.36,235487,60640,174847,3.11,12.078,63994,3.282,24.155,8974,8992,41225
2017,2383,98134,99352,793761,777204,13406,13.678,10720,10.938,155249,44709,110540,5.753,19.975,122434,36912,85522,4.749,15.753,32815,4.222,31.506,7368,7378,26320
2017,2389,57201,58026,616373,603679,7061,12.306,5763,10.044,103318,25776,77542,4.27,17.115,77783,22293,55490,3.693,12.885,25535,4.23,25.77,3824,3825,15504
2017,3111,1089,1713,50250,50217,89,5.205,83,4.854,5234,1385,3849,2.758,10.423,5290,1358,3932,2.704,10.534,-56,-0.112,20.846,52,52,677
2017,3112,517,864,56652,56312,52,6.089,32,3.747,4619,732,3887,1.3,8.203,4019,463,3556,0.822,7.137,600,1.065,14.274,19,19,257
2017,3113,1655,1828,81645,81730,132,7.221,132,7.221,7095,1004,6091,1.228,8.681,7392,2061,5331,2.522,9.044,-297,-0.363,17.362,99,101,975
2017,3114,1410,1773,160263,159685,136,7.697,124,7.018,16511,2144,14367,1.343,10.34,15560,4492,11068,2.813,9.744,951,0.596,19.488,83,84,1133
2017,3115,1048,1549,145576,144504,111,7.184,103,6.667,13257,2074,11183,1.435,9.174,11246,3048,8198,2.109,7.783,2011,1.392,15.565,79,79,1683
2017,3116,2702,3334,509509,502574,169,5.054,189,5.652,39493,7402,32091,1.473,7.858,25715,5618,20097,1.118,5.117,13778,2.741,10.233,141,141,2235
2017,3117,400,495,31767,31152,30,5.982,43,8.574,3372,696,2676,2.234,10.824,2227,688,1539,2.209,7.149,1145,3.676,14.298,31,32,576
2017,3118,9703,10513,295151,292961,972,9.277,902,8.609,34552,8556,25996,2.921,11.794,30325,8991,21334,3.069,10.351,4227,1.443,20.702,709,720,5830
2017,3119,3051,3532,210536,205014,373,10.734,259,7.453,25763,5245,20518,2.558,12.566,14854,5470,9384,2.668,7.245,10909,5.321,14.491,183,188,3058
2017,3121,7279,7967,204092,192962,1258,16.622,461,6.091,34701,10091,24610,5.23,17.983,12218,3297,8921,1.709,6.332,22483,11.652,12.664,329,329,2015
2017,3122,132,156,13871,13764,21,13.505,20,12.862,1422,172,1250,1.25,10.332,1172,204,968,1.482,8.515,250,1.816,17.031,15,15,110
2017,3131,221,277,22858,23586,17,5.986,31,10.915,1605,366,1239,1.552,6.805,3210,1191,2019,5.05,13.61,-1605,-6.805,13.61,21,24,560
2017,3132,724,807,45843,46590,46,5.655,59,7.253,4017,802,3215,1.721,8.622,5466,1154,4312,2.477,11.732,-1449,-3.11,17.244,41,43,489
2017,3133,746,788,26854,27394,43,5.365,70,8.734,2085,668,1417,2.438,7.611,3188,1215,1973,4.435,11.638,-1103,-4.026,15.222,51,51,791
2017,3141,1459,1564,51569,52343,88,5.549,132,8.323,5163,1637,3526,3.127,9.864,6926,2562,4364,4.895,13.232,-1763,-3.368,19.728,101,102,534
2017,3149,3647,3744,56598,56847,285,7.546,351,9.293,5612,1039,4573,1.828,9.872,6161,1947,4214,3.425,10.838,-549,-0.966,19.744,260,260,910
2017,3151,201,210,11074,11276,10,4.695,16,7.512,899,350,549,3.104,7.973,1301,425,876,3.769,11.538,-402,-3.565,15.945,15,15,280
2017,3152,4246,4294,72508,75168,587,13.269,847,19.146,10758,4960,5798,6.599,14.312,16042,6128,9914,8.152,21.342,-5284,-7.03,28.624,756,758,5532
2017,3159,504,511,8235,8519,55,10.753,56,10.948,917,322,595,3.78,10.765,1443,182,1261,2.137,16.94,-526,-6.175,21.53,49,49,159
2017,3161,156,165,3564,3544,12,7.122,19,11.276,462,28,434,0.79,13.038,404,259,145,7.309,11.401,58,1.637,22.802,13,13,58
2017,3162,182,200,12184,11827,21,10.526,20,10.025,1307,67,1240,0.567,11.051,628,159,469,1.344,5.31,679,5.741,10.62,17,17,50
2017,3169,685,690,11487,11532,55,7.891,69,9.9,1217,315,902,2.732,10.553,1279,252,1027,2.185,11.091,-62,-0.538,21.106,58,58,186
2017,3211,2646,3108,88672,87974,199,6.382,219,7.024,9000,2144,6856,2.437,10.23,7511,2526,4985,2.871,8.538,1489,1.693,17.075,157,159,1537
2017,3212,1025,1391,79992,77918,94,6.797,78,5.64,11344,3067,8277,3.936,14.559,7074,2275,4799,2.92,9.079,4270,5.48,18.158,49,49,917
2017,3219,8059,9159,238176,233061,847,9.341,665,7.333,30836,8073,22763,3.464,13.231,20441,7318,13123,3.14,8.771,10395,4.46,17.541,498,502,4787
2017,3221,155,368,96706,98935,10,2.699,15,4.049,3869,818,3051,0.827,3.911,8424,1768,6656,1.787,8.515,-4555,-4.604,7.821,6,6,62
2017,3222,2329,3597,247916,248486,117,3.223,184,5.068,19469,3950,15519,1.59,7.835,20622,5763,14859,2.319,8.299,-1153,-0.464,15.67,109,112,1794
2017,3231,22291,23754,453209,459234,1358,5.657,1859,7.744,38337,9318,29019,2.029,8.348,50389,16320,34069,3.554,10.972,-12052,-2.624,16.696,1458,1468,9088
2017,3241,887,2064,105350,106573,95,4.564,130,6.245,6903,806,6097,0.756,6.477,9342,4988,4354,4.68,8.766,-2439,-2.289,12.955,38,38,481
2017,3251,1213,2399,157084,156050,104,4.284,161,6.632,16854,3571,13283,2.288,10.8,14472,5479,8993,3.511,9.274,2382,1.526,18.548,61,62,857
2017,3252,1038,1376,100189,99390,54,3.907,66,4.776,9533,1544,7989,1.553,9.592,7917,1949,5968,1.961,7.966,1616,1.626,15.931,40,41,1156
2017,3253,675,923,30884,30528,64,6.949,60,6.515,3037,684,2353,2.241,9.948,2304,539,1765,1.766,7.547,733,2.401,15.095,30,31,286
2017,3254,1750,2247,253285,252378,215,9.639,182,8.16,28225,4487,23738,1.778,11.184,26668,11479,15189,4.548,10.567,1557,0.617,21.133,101,101,1757
2017,3255,1317,1690,63347,62826,72,4.253,78,4.607,4551,583,3968,0.928,7.244,3539,1128,2411,1.795,5.633,1012,1.611,11.266,52,52,684
2017,3256,1899,2110,102465,100685,176,8.389,152,7.245,11705,1908,9797,1.895,11.625,8283,2980,5303,2.96,8.227,3422,3.399,16.453,123,123,1617
2017,3259,1697,2195,83794,83649,144,6.529,165,7.481,8498,1435,7063,1.716,10.159,8129,2410,5719,2.881,9.718,369,0.441,19.436,117,127,1308
2017,3261,7680,10077,636381,630193,370,3.647,506,4.988,59371,8334,51037,1.322,9.421,46738,12960,33778,2.057,7.416,12633,2.005,14.833,341,349,6176
2017,3262,1356,1787,133379,133729,64,3.567,78,4.348,8838,1337,7501,1,6.609,9609,2731,6878,2.042,7.185,-771,-0.577,13.218,51,51,1030
2017,3271,857,1037,34516,34310,59,5.662,69,6.622,3225,510,2715,1.486,9.4,2788,853,1935,2.486,8.126,437,1.274,16.252,48,49,297
2017,3272,1340,1586,92983,91729,101,6.342,114,7.159,8354,1951,6403,2.127,9.107,5751,1905,3846,2.077,6.27,2603,2.838,12.539,79,79,869
2017,3273,3915,8519,173393,171171,396,4.652,382,4.488,23508,4841,18667,2.828,13.734,19039,5294,13745,3.093,11.123,4469,2.611,22.246,172,174,2374
2017,3274,146,278,13742,13279,15,5.329,22,7.815,1500,95,1405,0.715,11.296,514,82,432,0.618,3.871,986,7.426,7.742,19,19,77
2017,3279,2578,3048,78638,78504,180,5.873,214,6.982,8643,1670,6973,2.127,11.01,8412,2465,5947,3.14,10.715,231,0.294,21.431,130,131,1236
2017,3311,165,288,85467,85858,15,5.025,36,12.06,7024,2138,4886,2.49,8.181,7866,1529,6337,1.781,9.162,-842,-0.981,16.362,21,21,619
2017,3312,482,649,48487,48073,34,5.267,27,4.183,4207,434,3773,0.903,8.751,3390,229,3161,0.476,7.052,817,1.699,14.104,18,18,108
2017,3313,314,446,57463,57344,23,5.117,30,6.674,5096,2309,2787,4.027,8.887,5303,2380,2923,4.15,9.248,-207,-0.361,17.773,20,24,2034
2017,3314,607,798,56120,57370,25,3.092,46,5.69,3502,1001,2501,1.745,6.104,5980,2434,3546,4.243,10.424,-2478,-4.319,12.208,27,27,366
2017,3315,1437,1633,116203,118031,52,3.152,85,5.153,8197,1040,7157,0.881,6.945,11890,2861,9029,2.424,10.074,-3693,-3.129,13.89,61,62,1760
2017,3321,2025,2291,103872,104044,64,2.768,107,4.627,8438,1477,6961,1.42,8.11,8829,2524,6305,2.426,8.486,-391,-0.376,16.22,78,78,1228
2017,3322,1002,1077,34170,34379,56,5.168,69,6.368,2657,613,2044,1.783,7.729,3053,708,2345,2.059,8.881,-396,-1.152,15.457,51,51,291
2017,3323,11250,12281,359621,358039,741,6.039,720,5.868,39028,10368,28660,2.896,10.9,35734,12282,23452,3.43,9.98,3294,0.92,19.961,520,524,7126
2017,3324,1180,1496,84768,84986,70,4.636,98,6.49,10772,2697,8075,3.173,12.675,11154,2260,8894,2.659,13.125,-382,-0.449,25.35,56,56,947
2017,3325,544,590,28785,28378,32,5.442,28,4.762,2436,709,1727,2.498,8.584,1515,188,1327,0.662,5.339,921,3.245,10.677,21,21,169
2017,3326,952,1102,38693,38780,29,2.602,54,4.845,3167,767,2400,1.978,8.167,3329,1117,2212,2.88,8.584,-162,-0.418,16.333,36,36,558
2017,3327,20996,21587,371723,374189,973,4.458,1446,6.626,34445,8449,25996,2.258,9.205,39470,12430,27040,3.322,10.548,-5025,-1.343,18.41,1056,1067,8145
2017,3328,4759,5316,127899,127254,220,4.1,321,5.982,14095,2197,11898,1.726,11.076,12772,3526,9246,2.771,10.037,1323,1.04,20.073,233,233,2304
2017,3329,5439,5955,250635,251717,372,6.209,444,7.411,20991,3964,17027,1.575,8.339,23387,7330,16057,2.912,9.291,-2396,-0.952,16.678,316,319,4114
2017,3331,2428,2824,184380,185619,133,4.659,194,6.796,17257,3362,13895,1.811,9.297,19882,3790,16092,2.042,10.711,-2625,-1.414,18.594,123,123,1074
2017,3332,2826,2990,110067,108029,149,4.965,171,5.698,12224,2148,10076,1.988,11.316,8152,2555,5597,2.365,7.546,4072,3.769,15.092,119,120,1670
2017,3333,1688,1811,70157,70160,116,6.372,135,7.416,6272,1298,4974,1.85,8.94,6255,2260,3995,3.221,8.915,17,0.024,17.831,90,90,1148
2017,3334,1390,1651,128081,127521,73,4.384,101,6.066,9165,1236,7929,0.969,7.187,7971,2513,5458,1.971,6.251,1194,0.936,12.501,67,67,969
2017,3335,5800,6050,147691,148074,243,3.978,359,5.878,14024,2858,11166,1.93,9.471,14855,5386,9469,3.637,10.032,-831,-0.561,18.942,272,273,2615
2017,3336,723,930,101292,101430,31,3.231,90,9.38,9949,1416,8533,1.396,9.809,10474,4702,5772,4.636,10.326,-525,-0.518,19.618,40,41,829
2017,3339,5093,5800,297201,298530,249,4.259,343,5.866,24840,5527,19313,1.851,8.321,27820,7633,20187,2.557,9.319,-2980,-0.998,16.642,236,236,3362
2017,3341,851,882,39185,38981,73,8.193,91,10.213,4330,340,3990,0.872,11.108,3879,1174,2705,3.012,9.951,451,1.157,19.902,68,68,438
2017,3342,1095,1197,82189,82039,69,5.663,112,9.192,6895,845,6050,1.03,8.405,6481,2417,4064,2.946,7.9,414,0.505,15.8,74,75,829
2017,3343,424,437,9407,9477,32,7.264,39,8.854,841,132,709,1.393,8.874,952,231,721,2.437,10.045,-111,-1.171,17.748,28,28,145
2017,3344,3299,3745,257732,261097,184,4.866,256,6.771,17250,2361,14889,0.904,6.607,23926,7170,16756,2.746,9.164,-6676,-2.557,13.214,184,185,2985
2017,3345,4229,4926,387620,386339,236,4.754,312,6.285,31234,5096,26138,1.319,8.085,28893,7137,21756,1.847,7.479,2341,0.606,14.957,216,216,2862
2017,3346,398,406,8092,8917,29,7.005,45,10.87,888,128,760,1.436,9.959,2415,563,1852,6.314,27.085,-1527,-17.126,19.918,40,40,348
2017,3351,954,1016,43397,43461,74,7.276,76,7.473,3373,570,2803,1.312,7.761,3424,911,2513,2.096,7.878,-51,-0.117,15.522,63,63,681
2017,3352,239,287,51914,50354,29,10.122,28,9.773,4863,1251,3612,2.484,9.658,1819,515,1304,1.023,3.612,3044,6.045,7.225,20,20,380
2017,3353,1677,1938,112974,114554,80,4.084,122,6.228,8870,1728,7142,1.508,7.743,12022,2472,9550,2.158,10.495,-3152,-2.752,15.486,74,74,1007
2017,3359,1705,1991,132958,132426,111,5.554,126,6.305,10570,2283,8287,1.724,7.982,9427,3017,6410,2.278,7.119,1143,0.863,14.237,83,83,1334
2017,3361,247,297,206729,199381,32,10.866,27,9.168,20443,283,20160,0.142,10.253,5769,950,4819,0.476,2.893,14674,7.36,5.787,19,19,239
2017,3362,1542,1855,153130,149960,125,6.762,112,6.059,19092,4492,14600,2.995,12.731,12958,4132,8826,2.755,8.641,6134,4.09,17.282,81,82,2762
2017,3363,3852,4803,588754,581233,216,4.454,310,6.392,52230,6251,45979,1.075,8.986,37382,10167,27215,1.749,6.432,14848,2.555,12.863,193,200,3360
2017,3364,1255,1684,373942,370637,86,5.057,119,6.998,28599,1291,27308,0.348,7.716,22472,3733,18739,1.007,6.063,6127,1.653,12.126,73,73,896
2017,3365,147,226,29126,29864,5,2.151,18,7.742,2041,466,1575,1.56,6.834,3505,489,3016,1.637,11.737,-1464,-4.902,13.669,9,9,224
2017,3366,1273,1402,137622,139369,107,7.629,108,7.701,9287,1585,7702,1.137,6.664,12642,1795,10847,1.288,9.071,-3355,-2.407,13.327,73,73,689
2017,3369,758,791,32914,34364,73,9.182,81,10.189,3469,1641,1828,4.775,10.095,6499,3273,3226,9.525,18.913,-3030,-8.817,20.19,66,66,623
2017,3371,9265,9515,224221,222764,605,6.303,771,8.033,21686,3979,17707,1.786,9.735,18752,6987,11765,3.137,8.418,2934,1.317,16.836,568,571,4522
2017,3372,3274,3414,115278,115238,171,4.938,269,7.768,11894,1599,10295,1.388,10.321,11824,4679,7145,4.06,10.261,70,0.061,20.521,197,200,2396
2017,3379,604,710,32334,31786,50,7.052,48,6.77,4792,1034,3758,3.253,15.076,3629,1269,2360,3.992,11.417,1163,3.659,22.834,35,35,339
2017,3391,8615,9526,278552,276876,531,5.498,794,8.222,28689,4727,23962,1.707,10.362,25371,10077,15294,3.64,9.163,3318,1.198,18.327,608,609,5193
2017,3399,15615,16021,266020,262961,1631,10.286,1303,8.217,32580,9900,22680,3.765,12.39,26474,8420,18054,3.202,10.068,6106,2.322,20.135,960,962,5358
2017,4231,14632,22571,404547,403091,1428,6.291,1684,7.419,46777,11939,34838,2.962,11.605,43790,12754,31036,3.164,10.864,2987,0.741,21.727,1095,1161,7469
2017,4232,10305,12350,170225,166131,870,7.032,913,7.38,25908,5822,20086,3.504,15.595,17860,5594,12266,3.367,10.751,8048,4.844,21.501,638,655,3272
2017,4233,9448,16757,247142,242272,1098,6.564,1040,6.217,34767,7910,26857,3.265,14.35,24647,9322,15325,3.848,10.173,10120,4.177,20.347,531,563,3749
2017,4234,21073,32352,647602,647093,2648,8.16,2849,8.779,85441,25223,60218,3.898,13.204,84920,30063,54857,4.646,13.123,521,0.081,26.247,1502,1545,10892
2017,4235,6730,9223,150937,150568,434,4.652,646,6.925,17046,2647,14399,1.758,11.321,16503,5059,11444,3.36,10.961,543,0.361,21.921,360,384,2678
2017,4236,17796,27870,524247,531679,1699,6.023,2374,8.416,58129,15084,43045,2.837,10.933,72358,33046,39312,6.215,13.609,-14229,-2.676,21.866,1284,1339,8745
2017,4237,9763,19101,246791,242899,1063,5.583,938,4.927,32285,8918,23367,3.671,13.292,24539,7939,16600,3.268,10.103,7746,3.189,20.205,492,534,3630
2017,4238,38343,55940,757524,762088,2927,5.199,3651,6.485,85913,21502,64411,2.821,11.273,94543,30908,63635,4.056,12.406,-8630,-1.132,22.547,1998,2087,12506
2017,4239,26178,29462,322516,321758,2539,8.534,3117,10.477,43945,11843,32102,3.681,13.658,42581,16687,25894,5.186,13.234,1364,0.424,26.468,2298,2353,10712
2017,4241,6881,9329,147437,148257,460,4.868,699,7.398,14390,3693,10697,2.491,9.706,15855,6240,9615,4.209,10.694,-1465,-0.988,19.412,417,421,2276
2017,4242,6248,9575,310776,312882,782,8.143,838,8.726,38236,12581,25655,4.021,12.221,42957,14691,28266,4.695,13.729,-4721,-1.509,24.441,521,546,3580
2017,4243,13002,14084,200879,201170,1440,10.152,1642,11.576,26069,6884,19185,3.422,12.959,26782,9567,17215,4.756,13.313,-713,-0.354,25.917,1294,1313,6474
2017,4244,25073,32949,833659,822461,2777,8.459,2535,7.722,99484,28617,70867,3.479,12.096,77617,26159,51458,3.181,9.437,21867,2.659,18.874,1704,1726,11183
2017,4245,3232,6047,62573,62828,273,4.498,319,5.255,7852,1765,6087,2.809,12.498,8274,1958,6316,3.116,13.169,-422,-0.672,24.995,156,166,996
2017,4246,7774,12338,162786,160586,630,5.073,790,6.362,22683,4872,17811,3.034,14.125,18007,6647,11360,4.139,11.213,4676,2.912,22.427,386,407,2484
2017,4247,3807,6157,98969,99021,266,4.278,389,6.256,13069,3751,9318,3.788,13.198,13322,4318,9004,4.361,13.454,-253,-0.256,26.397,194,203,2342
2017,4248,3224,4225,204307,202938,354,8.364,369,8.718,19202,6335,12867,3.122,9.462,16619,7491,9128,3.691,8.189,2583,1.273,16.378,238,242,3457
2017,4249,19703,26644,341531,342954,2173,8.136,2300,8.612,40823,10671,30152,3.111,11.903,43494,13972,29522,4.074,12.682,-2671,-0.779,23.807,1630,1666,7952
2017,4251,29984,32140,280363,277289,3505,10.785,4225,13,51898,11705,40193,4.221,18.716,45144,19192,25952,6.921,16.28,6754,2.436,32.561,3235,3265,10638
2017,4411,37578,43831,1330617,1313890,3643,8.317,3584,8.182,144420,44630,99790,3.397,10.992,110616,38044,72572,2.896,8.419,33804,2.573,16.838,2729,2765,27057
2017,4412,11089,12836,150707,147911,862,6.696,937,7.279,20702,5653,15049,3.822,13.996,15168,5473,9695,3.7,10.255,5534,3.741,20.51,664,683,3710
2017,4413,26111,55905,533179,530003,2841,5.09,2652,4.752,54373,17507,36866,3.303,10.259,48248,15133,33115,2.855,9.103,6125,1.156,18.207,1622,1681,7128
2017,4421,12734,22320,208639,208365,1587,7.102,1640,7.339,28719,7714,21005,3.702,13.783,28390,7648,20742,3.67,13.625,329,0.158,27.25,1079,1150,4955
2017,4422,17264,25356,250460,249260,1554,6.083,1937,7.582,26151,8101,18050,3.25,10.491,23690,8102,15588,3.25,9.504,2461,0.987,19.008,1253,1278,3987
2017,4431,17867,29104,319043,336370,1768,5.432,8661,26.608,32227,7925,24302,2.356,9.581,68086,43394,24692,12.901,20.241,-35859,-10.661,19.162,2534,2878,13043
2017,4441,33740,55348,1146294,1153374,2454,4.418,2846,5.124,74181,17295,56886,1.5,6.432,86818,16321,70497,1.415,7.527,-12637,-1.096,12.863,1793,1895,9931
2017,4442,12362,16275,157335,155003,870,5.322,1012,6.191,23222,4489,18733,2.896,14.982,18110,4378,13732,2.824,11.684,5112,3.298,23.367,686,695,2849
2017,4451,60003,86404,2798687,2809407,7883,9.139,7586,8.795,235600,92077,143523,3.277,8.386,258709,79185,179524,2.819,9.209,-23109,-0.823,16.772,5608,5686,27447
2017,4452,15894,19796,157096,157037,2197,11.129,2089,10.582,28223,11469,16754,7.303,17.972,28132,10126,18006,6.448,17.914,91,0.058,35.829,1524,1550,7456
2017,4453,27998,32059,170267,168029,2542,7.961,2289,7.168,26555,8940,17615,5.321,15.804,22335,7766,14569,4.622,13.292,4220,2.511,26.585,1782,1804,5831
2017,4461,39296,92784,1011711,1019630,5433,5.874,4847,5.241,166642,35636,131006,3.495,16.343,182563,25869,156694,2.537,17.905,-15921,-1.561,32.687,3308,3428,17310
2017,4471,61784,107518,945935,943894,7611,7.092,7222,6.729,135271,48727,86544,5.162,14.331,130714,37862,92852,4.011,13.848,4557,0.483,27.697,4525,4978,23143
2017,4481,32248,91284,1395082,1386701,7075,7.705,8163,8.889,172594,63652,108942,4.59,12.446,158488,45647,112841,3.292,11.429,14106,1.017,22.858,3577,3894,14453
2017,4482,4819,24094,243170,242199,951,3.92,1284,5.293,31819,6880,24939,2.841,13.138,29495,6805,22690,2.81,12.178,2324,0.96,24.356,470,579,2189
2017,4483,14293,21030,121782,123433,1171,5.5,1696,7.965,14770,4552,10218,3.688,11.966,18237,6075,12162,4.922,14.775,-3467,-2.809,23.932,1011,1022,2748
2017,4511,24192,34825,452757,464370,2990,8.482,3842,10.899,60612,21123,39489,4.549,13.053,81288,37374,43914,8.048,17.505,-20676,-4.452,26.105,2134,2539,13204
2017,4512,3144,7201,84527,86109,607,8.524,447,6.277,9540,4107,5433,4.77,11.079,12452,2717,9735,3.155,14.461,-2912,-3.382,22.158,300,325,1584
2017,4522,15,4321,476824,501614,32,0.698,564,12.296,36723,1752,34971,0.349,7.321,84428,46810,37618,9.332,16.831,-47705,-9.51,14.642,3,3,19
2017,4523,7096,47214,2224430,2219310,2516,5.334,2420,5.131,119320,33172,86148,1.495,5.376,109035,39889,69146,1.797,4.913,10285,0.463,9.826,823,831,2543
2017,4531,11161,11654,56200,56807,904,7.659,1201,10.176,8504,2679,5825,4.716,14.97,9715,3731,5984,6.568,17.102,-1211,-2.132,29.94,937,945,2909
2017,4532,16094,25180,217173,222104,1821,7.063,3022,11.722,29356,9042,20314,4.071,13.217,39121,15608,23513,7.027,17.614,-9765,-4.397,26.435,1687,1757,6346
2017,4533,12675,18939,198817,204028,1464,7.667,1775,9.296,23335,7922,15413,3.883,11.437,33819,7709,26110,3.778,16.576,-10484,-5.139,22.874,1319,1358,5021
2017,4539,32518,44080,283680,282481,5180,11.881,4221,9.681,45913,19988,25925,7.076,16.253,43812,14572,29240,5.159,15.51,2101,0.744,31.019,3149,3248,10954
2017,4541,33248,34749,547941,524268,6102,18.029,4296,12.693,123506,25445,98061,4.853,23.558,73365,37702,35663,7.191,13.994,50141,9.564,27.988,3260,3279,15502
2017,4542,2885,3429,41642,40674,417,12.22,384,11.253,5958,3444,2514,8.467,14.648,4116,1504,2612,3.698,10.12,1842,4.529,20.239,308,309,1098
2017,4543,22258,27632,182460,181341,3055,11.167,2508,9.167,28821,10960,17861,6.044,15.893,26197,8482,17715,4.677,14.446,2624,1.447,28.893,1787,1810,6177
2017,4811,415,2147,430771,428818,158,7.439,112,5.273,32468,3916,28552,0.913,7.572,28626,2155,26471,0.503,6.676,3842,0.896,13.351,26,40,429
2017,4812,1682,1925,40319,39532,220,11.408,227,11.771,5862,1866,3996,4.72,14.828,4311,1468,2843,3.713,10.905,1551,3.923,21.81,167,168,668
2017,4831,586,915,40848,41711,125,13.736,115,12.637,4467,1039,3428,2.491,10.71,6127,2016,4111,4.833,14.689,-1660,-3.98,21.419,57,69,328
2017,4832,416,480,18974,19235,58,12.211,48,10.105,1355,507,848,2.636,7.044,1900,375,1525,1.95,9.878,-545,-2.833,14.089,41,42,162
2017,4841,54208,64909,976258,976548,9814,15.182,9278,14.353,118873,37896,80977,3.881,12.173,120156,49607,70549,5.08,12.304,-1283,-0.131,24.346,6681,6731,25169
2017,4842,39290,43000,489282,487488,5205,12.122,5085,11.842,74383,20287,54096,4.162,15.258,70633,24024,46609,4.928,14.489,3750,0.769,28.978,3626,3690,15408
2017,4851,409,692,53242,53296,68,9.913,56,8.163,2447,558,1889,1.047,4.591,2506,1218,1288,2.285,4.702,-59,-0.111,9.183,38,38,933
2017,4852,312,558,14684,14477,58,10.681,28,5.157,1321,456,865,3.15,9.125,897,254,643,1.755,6.196,424,2.929,12.392,18,18,233
2017,4853,6719,6887,75298,76162,1047,15.056,1181,16.983,10086,3980,6106,5.226,13.243,12030,4769,7261,6.262,15.795,-1944,-2.552,26.486,997,999,3859
2017,4854,2487,4212,241045,240501,203,4.792,251,5.925,16862,4058,12804,1.687,7.011,15941,5551,10390,2.308,6.628,921,0.383,13.256,163,167,2610
2017,4855,1072,1200,34117,33864,105,8.717,114,9.465,4335,1396,2939,4.122,12.801,3876,1794,2082,5.298,11.446,459,1.355,22.892,82,82,1023
2017,4859,4034,4547,97854,95615,784,17.559,620,13.886,16039,5116,10923,5.351,16.775,11553,4776,6777,4.995,12.083,4486,4.692,24.166,475,483,3566
2017,4861,67,783,13275,13722,48,5.996,83,10.369,1164,392,772,2.857,8.483,2017,757,1260,5.517,14.7,-853,-6.217,16.966,13,13,58
2017,4862,114,2139,28098,28478,144,6.817,91,4.308,3159,1178,1981,4.137,11.093,3901,821,3080,2.883,13.699,-742,-2.606,22.186,4,4,41
2017,4869,66,709,8492,8410,50,7.092,42,5.957,1172,560,612,6.659,13.936,1008,330,678,3.924,11.986,164,1.95,23.971,5,5,24
2017,4871,569,613,11049,11375,86,14.18,73,12.036,1557,410,1147,3.604,13.688,2268,1190,1078,10.462,19.938,-711,-6.251,27.376,52,54,295
2017,4872,1276,1326,15028,14867,187,14.313,148,11.328,2260,822,1438,5.529,15.201,1993,543,1450,3.652,13.406,267,1.796,26.811,94,94,365
2017,4879,171,204,3392,3282,24,11.707,26,12.683,415,78,337,2.377,12.647,199,60,139,1.828,6.064,216,6.582,12.129,18,18,44
2017,4881,3880,5686,199204,193936,431,7.557,466,8.17,39032,6371,32661,3.285,20.126,28306,12274,16032,6.329,14.596,10726,5.531,29.191,261,286,2503
2017,4882,521,1476,40633,41670,184,12.603,152,10.411,4702,1936,2766,4.646,11.284,6880,2110,4770,5.064,16.511,-2178,-5.227,22.568,24,24,183
2017,4883,1829,2450,92860,94611,183,7.465,186,7.587,7871,1306,6565,1.38,8.319,11307,1221,10086,1.291,11.951,-3436,-3.632,16.639,119,122,631
2017,4884,9535,11265,103756,102295,1404,12.624,1118,10.052,16964,5869,11095,5.737,16.583,14145,5172,8973,5.056,13.828,2819,2.756,27.655,793,799,3281
2017,4885,13826,19928,265704,261177,1763,8.872,1649,8.299,40286,10742,29544,4.113,15.425,31326,10867,20459,4.161,11.994,8960,3.431,23.988,999,1025,4591
2017,4889,1412,1508,16408,16756,208,13.853,195,12.987,2463,1111,1352,6.63,14.699,3104,823,2281,4.912,18.525,-641,-3.825,29.398,150,152,608
2017,4921,3787,9425,590769,581107,527,5.476,925,9.611,46130,7679,38451,1.321,7.938,25959,8475,17484,1.458,4.467,20171,3.471,8.934,501,505,2494
2017,4922,3465,3901,47696,45771,514,12.928,664,16.7,11975,4662,7313,10.186,26.163,8155,4283,3872,9.358,17.817,3820,8.346,35.634,467,468,2657
2017,4931,7497,16105,916983,870373,1541,9.685,1152,7.241,186808,79827,106981,9.172,21.463,88597,25527,63070,2.933,10.179,98211,11.284,20.358,380,398,3904
2017,5111,10742,15307,365132,373034,921,5.871,1680,10.71,37654,9368,28286,2.511,10.094,53364,19202,34162,5.148,14.305,-15710,-4.211,20.188,893,938,6243
2017,5112,8364,11676,611341,597567,1532,13.399,1048,9.166,85673,25661,60012,4.294,14.337,57907,18326,39581,3.067,9.69,27766,4.647,19.381,658,669,8729
2017,5121,14125,17403,308176,348423,2139,12.287,2150,12.35,45631,18750,26881,5.381,13.096,125448,13804,111644,3.962,36.005,-79817,-22.908,26.193,1412,1418,7269
2017,5122,2738,2943,23298,23491,361,12.283,353,12.011,3703,1308,2395,5.568,15.764,3972,2501,1471,10.647,16.909,-269,-1.145,31.528,249,249,637
2017,5151,3867,7274,207806,211642,340,4.648,423,5.782,15041,4420,10621,2.088,7.107,22690,6599,16091,3.118,10.721,-7649,-3.614,14.214,234,242,2208
2017,5152,356,682,50860,50460,27,3.902,47,6.792,3633,414,3219,0.82,7.2,2734,932,1802,1.847,5.418,899,1.782,10.836,30,30,704
2017,5173,6338,53508,1009682,1018989,5701,10.469,7601,13.958,147750,37266,110484,3.657,14.5,168675,53081,115594,5.209,16.553,-20925,-2.054,28.999,318,376,3154
2017,5174,300,371,9013,8394,54,14.516,56,15.054,2426,1215,1211,14.475,28.902,1183,348,835,4.146,14.093,1243,14.808,28.187,36,36,104
2017,5179,2660,3532,53817,53513,756,20.855,942,25.986,10917,5211,5706,9.738,20.401,10054,6374,3680,11.911,18.788,863,1.613,37.576,721,823,3979
2017,5182,9655,15851,526859,521667,3203,21.231,1674,11.096,103424,46352,57072,8.885,19.826,93350,37896,55454,7.264,17.895,10074,1.931,35.789,825,873,13502
2017,5191,8397,10650,301032,296316,1358,12.718,1413,13.233,48651,10396,38255,3.508,16.419,39469,14097,25372,4.757,13.32,9182,3.099,26.64,984,1013,6661
2017,5211,12,58,19737,19552,0,0,(D),(D),675,0,675,0,3.452,309,(D),308,(D),1.58,366,1.872,3.161,(D),(D),(D)
2017,5221,10877,117814,1971753,1970846,4715,3.995,5121,4.339,215920,49134,166786,2.493,10.956,214843,42909,171934,2.177,10.901,1077,0.055,21.802,351,558,6051
2017,5222,12986,43799,620317,627751,3694,8.426,3776,8.613,104725,26440,78285,4.212,16.683,117907,48772,69135,7.769,18.782,-13182,-2.1,33.365,1102,1208,6773
2017,5223,11637,25600,296452,292022,1933,7.398,2991,11.447,50129,15300,34829,5.239,17.166,41778,18503,23275,6.336,14.306,8351,2.86,28.613,940,1051,5606
2017,5231,9418,26777,357508,363016,2355,8.638,3328,12.207,31317,10947,20370,3.016,8.627,42398,13434,28964,3.701,11.679,-11081,-3.052,17.254,856,871,3288
2017,5232,13,36,6028,6164,(D),(D),(D),(D),83,(D),61,(D),1.347,369,(D),348,(D),5.987,-286,-4.64,2.693,(D),(D),(D)
2017,5239,44974,64863,537689,530586,6645,10.356,5247,8.177,78309,28424,49885,5.357,14.759,64558,21772,42786,4.103,12.167,13751,2.592,24.335,3562,3602,13122
2017,5241,4345,31140,1566698,1559847,3776,11.35,8032,24.143,237549,108541,129008,6.958,15.229,224560,88262,136298,5.658,14.396,12989,0.833,28.793,300,332,4121
2017,5242,119945,135781,1024269,1008958,11496,8.464,11567,8.517,168008,71945,96063,7.131,16.652,136831,57230,79601,5.672,13.562,31177,3.09,27.123,7749,7856,27096
2017,5259,569,574,4332,4369,162,28.272,160,27.923,2117,1489,628,34.081,48.455,2213,1452,761,33.234,50.652,-96,-2.197,96.91,121,121,611
2017,5311,87089,117908,584908,581345,11476,9.764,10721,9.122,98532,41032,57500,7.058,16.949,90099,39918,50181,6.866,15.498,8433,1.451,30.997,7524,7878,24453
2017,5312,77216,92342,327496,317678,17589,19.918,9516,10.776,69547,38700,30847,12.182,21.892,48971,20258,28713,6.377,15.415,20576,6.477,30.831,5791,5862,12147
2017,5313,67349,84359,695945,682318,10046,12.077,7694,9.249,114478,41875,72603,6.137,16.778,87036,36096,50940,5.29,12.756,27442,4.022,25.512,4915,4990,21537
2017,5321,3413,15494,161080,162625,1099,7.129,941,6.104,18446,4530,13916,2.786,11.343,20845,3683,17162,2.265,12.818,-2399,-1.475,22.685,358,363,1528
2017,5322,6897,17667,135412,140857,2391,13.473,2550,14.369,22431,7804,14627,5.54,15.925,33070,14149,18921,10.045,23.478,-10639,-7.553,31.849,718,795,5827
2017,5323,2122,2807,19404,18991,253,9.127,183,6.602,3274,891,2383,4.692,17.24,2408,687,1721,3.618,12.68,866,4.56,25.36,132,138,504
2017,5324,7264,14289,185742,183800,1319,9.303,1097,7.737,27114,7557,19557,4.112,14.752,23003,6439,16564,3.503,12.515,4111,2.237,25.031,531,543,2477
2017,5331,2146,2363,38691,37807,292,12.473,248,10.594,6536,1473,5063,3.896,17.288,4864,1658,3206,4.385,12.866,1672,4.423,25.731,163,164,849
2017,5411,156547,168560,1152957,1144869,12642,7.483,13399,7.931,135022,36481,98541,3.186,11.794,118896,37901,80995,3.311,10.385,16126,1.409,20.77,9926,10096,27013
2017,5412,99495,119024,1149083,1153599,9399,7.894,9474,7.957,142633,40524,102109,3.513,12.364,151320,76060,75260,6.593,13.117,-8687,-0.753,24.728,6561,6626,45660
2017,5413,81912,101549,1503096,1479923,8581,8.444,8716,8.577,210031,51124,158907,3.455,14.192,163828,58052,105776,3.923,11.07,46203,3.122,22.14,5113,5198,24051
2017,5414,26475,26856,119158,118493,3687,13.836,3270,12.271,19080,7286,11794,6.149,16.102,17682,8436,9246,7.119,14.922,1398,1.18,29.845,2338,2341,5133
2017,5415,98896,122084,1835447,1804814,17466,14.371,16379,13.476,277718,82000,195718,4.543,15.388,217982,83377,134605,4.62,12.078,59736,3.31,24.156,11282,11364,47787
2017,5416,124854,135018,1273327,1251755,23301,17.397,21134,15.779,248693,89451,159242,7.146,19.868,204221,96883,107338,7.74,16.315,44472,3.553,32.63,14810,14893,53052
2017,5417,13315,16683,713347,703795,2088,12.587,1898,11.442,88638,17521,71117,2.49,12.594,70022,23811,46211,3.383,9.949,18616,2.645,19.898,1147,1170,7458
2017,5418,28790,32985,486920,481598,3470,10.484,3698,11.173,73981,20535,53446,4.264,15.362,62687,25880,36807,5.374,13.016,11294,2.345,26.033,2723,2749,17515
2017,5419,54689,62177,640151,634887,7152,11.612,5983,9.714,101329,36730,64599,5.785,15.96,90592,41823,48769,6.587,14.269,10737,1.691,28.538,4118,4198,23802
2017,5511,26623,55560,3529482,3447961,5506,9.997,4534,8.233,589163,175681,413482,5.095,17.087,428559,134294,294265,3.895,12.429,160604,4.658,24.859,795,823,15764
2017,5611,26631,29336,482158,465898,3599,12.387,3038,10.456,97919,35246,62673,7.565,21.017,65057,26791,38266,5.75,13.964,32862,7.053,27.928,2211,2231,17789
2017,5612,1985,6541,280761,263714,514,7.834,555,8.458,86756,67225,19531,25.492,32.898,54027,37391,16636,14.179,20.487,32729,12.411,40.974,105,114,2296
2017,5613,24442,49105,5868234,5820577,4554,9.291,4374,8.924,1044993,192308,852685,3.304,17.953,946247,271575,674672,4.666,16.257,98746,1.696,32.514,2337,2405,107749
2017,5614,21726,28635,798961,799641,2390,8.226,3231,11.12,131478,47695,83783,5.965,16.442,133719,48660,85059,6.085,16.722,-2241,-0.28,32.884,2181,2211,25075
2017,5615,12673,21984,232862,232136,1293,5.846,1564,7.071,32483,6726,25757,2.897,13.993,30622,13123,17499,5.653,13.191,1861,0.802,26.383,992,1011,4781
2017,5616,18002,23086,955860,947056,2293,9.775,3036,12.943,236986,121464,115522,12.825,25.023,220593,83472,137121,8.814,23.293,16393,1.731,46.585,1385,1403,17131
2017,5617,153250,162159,1954787,1922010,22525,14.04,19083,11.894,334492,114773,219719,5.972,17.403,270259,89784,180475,4.671,14.061,64233,3.342,28.123,13289,13334,62875
2017,5619,15641,17738,287916,289313,1688,9.503,1738,9.784,43435,8997,34438,3.11,15.013,46283,16102,30181,5.566,15.998,-2848,-0.984,30.026,1173,1296,11073
2017,5621,7211,11125,215620,211262,673,6.057,647,5.823,23341,4951,18390,2.344,11.048,14358,5577,8781,2.64,6.796,8983,4.252,13.593,487,502,3989
2017,5622,1205,2528,57960,55092,138,5.458,139,5.497,9728,3163,6565,5.741,17.658,3981,1936,2045,3.514,7.226,5747,10.432,14.452,84,88,469
2017,5629,8513,10013,134157,133071,848,8.499,778,7.797,22518,4683,17835,3.519,16.922,20338,7309,13029,5.493,15.284,2180,1.638,30.567,540,548,3832
2017,6111,18733,21449,1049897,1036484,901,4.196,953,4.438,88974,16729,72245,1.614,8.584,62281,20969,41312,2.023,6.009,26693,2.575,12.018,632,657,14445
2017,6112,425,786,61560,67583,17,1.917,219,24.69,3544,210,3334,0.311,5.244,16256,11069,5187,16.379,24.054,-12712,-18.81,10.488,29,182,9853
2017,6113,2347,4336,1878168,1881982,219,5.032,251,5.767,80804,3189,77615,0.169,4.294,86664,7827,78837,0.416,4.605,-5860,-0.311,8.587,83,102,2253
2017,6114,6666,7168,64047,63493,839,11.737,800,11.191,10581,3294,7287,5.188,16.665,9498,3696,5802,5.821,14.959,1083,1.706,29.918,542,551,2615
2017,6115,6141,7646,109281,109516,742,9.658,815,10.609,18640,5882,12758,5.371,17.02,19304,6867,12437,6.27,17.627,-664,-0.606,34.041,430,611,5101
2017,6116,42211,45584,439454,426919,5734,12.763,4418,9.834,86302,30073,56229,7.044,20.215,61057,21689,39368,5.08,14.302,25245,5.913,28.604,3348,3407,16700
2017,6117,6554,7348,99779,100432,1238,17.194,942,13.083,17752,6012,11740,5.986,17.676,19382,7145,12237,7.114,19.299,-1630,-1.623,35.351,640,647,2619
2017,6211,154716,205044,2447629,2415757,16396,7.981,17186,8.366,371194,113129,258065,4.683,15.366,308198,124749,183449,5.164,12.758,62996,2.608,25.516,11369,11667,61967
2017,6212,118655,129516,945043,933737,7448,5.761,6992,5.408,126265,41155,85110,4.408,13.523,103769,35064,68705,3.755,11.113,22496,2.409,22.227,5782,5859,28961
2017,6213,121384,142379,870800,856940,14451,10.267,11209,7.963,148901,49936,98965,5.827,17.376,120653,47630,73023,5.558,14.08,28248,3.296,28.159,7154,7300,27496
2017,6214,17146,43483,1114079,1089376,3969,9.188,3403,7.877,168335,50700,117635,4.654,15.452,119888,44983,74905,4.129,11.005,48447,4.447,22.01,978,1279,13895
2017,6215,6789,16037,288644,288168,1301,7.976,1848,11.33,41022,9330,31692,3.238,14.235,39878,18533,21345,6.431,13.838,1144,0.397,27.677,678,749,6849
2017,6216,21364,30902,1403924,1380005,3596,11.751,2996,9.79,213814,47490,166324,3.441,15.494,167472,59872,107600,4.339,12.136,46342,3.358,24.271,1797,1844,30199
2017,6219,6388,10789,334265,320703,1112,10.486,743,7.006,58121,16905,41216,5.271,18.123,30870,9441,21429,2.944,9.626,27251,8.497,19.251,405,419,5498
2017,6221,2404,5069,5447726,5355683,80,1.574,107,2.105,343889,28942,314947,0.54,6.421,159955,26330,133625,0.492,2.987,183934,3.434,5.973,41,41,13355
2017,6222,394,629,232377,230946,12,1.894,21,3.315,17788,2176,15612,0.942,7.702,14826,3875,10951,1.678,6.42,2962,1.283,12.839,6,6,1233
2017,6223,289,860,255867,257373,27,3.073,64,7.285,15999,1731,14268,0.673,6.216,18900,7122,11778,2.767,7.343,-2901,-1.127,12.433,19,19,1107
2017,6231,8393,16020,1623750,1647186,999,6.175,1316,8.134,145893,63737,82156,3.869,8.857,194533,94713,99820,5.75,11.81,-48640,-2.953,17.714,613,664,47056
2017,6232,10281,41646,796994,789118,2517,6.041,2560,6.144,115469,26470,88999,3.354,14.633,99567,25848,73719,3.276,12.618,15902,2.015,25.235,447,555,5827
2017,6233,16586,23872,947565,940140,2023,8.531,1708,7.202,101084,36028,65056,3.832,10.752,86797,32830,53967,3.492,9.232,14287,1.52,18.465,1219,1273,21695
2017,6239,2950,4895,121335,123768,446,9.177,376,7.737,16553,4202,12351,3.395,13.374,21051,5011,16040,4.049,17.008,-4498,-3.634,26.748,186,204,2342
2017,6241,60608,79072,1845636,1805322,9779,12.518,7869,10.073,298987,65736,233251,3.641,16.561,217320,54986,162334,3.046,12.038,81667,4.524,24.075,5183,5308,32648
2017,6242,10093,14152,199225,195887,667,4.71,683,4.823,32407,6522,25885,3.329,16.544,25322,4994,20328,2.549,12.927,7085,3.617,25.854,327,347,2172
2017,6243,3832,7186,291149,295353,361,4.993,449,6.21,35456,6923,28533,2.344,12.005,44285,7514,36771,2.544,14.994,-8829,-2.989,24.009,150,154,1495
2017,6244,56567,72392,969282,956401,6457,8.957,5858,8.126,138212,45354,92858,4.742,14.451,112757,40706,72051,4.256,11.79,25455,2.662,23.579,4202,4273,27089
2017,7111,7166,7296,121162,120985,814,11.179,785,10.781,18731,4586,14145,3.791,15.482,18352,4948,13404,4.09,15.169,379,0.313,30.338,535,535,3527
2017,7112,2993,3176,128163,128806,347,10.808,416,12.957,15829,2905,12924,2.255,12.289,16919,3461,13458,2.687,13.135,-1090,-0.846,24.578,308,308,1687
2017,7113,6392,6840,184015,182198,777,11.436,686,10.096,30591,5531,25060,3.036,16.79,26664,11014,15650,6.045,14.635,3927,2.155,29.269,448,449,3298
2017,7114,3100,3240,21211,20645,439,13.581,424,13.117,3843,1544,2299,7.479,18.615,2710,1096,1614,5.309,13.127,1133,5.488,26.253,280,281,744
2017,7115,17004,17049,49875,48160,3505,21.201,2471,14.947,13819,8229,5590,17.087,28.694,10374,5228,5146,10.856,21.541,3445,7.153,43.082,1603,1603,3625
2017,7121,6637,7124,155076,153215,327,4.604,285,4.012,13122,1788,11334,1.167,8.564,9434,1756,7678,1.146,6.157,3688,2.407,12.315,186,186,1215
2017,7131,2477,3160,225738,219624,683,22.808,352,11.755,29852,7825,22027,3.563,13.592,18212,3837,14375,1.747,8.292,11640,5.3,16.585,271,271,2962
2017,7132,1751,2897,134683,134173,234,8.058,248,8.54,12400,5053,7347,3.766,9.242,11429,4523,6906,3.371,8.518,971,0.724,17.036,114,134,2229
2017,7139,53921,62979,1357839,1340958,7834,12.631,5923,9.55,189329,73288,116041,5.465,14.119,155023,52189,102834,3.892,11.561,34306,2.558,23.121,4478,4499,38360
2017,7211,42045,53303,2049043,2039553,5070,9.578,4334,8.187,226777,94167,132610,4.617,11.119,208549,86741,121808,4.253,10.225,18228,0.894,20.45,2987,3054,46523
2017,7212,5470,6073,46767,45729,516,8.55,440,7.291,8348,1716,6632,3.753,18.256,6284,1826,4458,3.993,13.742,2064,4.514,27.484,276,276,886
2017,7213,1612,1787,9401,9768,112,6.186,159,8.782,1298,346,952,3.542,13.288,2018,1036,982,10.606,20.659,-720,-7.371,26.577,112,124,893
2017,7223,15373,42031,894727,831438,8259,20.673,4098,10.258,229603,113076,116527,13.6,27.615,104334,40259,64075,4.842,12.549,125269,15.067,25.097,1870,1923,10636
2017,7224,35737,36505,363573,360349,3634,9.907,3985,10.864,67009,30803,36206,8.548,18.596,60767,26703,34064,7.41,16.863,6242,1.732,33.727,3242,3257,21410
2017,7225,376686,521409,10739351,10625525,53727,10.404,43728,8.468,1687663,781516,906147,7.355,15.883,1461455,507593,953862,4.777,13.754,226208,2.129,27.508,33553,34873,376190
2017,8111,135049,150088,904082,894901,12925,8.635,12122,8.098,142297,58438,83859,6.53,15.901,123207,45125,78082,5.042,13.768,19090,2.133,27.535,9209,9396,34096
2017,8112,9996,11328,96221,96195,1254,11.065,1265,11.162,16014,6562,9452,6.822,16.648,15944,6307,9637,6.557,16.575,70,0.073,33.15,881,903,3643
2017,8113,18185,20006,201852,199806,1541,7.669,1719,8.554,30748,8212,22536,4.11,15.389,26671,8989,17682,4.499,13.348,4077,2.04,26.697,1182,1199,5144
2017,8114,17700,18581,72413,71467,2280,12.361,2007,10.881,12694,5474,7220,7.659,17.762,10567,4691,5876,6.564,14.786,2127,2.976,29.572,1508,1514,3418
2017,8121,101836,118797,714261,707464,15429,13.153,12450,10.613,129931,62520,67411,8.837,18.366,115907,47110,68797,6.659,16.383,14024,1.982,32.767,9666,9822,36137
2017,8122,14120,20013,142518,141155,914,4.545,1108,5.51,21956,4328,17628,3.066,15.555,18945,6289,12656,4.455,13.421,3011,2.133,26.843,477,511,1845
2017,8123,26697,31945,288881,290916,2362,7.347,2774,8.628,35632,11373,24259,3.909,12.248,39833,13431,26402,4.617,13.692,-4201,-1.444,24.496,2147,2261,9349
2017,8129,30866,40865,320891,315148,5984,14.965,4228,10.573,57454,22771,34683,7.225,18.231,45498,19693,25805,6.249,14.437,11956,3.794,28.874,3012,3052,13654
2017,8131,179046,179724,1690497,1689077,8061,4.496,7191,4.011,132287,22266,110021,1.318,7.832,129610,21535,108075,1.275,7.673,2677,0.158,15.347,4994,4994,15559
2017,8132,16990,18767,191166,189567,1397,7.462,1308,6.986,22414,4522,17892,2.385,11.824,19285,6431,12854,3.392,10.173,3129,1.651,20.346,906,937,3757
2017,8133,14330,16983,181058,177748,1281,7.582,1105,6.54,23425,3786,19639,2.13,13.179,16816,4413,12403,2.483,9.461,6609,3.718,18.921,708,709,2891
2017,8134,22456,24028,218411,217170,1384,5.752,1449,6.022,26746,4857,21889,2.236,12.316,24026,5486,18540,2.526,11.063,2720,1.252,22.126,988,994,3462
2017,8139,52963,55104,487955,490651,2258,4.071,2968,5.352,45649,8996,36653,1.833,9.304,51152,12174,38978,2.481,10.425,-5503,-1.122,18.608,2108,2120,8961
2018,1131,392,417,3605,3709,31,7.201,58,13.473,434,55,379,1.483,11.701,639,264,375,7.118,17.228,-205,-5.527,23.403,39,39,123
2018,1132,131,146,1116,1102,25,17.986,11,7.914,166,45,121,4.083,15.064,147,30,117,2.722,13.339,19,1.724,26.679,9,9,21
2018,1133,7058,7127,48802,48760,640,8.924,729,10.165,6857,1721,5136,3.53,14.063,6766,2402,4364,4.926,13.876,91,0.187,27.752,538,538,1660
2018,1141,1302,1316,5417,5463,210,15.861,226,17.069,1076,416,660,7.616,19.698,1161,744,417,13.62,21.254,-85,-1.556,39.396,138,138,493
2018,1142,303,305,1674,1667,29,9.493,30,9.82,221,64,157,3.84,13.261,193,48,145,2.88,11.581,28,1.68,23.162,22,22,34
2018,1151,3785,4126,67947,68209,430,10.47,392,9.545,9288,4086,5202,5.99,13.617,9779,2785,6994,4.083,14.337,-491,-0.72,27.234,302,302,2078
2018,1152,4029,4111,20620,20416,551,13.602,431,10.639,3269,1343,1926,6.578,16.012,2858,1123,1735,5.501,13.999,411,2.013,27.998,340,340,740
2018,1153,1343,1445,13188,12664,151,10.472,145,10.055,2747,847,1900,6.688,21.691,1683,564,1119,4.454,13.29,1064,8.402,26.579,103,103,351
2018,2111,4336,5588,106915,108641,359,6.318,548,9.644,10342,3255,7087,2.996,9.519,13855,4497,9358,4.139,12.753,-3513,-3.234,19.039,387,402,1607
2018,2121,331,625,49842,49875,38,5.905,75,11.655,6354,780,5574,1.564,12.74,6196,2339,3857,4.69,12.423,158,0.317,24.846,33,36,1004
2018,2122,187,249,35555,36252,33,13.415,27,10.976,1946,407,1539,1.123,5.368,3327,577,2750,1.592,9.178,-1381,-3.809,10.736,22,23,214
2018,2123,2508,4642,86694,86481,219,4.709,237,5.096,10579,2151,8428,2.487,12.233,9877,1911,7966,2.21,11.421,702,0.812,22.842,129,137,985
2018,2131,9553,12139,330080,316564,1493,12.189,1713,13.985,77541,14654,62887,4.629,24.495,49345,26796,22549,8.465,15.588,28196,8.907,31.175,905,939,7875
2018,2211,1793,11328,511434,513445,1616,14.537,1193,10.732,65157,35838,29319,6.98,12.69,68866,33972,34894,6.616,13.413,-3709,-0.722,25.38,85,93,476
2018,2212,383,2426,90397,89789,91,3.707,148,6.03,6081,1640,4441,1.827,6.773,4931,1765,3166,1.966,5.492,1150,1.281,10.984,20,21,257
2018,2213,3446,4633,45877,45046,224,4.832,230,4.961,5534,1754,3780,3.894,12.285,3802,1410,2392,3.13,8.44,1732,3.845,16.881,125,126,376
2018,2361,146583,147997,767001,742928,26198,18.112,19490,13.475,173642,72514,101128,9.761,23.373,125641,53462,72179,7.196,16.912,48001,6.461,33.823,13898,13914,38969
2018,2362,35369,36824,651181,638131,3478,9.454,3407,9.261,104574,18691,85883,2.929,16.388,78091,17273,60818,2.707,12.237,26483,4.15,24.475,2530,2538,12506
2018,2371,15931,17553,610799,598623,1282,7.304,1281,7.298,105026,20572,84454,3.437,17.545,80458,16696,63762,2.789,13.441,24568,4.104,26.881,884,901,8455
2018,2372,3943,4048,21706,21514,409,10.068,438,10.782,3693,1177,2516,5.471,17.166,3271,1296,1975,6.024,15.204,422,1.962,30.408,348,350,955
2018,2373,7769,8632,299134,295786,501,5.788,549,6.342,39268,4416,34852,1.493,13.276,32858,4102,28756,1.387,11.109,6410,2.167,22.217,369,369,2290
2018,2379,3599,3732,68653,66904,384,10.345,344,9.267,13397,4564,8833,6.822,20.024,9698,1921,7777,2.871,14.495,3699,5.529,28.991,239,239,1289
2018,2381,77786,78717,880442,862425,9893,12.689,8391,10.762,167905,42889,125016,4.973,19.469,131869,36050,95819,4.18,15.29,36036,4.178,30.581,5692,5697,25765
2018,2382,163578,168311,2063877,2022368,15785,9.45,13247,7.93,306622,64550,242072,3.192,15.162,223871,61442,162429,3.038,11.07,82751,4.092,22.139,9830,9857,43828
2018,2383,99391,100611,809596,795111,13295,13.353,11204,11.253,151688,48015,103673,6.039,19.078,123062,36662,86400,4.611,15.477,28626,3.6,30.955,8026,8029,27385
2018,2389,58178,58987,639212,628636,7098,12.184,5634,9.671,106579,26497,80082,4.215,16.954,84891,22500,62391,3.579,13.504,21688,3.45,27.008,3840,3844,15705
2018,3111,1128,1750,52117,50907,104,6.001,70,4.039,5856,960,4896,1.886,11.503,3426,1081,2345,2.123,6.73,2430,4.773,13.46,43,43,668
2018,3112,525,873,58954,57980,38,4.348,40,4.577,7192,278,6914,0.479,12.404,4913,1093,3820,1.885,8.474,2279,3.931,16.947,27,28,577
2018,3113,1639,1803,80084,80042,116,6.414,127,7.022,6633,970,5663,1.212,8.287,6650,1550,5100,1.936,8.308,-17,-0.021,16.574,96,100,813
2018,3114,1431,1797,160669,159519,131,7.304,124,6.914,16152,3556,12596,2.229,10.125,13979,3581,10398,2.245,8.763,2173,1.362,17.526,90,92,1291
2018,3115,1080,1586,149246,147694,93,5.895,76,4.818,10850,1893,8957,1.282,7.346,7699,1381,6318,0.935,5.213,3151,2.133,10.426,52,52,847
2018,3116,2684,3328,523716,516711,151,4.524,171,5.123,34376,3606,30770,0.698,6.653,20217,3180,17037,0.615,3.913,14159,2.74,7.825,134,134,1952
2018,3117,409,501,30400,30729,39,7.879,27,5.455,2682,677,2005,2.203,8.728,3318,613,2705,1.995,10.798,-636,-2.07,17.456,22,22,186
2018,3118,9741,10551,293804,293052,938,8.899,917,8.7,31846,8839,23007,3.016,10.867,30449,9657,20792,3.295,10.39,1397,0.477,20.781,731,734,5332
2018,3119,3152,3654,217999,213682,414,11.564,266,7.43,25073,5591,19482,2.617,11.734,16367,3190,13177,1.493,7.66,8706,4.074,15.319,216,216,2065
2018,3121,8158,8871,227365,217068,1294,15.317,448,5.303,35967,11730,24237,5.404,16.57,15243,3851,11392,1.774,7.022,20724,9.547,14.044,343,345,2586
2018,3122,113,137,13221,13434,10,7.117,17,12.1,995,37,958,0.275,7.407,1387,179,1208,1.332,10.325,-392,-2.918,14.813,13,13,131
2018,3131,205,260,22693,23081,18,6.716,34,12.687,1785,201,1584,0.871,7.734,2620,709,1911,3.072,11.352,-835,-3.618,15.468,24,24,357
2018,3132,705,789,45556,45261,36,4.523,50,6.281,3821,629,3192,1.39,8.442,3269,708,2561,1.564,7.223,552,1.22,14.445,43,43,597
2018,3133,746,784,26610,26865,67,8.601,57,7.317,2165,375,1790,1.396,8.059,2709,561,2148,2.088,10.084,-544,-2.025,16.118,44,44,453
2018,3141,1458,1558,49448,50397,85,5.397,119,7.556,3947,854,3093,1.695,7.832,6003,1162,4841,2.306,11.912,-2056,-4.08,15.664,93,93,667
2018,3149,3676,3772,56721,56595,303,8.038,298,7.906,6081,1812,4269,3.202,10.745,5899,1508,4391,2.665,10.423,182,0.322,20.846,231,231,982
2018,3151,197,205,10887,11115,13,6.295,16,7.748,643,70,573,0.63,5.785,1129,258,871,2.321,10.158,-486,-4.373,11.57,12,12,109
2018,3152,4052,4102,65243,68706,603,14.429,757,18.114,10025,4715,5310,6.863,14.591,17152,7881,9271,11.471,24.965,-7127,-10.373,29.183,682,682,7122
2018,3159,501,507,8029,8133,65,12.884,60,11.893,858,261,597,3.209,10.55,1073,379,694,4.66,13.193,-215,-2.644,21.099,44,44,156
2018,3161,151,159,3306,3449,11,6.854,14,8.723,182,29,153,0.841,5.278,476,60,416,1.74,13.803,-294,-8.525,10.555,11,11,24
2018,3162,194,210,11336,11760,16,7.656,14,6.699,810,388,422,3.299,6.888,1657,113,1544,0.961,14.091,-847,-7.203,13.776,11,11,22
2018,3169,696,702,11327,11421,62,8.714,81,11.384,1196,307,889,2.688,10.472,1383,489,894,4.282,12.11,-187,-1.637,20.945,70,70,434
2018,3211,2561,3019,92184,91173,191,6.292,224,7.379,9486,2749,6737,3.015,10.404,7400,2803,4597,3.074,8.116,2086,2.288,16.233,157,157,1194
2018,3212,1036,1407,79223,78875,55,3.909,55,3.909,7748,989,6759,1.254,9.823,7121,1395,5726,1.769,9.028,627,0.795,18.056,40,40,737
2018,3219,8025,9133,244237,241446,687,7.538,649,7.121,26827,7200,19627,2.982,11.111,21576,6343,15233,2.627,8.936,5251,2.175,17.872,493,495,4058
2018,3221,233,448,98671,99449,18,4.045,12,2.697,4170,550,3620,0.553,4.193,5625,839,4786,0.844,5.656,-1455,-1.463,8.386,4,4,360
2018,3222,2166,3446,243996,243205,97,2.785,170,4.882,17960,2766,15194,1.137,7.385,16345,4375,11970,1.799,6.721,1615,0.664,13.441,129,129,2900
2018,3231,21929,23324,433493,443002,1273,5.387,1891,8.002,36176,7702,28474,1.739,8.166,54596,17855,36741,4.03,12.324,-18420,-4.158,16.332,1479,1488,10092
2018,3241,885,2055,106934,106191,52,2.509,87,4.198,6663,628,6035,0.591,6.275,5110,752,4358,0.708,4.812,1553,1.462,9.624,46,46,336
2018,3251,1179,2352,154393,155404,84,3.553,109,4.61,10479,1871,8608,1.204,6.743,12464,5591,6873,3.598,8.02,-1985,-1.277,13.486,54,57,1037
2018,3252,1054,1404,105593,103491,64,4.555,66,4.698,12418,1635,10783,1.58,11.999,8497,3548,4949,3.428,8.21,3921,3.789,16.421,42,46,1692
2018,3253,680,932,31936,31392,55,5.911,52,5.588,3234,804,2430,2.561,10.302,2128,312,1816,0.994,6.779,1106,3.523,13.558,39,39,195
2018,3254,1763,2288,255505,253727,212,9.368,162,7.159,24776,3229,21547,1.273,9.765,20880,4604,16276,1.815,8.229,3896,1.536,16.459,115,115,2100
2018,3255,1297,1652,64362,63911,77,4.623,104,6.244,7404,1251,6153,1.957,11.585,6574,3391,3183,5.306,10.286,830,1.299,20.573,63,86,3129
2018,3256,1949,2150,100062,100740,146,6.794,144,6.701,10252,2172,8080,2.156,10.177,11558,4623,6935,4.589,11.473,-1306,-1.296,20.353,94,98,2429
2018,3259,1639,2110,83929,83533,116,5.437,163,7.64,7557,1324,6233,1.585,9.047,6749,1480,5269,1.772,8.079,808,0.967,16.159,106,107,691
2018,3261,7443,9861,648750,642477,336,3.383,476,4.793,58209,9356,48853,1.456,9.06,46011,9821,36190,1.529,7.162,12198,1.899,14.323,346,350,5838
2018,3262,1356,1803,136971,135725,94,5.243,74,4.127,11049,1963,9086,1.446,8.141,8610,1097,7513,0.808,6.344,2439,1.797,12.687,52,52,481
2018,3271,821,1004,35378,34815,68,6.7,90,8.867,3754,723,3031,2.077,10.783,2698,1216,1482,3.493,7.75,1056,3.033,15.499,65,66,554
2018,3272,1322,1583,94723,94216,115,7.26,117,7.386,6943,1608,5335,1.707,7.369,5875,1167,4708,1.239,6.236,1068,1.134,12.471,89,89,597
2018,3273,3813,8430,174650,173620,368,4.352,418,4.944,22255,5554,16701,3.199,12.818,19990,4385,15605,2.526,11.514,2265,1.305,23.027,186,194,1989
2018,3274,151,299,14485,14171,26,8.904,12,4.11,1104,254,850,1.792,7.791,508,80,428,0.565,3.585,596,4.206,7.17,6,6,26
2018,3279,2640,3110,81371,80832,167,5.364,174,5.589,8458,2819,5639,3.488,10.464,7427,1706,5721,2.111,9.188,1031,1.275,18.376,126,129,1116
2018,3311,271,409,86658,86793,34,8.479,18,4.489,5394,2328,3066,2.682,6.215,5608,109,5499,0.126,6.461,-214,-0.247,12.43,14,14,77
2018,3312,529,700,50957,50277,41,5.908,29,4.179,5167,622,4545,1.237,10.277,3737,395,3342,0.786,7.433,1430,2.844,14.866,16,16,187
2018,3313,351,484,60283,59262,22,4.564,18,3.734,4604,522,4082,0.881,7.769,2469,377,2092,0.636,4.166,2135,3.603,8.332,11,12,198
2018,3314,638,819,57400,56806,26,3.15,39,4.724,4275,544,3731,0.958,7.526,3013,486,2527,0.856,5.304,1262,2.222,10.608,26,26,220
2018,3315,1353,1545,118315,116890,49,3.133,87,5.563,11721,1223,10498,1.046,10.027,8700,2567,6133,2.196,7.443,3021,2.584,14.886,70,72,1506
2018,3321,2002,2262,107237,106155,64,2.807,100,4.386,8754,772,7982,0.727,8.246,6547,1737,4810,1.636,6.167,2207,2.079,12.335,71,71,814
2018,3322,953,1027,34550,34306,35,3.356,67,6.424,2732,356,2376,1.038,7.964,2265,653,1612,1.903,6.602,467,1.361,13.205,58,58,580
2018,3323,11857,12900,376325,369699,756,5.868,723,5.612,45063,9936,35127,2.688,12.189,31939,9105,22834,2.463,8.639,13124,3.55,17.278,552,558,6314
2018,3324,1136,1450,86762,86014,53,3.613,87,5.93,8491,685,7806,0.796,9.872,7019,2160,4859,2.511,8.16,1472,1.711,16.321,57,57,818
2018,3325,508,553,28267,28306,21,3.747,36,6.423,2343,123,2220,0.435,8.277,2510,512,1998,1.809,8.867,-167,-0.59,16.555,31,31,238
2018,3326,919,1074,38281,38188,42,3.885,56,5.18,3269,728,2541,1.906,8.56,3153,972,2181,2.545,8.257,116,0.304,16.513,44,45,546
2018,3327,21271,21839,377937,373233,1051,4.785,1303,5.932,41019,8559,32460,2.293,10.99,31469,10386,21083,2.783,8.431,9550,2.559,16.863,1017,1026,7045
2018,3328,4845,5407,130043,128850,250,4.619,262,4.84,14658,3840,10818,2.98,11.376,12427,2595,9832,2.014,9.645,2231,1.731,19.289,213,218,1440
2018,3329,5228,5783,255853,254152,420,7.28,393,6.812,25249,6845,18404,2.693,9.935,21783,5535,16248,2.178,8.571,3466,1.364,17.142,293,294,2324
2018,3331,2368,2759,189023,186442,148,5.355,158,5.716,17655,1652,16003,0.886,9.469,12314,3007,9307,1.613,6.605,5341,2.865,13.21,96,96,896
2018,3332,2768,2944,109839,108807,146,4.958,147,4.992,10140,1486,8654,1.366,9.319,8142,1752,6390,1.61,7.483,1998,1.836,14.966,121,121,1062
2018,3333,1664,1794,71351,70980,100,5.545,119,6.598,6093,1572,4521,2.215,8.584,5420,1180,4240,1.662,7.636,673,0.948,15.272,93,93,932
2018,3334,1362,1623,128848,128527,59,3.611,81,4.957,8705,879,7826,0.684,6.773,8137,2289,5848,1.781,6.331,568,0.442,12.662,60,60,1083
2018,3335,5964,6222,150780,150649,240,3.832,323,5.157,12507,2843,9664,1.887,8.302,12222,3254,8968,2.16,8.113,285,0.189,16.226,247,248,2225
2018,3336,766,974,106661,106283,37,3.762,56,5.694,12907,4032,8875,3.794,12.144,11990,2429,9561,2.285,11.281,917,0.863,22.563,25,25,253
2018,3339,4982,5827,307736,302087,404,7.014,270,4.688,29988,5514,24474,1.825,9.927,18624,4888,13736,1.618,6.165,11364,3.762,12.33,189,190,2096
2018,3341,797,827,40312,39728,59,7.003,90,10.682,5293,371,4922,0.934,13.323,3968,577,3391,1.452,9.988,1325,3.335,19.976,67,67,435
2018,3342,1061,1169,74156,76476,66,5.577,95,8.027,4254,798,3456,1.043,5.563,8950,1005,7945,1.314,11.703,-4696,-6.141,11.125,72,72,469
2018,3343,401,417,9021,9151,34,8.105,39,9.297,939,202,737,2.207,10.261,1203,704,499,7.693,13.146,-264,-2.885,20.522,31,31,182
2018,3344,3184,3631,265483,265452,162,4.426,221,6.037,18095,2357,15738,0.888,6.817,17999,5619,12380,2.117,6.781,96,0.036,13.561,174,177,2289
2018,3345,4100,4927,383067,386100,394,8.03,353,7.195,29683,7154,22529,1.853,7.688,35531,5773,29758,1.495,9.203,-5848,-1.515,15.376,251,252,2555
2018,3346,365,373,7861,7953,24,6.186,54,13.918,1116,396,720,4.98,14.033,1352,736,616,9.255,17.001,-236,-2.968,28.067,44,44,341
2018,3351,956,1026,42746,43184,67,6.518,71,6.907,3810,1130,2680,2.617,8.823,4665,1387,3278,3.212,10.803,-855,-1.98,17.646,53,53,457
2018,3352,232,279,51290,51189,23,8.394,13,4.745,2670,809,1861,1.58,5.216,2363,370,1993,0.723,4.616,307,0.6,9.232,9,9,32
2018,3353,1648,1984,117369,115232,154,7.857,106,5.408,11646,3006,8640,2.609,10.107,7299,1569,5730,1.362,6.334,4347,3.772,12.668,75,75,628
2018,3359,1689,1968,134489,134064,94,4.749,117,5.911,10529,1527,9002,1.139,7.854,9827,2730,7097,2.036,7.33,702,0.524,14.66,90,91,907
2018,3361,243,297,212938,209748,27,9.199,20,6.814,12710,573,12137,0.273,6.06,6967,232,6735,0.111,3.322,5743,2.738,6.643,18,18,132
2018,3362,1507,1839,169123,162110,129,7.024,124,6.752,22707,3968,18739,2.448,14.007,8964,3124,5840,1.927,5.53,13743,8.478,11.059,92,94,1363
2018,3363,3615,4610,590795,585076,233,5.049,242,5.244,48101,5079,43022,0.868,8.221,36669,5615,31054,0.96,6.267,11432,1.954,12.535,175,175,3131
2018,3364,1227,1829,377664,373102,262,14.95,109,6.22,29176,9049,20127,2.425,7.82,21360,3779,17581,1.013,5.725,7816,2.095,11.45,78,78,1209
2018,3365,148,230,27149,28008,14,6.167,8,3.524,1258,89,1169,0.318,4.492,2905,239,2666,0.853,10.372,-1647,-5.88,8.983,3,3,122
2018,3366,1239,1366,137319,136980,118,8.68,105,7.723,11849,2490,9359,1.818,8.65,11398,1822,9576,1.33,8.321,451,0.329,16.642,85,85,1330
2018,3369,750,778,33586,33110,76,9.725,83,10.621,3487,436,3051,1.317,10.532,2516,916,1600,2.767,7.599,971,2.933,15.198,67,67,373
2018,3371,9181,9433,225709,224248,584,6.143,733,7.71,19909,4891,15018,2.181,8.878,16810,4148,12662,1.85,7.496,3099,1.382,14.992,582,583,3359
2018,3372,3426,3564,117208,117097,212,5.956,203,5.703,10952,2009,8943,1.716,9.353,10828,2455,8373,2.097,9.247,124,0.106,18.494,159,159,1591
2018,3379,583,681,33238,33112,33,4.745,62,8.914,4174,253,3921,0.764,12.606,3904,1690,2214,5.104,11.79,270,0.815,23.581,44,44,453
2018,3391,8367,9288,285783,282510,550,5.85,777,8.265,26957,6276,20681,2.222,9.542,20705,6796,13909,2.406,7.329,6252,2.213,14.658,641,642,4131
2018,3399,13551,14384,267125,261785,1598,11.165,1455,10.166,37656,17714,19942,6.767,14.384,27637,8278,19359,3.162,10.557,10019,3.827,21.114,1198,1201,6398
2018,4231,14311,22299,407211,405167,1353,6.044,1523,6.804,40358,9805,30553,2.42,9.961,36521,10359,26162,2.557,9.014,3837,0.947,18.028,1015,1107,6669
2018,4232,9985,11989,166515,167035,740,6.117,956,7.903,17671,3642,14029,2.18,10.579,18685,5925,12760,3.547,11.186,-1014,-0.607,21.158,724,764,4802
2018,4233,9385,16604,256094,251155,880,5.281,996,5.978,31591,4803,26788,1.912,12.578,21950,7941,14009,3.162,8.74,9641,3.839,17.479,597,656,5048
2018,4234,20718,32338,642834,644670,3270,10.133,3134,9.712,73508,17522,55986,2.718,11.402,76817,25592,51225,3.97,11.916,-3309,-0.513,22.805,1494,1545,9505
2018,4235,6632,9103,150893,150699,362,3.947,500,5.451,14859,2042,12817,1.355,9.86,14287,3548,10739,2.354,9.48,572,0.38,18.961,349,364,1832
2018,4236,17226,27131,520702,520022,1513,5.531,1960,7.165,56506,8549,47957,1.644,10.866,55232,13639,41593,2.623,10.621,1274,0.245,21.242,1246,1283,7462
2018,4237,9409,18822,255113,251693,738,3.907,868,4.596,27650,8994,18656,3.573,10.986,20608,5444,15164,2.163,8.188,7042,2.798,16.376,520,553,3293
2018,4238,37354,54480,766224,761142,2284,4.149,3421,6.215,82789,12780,70009,1.679,10.877,72860,26193,46667,3.441,9.572,9929,1.304,19.145,2029,2174,12916
2018,4239,25666,28912,325135,324016,2340,8.029,2807,9.631,40521,9620,30901,2.969,12.506,38300,13308,24992,4.107,11.82,2221,0.685,23.641,2169,2195,9416
2018,4241,6589,8738,150423,149322,309,3.434,831,9.234,17774,2518,15256,1.686,11.903,15126,6194,8932,4.148,10.13,2648,1.773,20.26,416,438,2155
2018,4242,6279,9586,311097,312671,714,7.457,692,7.227,27458,3786,23672,1.211,8.782,30456,6670,23786,2.133,9.741,-2998,-0.959,17.564,521,537,4392
2018,4243,12476,13503,196204,198353,1158,8.419,1661,12.076,23046,6058,16988,3.054,11.619,27602,9654,17948,4.867,13.915,-4556,-2.297,23.237,1363,1391,7223
2018,4244,24983,32713,855749,845286,2516,7.677,2640,8.055,97372,29843,67529,3.531,11.519,75343,28614,46729,3.385,8.913,22029,2.606,17.827,1788,1803,12326
2018,4245,3102,5836,60543,62267,205,3.476,328,5.562,7076,1392,5684,2.236,11.364,10630,2549,8081,4.094,17.072,-3554,-5.708,22.728,170,181,950
2018,4246,7500,11776,162311,162352,421,3.505,894,7.442,16796,1964,14832,1.21,10.345,16792,7378,9414,4.544,10.343,4,0.002,20.686,426,440,2401
2018,4247,3720,6126,100690,99890,220,3.564,313,5.071,13274,3107,10167,3.11,13.289,11557,3650,7907,3.654,11.57,1717,1.719,23.14,177,185,1550
2018,4248,3204,4216,200616,202171,309,7.337,300,7.123,12908,2859,10049,1.414,6.385,16153,2950,13203,1.459,7.99,-3245,-1.605,12.769,218,223,1873
2018,4249,19292,26120,341651,342484,1742,6.617,2157,8.193,39219,8640,30579,2.523,11.451,40929,14382,26547,4.199,11.951,-1710,-0.499,22.903,1518,1570,9419
2018,4251,31671,33847,285118,286807,3449,10.144,3759,11.055,28370,11076,17294,3.862,9.892,31839,11941,19898,4.163,11.101,-3469,-1.21,19.783,2912,2935,9228
2018,4411,37260,43554,1331702,1331168,3312,7.581,3576,8.186,121457,41548,79909,3.121,9.124,120337,36947,83390,2.776,9.04,1120,0.084,18.08,2832,2894,28837
2018,4412,11050,12835,152455,152004,769,5.974,846,6.572,17667,5311,12356,3.494,11.623,16551,6135,10416,4.036,10.889,1116,0.734,21.777,662,687,4941
2018,4413,25689,55627,524600,530680,2307,4.138,2559,4.59,46815,11971,34844,2.256,8.822,58027,12332,45695,2.324,10.934,-11212,-2.113,17.643,1734,1859,7984
2018,4421,12421,21877,207981,208069,1243,5.632,1627,7.372,24196,7694,16502,3.698,11.629,24597,7188,17409,3.455,11.822,-401,-0.193,23.258,1114,1193,5211
2018,4422,17176,25419,262997,258020,1565,6.14,1703,6.682,45247,11559,33688,4.48,17.536,36680,7365,29315,2.854,14.216,8567,3.32,28.432,1153,1187,4055
2018,4431,16738,26625,311277,314683,1361,4.928,3345,12.112,35277,5670,29607,1.802,11.21,42461,20100,22361,6.387,13.493,-7184,-2.283,22.421,1986,2440,13199
2018,4441,32961,54909,1204008,1174643,2216,4.02,2660,4.825,110731,13806,96925,1.175,9.427,52186,13955,38231,1.188,4.443,58545,4.984,8.885,1836,1933,9939
2018,4442,12051,16168,155607,156449,868,5.35,980,6.04,18004,5101,12903,3.26,11.508,19886,4655,15231,2.975,12.711,-1882,-1.203,23.016,705,735,3528
2018,4451,59957,86337,2751137,2773259,7691,8.922,7428,8.617,202249,86152,116097,3.107,7.293,250450,69449,181001,2.504,9.031,-48201,-1.738,14.586,5567,5741,36641
2018,4452,16187,20067,164212,163350,2129,10.608,2133,10.628,29893,12633,17260,7.734,18.3,28030,10041,17989,6.147,17.159,1863,1.14,34.319,1545,1634,7428
2018,4453,28259,32304,174789,172521,2485,7.722,2241,6.964,26098,9002,17096,5.218,15.127,21526,7378,14148,4.277,12.477,4572,2.65,24.955,1779,1797,5906
2018,4461,39274,89456,1039814,1026382,5038,5.532,8256,9.066,212196,33087,179109,3.224,20.674,185183,113534,71649,11.062,18.042,27013,2.632,36.085,3165,3441,16735
2018,4471,61496,107858,974187,960217,7273,6.751,7012,6.509,146570,48817,97753,5.084,15.264,115877,38092,77785,3.967,12.068,30693,3.196,24.136,4563,4892,23630
2018,4481,31872,89299,1340548,1364955,5872,6.51,7677,8.511,160592,52526,108066,3.848,11.765,208144,54664,153480,4.005,15.249,-47552,-3.484,23.531,3657,4322,19432
2018,4482,4619,23045,239881,241786,976,4.138,2060,8.734,24263,7139,17124,2.953,10.035,28173,9730,18443,4.024,11.652,-3910,-1.617,20.07,445,483,2012
2018,4483,13883,20751,119966,121491,1149,5.476,1615,7.696,14710,4295,10415,3.535,12.108,17880,6055,11825,4.984,14.717,-3170,-2.609,24.216,1007,1042,3128
2018,4511,23536,34016,454074,452624,2275,6.626,2916,8.492,50061,12396,37665,2.739,11.06,47528,13106,34422,2.896,10.501,2533,0.56,21.001,2145,2291,8525
2018,4512,3231,7041,76894,83522,442,6.086,885,12.186,6525,2578,3947,3.087,7.812,19823,4862,14961,5.821,23.734,-13298,-15.922,15.625,307,577,3206
2018,4522,45,4175,456781,466882,74,1.74,228,5.362,18981,1309,17672,0.28,4.065,38062,15168,22894,3.249,8.152,-19081,-4.087,8.131,0,0,0
2018,4523,6954,48023,2211776,2219264,2027,4.252,1317,2.763,81403,15235,66168,0.686,3.668,96851,23200,73651,1.045,4.364,-15448,-0.696,7.336,790,815,2765
2018,4531,10858,11315,55422,55756,816,7.105,1156,10.065,8292,2544,5748,4.563,14.872,8996,3431,5565,6.154,16.135,-704,-1.263,29.744,925,936,2801
2018,4532,15405,23874,198279,204162,1557,6.403,2446,10.058,22781,6765,16016,3.314,11.158,34971,11715,23256,5.738,17.129,-12190,-5.971,22.317,1640,1759,7033
2018,4533,12148,18226,201488,199501,1245,6.737,1755,9.496,25595,5909,19686,2.962,12.83,21961,7292,14669,3.655,11.008,3634,1.822,22.016,1288,1365,4781
2018,4539,33749,45642,301845,295681,4704,10.385,4011,8.855,50487,21571,28916,7.295,17.075,38348,14028,24320,4.744,12.969,12139,4.105,25.939,3063,3195,11252
2018,4541,33867,35543,559414,552845,5737,16.4,4616,13.195,77871,27419,50452,4.96,14.086,65675,24672,41003,4.463,11.879,12196,2.206,23.759,3763,3794,15628
2018,4542,2800,3361,41524,41553,295,8.707,349,10.301,3437,896,2541,2.156,8.271,3507,1383,2124,3.328,8.44,-70,-0.168,16.543,298,304,1263
2018,4543,21394,26381,176645,176441,2507,9.426,2940,11.054,24949,8110,16839,4.596,14.14,24762,9952,14810,5.64,14.034,187,0.106,28.068,2019,2068,7434
2018,4811,428,2153,436748,433755,100,4.611,131,6.041,24818,1898,22920,0.438,5.722,19281,3813,15468,0.879,4.445,5537,1.277,8.89,42,47,914
2018,4812,1744,1982,43166,42487,189,9.469,217,10.872,5722,755,4967,1.777,13.468,4329,1093,3236,2.573,10.189,1393,3.279,20.378,154,158,873
2018,4831,672,1029,45607,44676,103,9.99,107,10.378,5620,712,4908,1.594,12.58,3827,1298,2529,2.905,8.566,1793,4.013,17.132,57,57,212
2018,4832,478,553,20663,20682,48,8.711,44,7.985,2175,578,1597,2.795,10.517,2125,718,1407,3.472,10.275,50,0.242,20.55,30,31,494
2018,4841,58800,69990,1029006,1009105,12432,18.336,8053,11.877,146027,53287,92740,5.281,14.471,104654,30581,74073,3.031,10.371,41373,4.1,20.742,6046,6078,20804
2018,4842,38963,42661,482099,479757,5095,11.976,4861,11.426,70057,20555,49502,4.284,14.603,65440,20930,44510,4.363,13.64,4617,0.962,27.281,3677,3710,15204
2018,4851,502,802,58337,57285,58,7.255,53,6.629,4996,1064,3932,1.857,8.721,2941,906,2035,1.582,5.134,2055,3.587,10.268,28,28,497
2018,4852,247,534,17215,15265,101,19.921,47,9.27,5585,3084,2501,20.204,36.588,1527,382,1145,2.503,10.004,4058,26.585,20.007,26,36,178
2018,4853,6426,6606,72557,73411,1021,15.294,1161,17.391,12083,4994,7089,6.803,16.459,13823,5169,8654,7.041,18.83,-1740,-2.37,32.919,982,986,4297
2018,4854,2387,4084,232738,235697,245,5.955,306,7.437,21408,5174,16234,2.195,9.083,28196,13254,14942,5.623,11.963,-6788,-2.88,18.166,164,169,4280
2018,4855,1004,1136,32073,32781,95,8.279,118,10.283,3222,597,2625,1.821,9.829,4448,1653,2795,5.043,13.569,-1226,-3.74,19.658,93,96,925
2018,4859,4482,4948,101551,101187,775,15.854,656,13.419,15170,4125,11045,4.077,14.992,14381,6400,7981,6.325,14.212,789,0.78,28.425,475,489,4586
2018,4861,78,764,12802,12951,45,5.852,55,7.152,935,388,547,2.996,7.22,1236,461,775,3.56,9.544,-301,-2.324,14.439,4,4,60
2018,4862,109,1962,26273,26817,69,3.382,226,11.076,2775,622,2153,2.319,10.348,3894,1766,2128,6.585,14.521,-1119,-4.173,20.696,9,9,109
2018,4869,77,682,8372,8458,17,2.443,45,6.466,550,71,479,0.839,6.503,763,452,311,5.344,9.022,-213,-2.518,13.006,3,3,5
2018,4871,556,600,11406,11149,81,13.534,78,13.033,2102,547,1555,4.906,18.854,1571,615,956,5.516,14.091,531,4.763,28.182,61,62,575
2018,4872,1306,1353,14411,14650,192,14.344,163,12.178,1717,511,1206,3.488,11.721,2221,943,1278,6.437,15.161,-504,-3.44,23.441,116,117,760
2018,4879,179,210,3392,3359,25,12.225,14,6.846,242,59,183,1.757,7.206,181,26,155,0.774,5.389,61,1.816,10.779,11,11,23
2018,4881,3835,5689,208116,203270,454,8.004,420,7.405,30176,6642,23534,3.268,14.845,20657,6205,14452,3.053,10.162,9519,4.683,20.325,247,249,1818
2018,4882,534,1448,41945,41637,79,5.387,116,7.91,4876,1094,3782,2.628,11.711,4333,1226,3107,2.945,10.407,543,1.304,20.813,22,22,165
2018,4883,1720,2273,94859,92073,125,5.451,165,7.196,13303,1108,12195,1.203,14.448,7348,1807,5541,1.963,7.981,5955,6.468,15.961,94,95,433
2018,4884,9636,11158,103317,102841,1261,11.328,1208,10.852,16167,5423,10744,5.273,15.72,15321,6167,9154,5.997,14.898,846,0.823,29.796,794,810,3718
2018,4885,13449,19337,267702,265393,1442,7.404,1719,8.826,37963,9290,28673,3.5,14.304,33138,13006,20132,4.901,12.486,4825,1.818,24.973,978,1007,4838
2018,4889,1608,1752,19982,19213,203,11.63,190,10.885,4309,1540,2769,8.015,22.428,2767,929,1838,4.835,14.402,1542,8.026,28.803,154,154,702
2018,4921,3740,9409,620307,605512,615,6.53,632,6.711,70396,9205,61191,1.52,11.626,40687,8897,31790,1.469,6.719,29709,4.906,13.439,417,447,4484
2018,4922,3388,3957,55569,51596,594,15.116,539,13.717,14878,6496,8382,12.59,28.836,6902,3694,3208,7.16,13.377,7976,15.459,26.754,443,443,3168
2018,4931,7595,16189,967911,942177,1248,7.747,1091,6.772,124319,40872,83447,4.338,13.195,73039,21270,51769,2.258,7.752,51280,5.443,15.504,397,422,4516
2018,5111,10461,14473,349358,356765,786,5.27,1669,11.19,38815,9479,29336,2.657,10.88,54908,17364,37544,4.867,15.391,-16093,-4.511,21.759,850,921,5777
2018,5112,9012,12372,624574,613091,1970,16.397,1255,10.446,95273,31797,63476,5.186,15.54,71246,21721,49525,3.543,11.621,24027,3.919,23.242,808,840,7774
2018,5121,14096,17355,305143,306436,2104,12.11,2142,12.329,35905,12345,23560,4.029,11.717,37978,11533,26445,3.764,12.393,-2073,-0.676,23.434,1468,1481,7946
2018,5122,2748,2933,22982,22443,376,12.863,356,12.179,3966,1786,2180,7.958,17.672,2907,936,1971,4.171,12.953,1059,4.719,25.906,251,255,574
2018,5151,3768,7094,199965,204059,238,3.309,434,6.034,12090,2875,9215,1.409,5.925,20698,4733,15965,2.319,10.143,-8608,-4.218,11.85,246,259,1331
2018,5152,336,653,50467,50658,33,4.944,62,9.288,2872,646,2226,1.275,5.669,3283,905,2378,1.786,6.481,-411,-0.811,11.339,27,28,145
2018,5173,6825,55763,1062582,1056160,5303,9.638,3823,6.948,146695,56903,89792,5.388,13.889,134097,39494,94603,3.739,12.697,12598,1.193,25.393,727,977,6016
2018,5174,301,400,9005,8983,83,21.503,55,14.249,1762,774,988,8.616,19.615,1762,1094,668,12.179,19.615,0,0,39.23,47,48,1039
2018,5179,2877,3877,67492,63246,624,16.359,499,13.082,16988,11272,5716,17.823,26.86,8945,2913,6032,4.606,14.143,8043,12.717,28.287,316,332,2099
2018,5182,9490,16299,555371,544488,2100,13.088,1592,9.922,91317,23741,67576,4.36,16.771,69396,25504,43892,4.684,12.745,21921,4.026,25.49,898,932,10561
2018,5191,8579,10684,311734,305886,1442,13.543,1369,12.857,54439,19918,34521,6.512,17.797,41902,13236,28666,4.327,13.699,12537,4.099,27.397,877,983,9068
2018,5211,12,58,19785,19761,0,0,0,0,347,0,347,0,1.756,301,0,301,0,1.523,46,0.233,3.046,0,0,0
2018,5221,10473,115524,1944733,1957985,2926,2.509,5148,4.414,163694,29305,134389,1.497,8.36,192222,39498,152724,2.017,9.817,-28528,-1.457,16.721,400,1054,11329
2018,5222,13311,44941,644908,641428,4342,9.701,3974,8.879,100031,28731,71300,4.479,15.595,93788,34114,59674,5.318,14.622,6243,0.973,29.244,1045,1199,9239
2018,5223,11117,24459,279747,279765,1577,6.393,1995,8.087,35978,10411,25567,3.721,12.86,35951,12462,23489,4.454,12.85,27,0.01,25.701,1009,1161,5717
2018,5231,9190,27296,352694,352566,3541,13.102,3001,11.104,53523,18641,34882,5.287,15.181,52804,11379,41425,3.227,14.977,719,0.204,29.954,737,776,3070
2018,5232,13,34,9769,7849,(D),(D),(D),(D),4744,(D),428,(D),60.441,804,(D),684,(D),10.243,3940,50.197,20.487,0,0,0
2018,5239,46074,65679,565220,554705,6611,10.128,5803,8.89,82479,32450,50029,5.85,14.869,62281,23798,38483,4.29,11.228,20198,3.641,22.456,3687,3710,13372
2018,5241,5375,32687,1549267,1565920,4701,14.528,4042,12.492,190272,75601,114671,4.828,12.151,226085,75522,150563,4.823,14.438,-35813,-2.287,24.302,286,297,2991
2018,5242,118515,135602,1083512,1050329,12798,9.472,11832,8.757,227228,115352,111876,10.982,21.634,157880,63535,94345,6.049,15.031,69348,6.603,30.063,8266,8399,29203
2018,5259,761,783,5345,5178,244,33.265,145,19.768,2590,2174,416,41.989,50.024,2288,1952,336,37.702,44.191,302,5.833,88.382,124,124,1872
2018,5311,86008,114207,570235,563570,10953,9.623,10175,8.94,100573,47867,52706,8.494,17.846,87981,36540,51441,6.484,15.611,12592,2.234,31.223,7402,7622,24474
2018,5312,81920,96932,325878,319172,16906,17.934,11574,12.278,73792,35583,38209,11.149,23.12,59992,30527,29465,9.564,18.796,13800,4.324,37.592,6332,6428,11845
2018,5313,71062,92046,754154,747385,9928,10.93,7507,8.264,103496,37159,66337,4.972,13.848,89974,35253,54721,4.717,12.039,13522,1.809,24.077,4959,5099,21317
2018,5321,3352,15487,172196,166611,990,6.395,976,6.305,26185,4053,22132,2.433,15.716,15653,4572,11081,2.744,9.395,10532,6.321,18.79,370,385,1828
2018,5322,6882,16809,133481,135160,909,5.255,1889,10.92,17252,3344,13908,2.474,12.764,20698,8901,11797,6.586,15.314,-3446,-2.55,25.528,715,761,4381
2018,5323,1980,2800,18397,18557,219,7.84,206,7.374,2359,677,1682,3.648,12.713,2691,964,1727,5.195,14.502,-332,-1.789,25.425,151,158,696
2018,5324,7373,14599,192812,189181,1299,8.998,974,6.747,27815,7786,20029,4.116,14.703,20629,6216,14413,3.286,10.904,7186,3.798,21.809,510,536,2860
2018,5331,2165,2344,39050,38820,272,11.664,248,10.635,4600,1496,3104,3.854,11.85,4136,1446,2690,3.725,10.654,464,1.195,21.309,182,182,917
2018,5411,155302,167244,1148052,1150130,11985,7.138,13311,7.928,118896,31824,87072,2.767,10.338,123095,38260,84835,3.327,10.703,-4199,-0.365,20.675,10088,10208,27942
2018,5412,99467,119528,1154756,1151591,9886,8.287,9409,7.888,134813,37533,97280,3.259,11.707,127368,46526,80842,4.04,11.06,7445,0.646,22.12,6685,6801,33462
2018,5413,81849,101476,1529980,1513206,8479,8.371,8118,8.014,194162,53768,140394,3.553,12.831,162184,48811,113373,3.226,10.718,31978,2.113,21.436,5288,5386,21217
2018,5414,26902,27283,122170,121111,3676,13.57,3289,12.141,19575,7740,11835,6.391,16.163,17528,8159,9369,6.737,14.473,2047,1.69,28.945,2395,2398,6334
2018,5415,98948,118765,1903492,1873080,15239,12.644,18755,15.561,298576,70432,228144,3.76,15.94,238319,109095,129224,5.824,12.723,60257,3.217,25.447,11540,11637,45486
2018,5416,129373,140025,1344574,1313697,24778,17.991,20176,14.65,257244,93070,164174,7.085,19.582,195968,80364,115604,6.117,14.917,61276,4.664,29.835,15073,15229,53775
2018,5417,13674,17035,740934,728435,2101,12.45,1781,10.554,87625,16336,71289,2.243,12.029,62058,16354,45704,2.245,8.519,25567,3.51,17.039,1155,1178,8118
2018,5418,28377,32477,473555,475965,3302,10.121,3597,11.025,55846,20606,35240,4.329,11.733,60839,23882,36957,5.018,12.782,-4993,-1.049,23.466,2682,2735,17669
2018,5419,55155,62428,669595,655148,6959,11.208,6282,10.118,106399,36494,69905,5.57,16.24,77079,36160,40919,5.519,11.765,29320,4.475,23.53,4382,4625,29267
2018,5511,25733,53897,3525854,3518153,2384,4.368,3739,6.851,452104,82546,369558,2.346,12.851,435366,133482,301884,3.794,12.375,16738,0.476,24.75,856,891,19112
2018,5611,26768,29504,498839,489374,3260,11.087,3062,10.413,84949,26434,58515,5.402,17.359,66798,23253,43545,4.752,13.65,18151,3.709,27.299,2291,2303,17163
2018,5612,1998,6060,271171,274509,256,4.069,718,11.413,29586,4064,25522,1.48,10.778,36496,15703,20793,5.72,13.295,-6910,-2.517,21.556,92,94,2971
2018,5613,24480,49183,6030336,5944573,4389,8.934,4281,8.714,992315,202074,790241,3.399,16.693,812708,187526,625182,3.155,13.671,179607,3.021,27.343,2392,2468,87988
2018,5614,21387,28456,836569,826147,2524,8.802,2965,10.339,153633,49410,104223,5.981,18.596,133062,42679,90383,5.166,16.106,20571,2.49,32.213,2081,2118,17422
2018,5615,12674,16399,221817,227946,1380,7.197,6932,36.151,33263,16645,16618,7.302,14.592,43000,31040,11960,13.617,18.864,-9737,-4.272,29.185,934,951,3909
2018,5616,18208,23262,991498,974658,2330,10.04,2219,9.562,127484,29988,97496,3.077,13.08,94618,30019,64599,3.08,9.708,32866,3.372,19.416,1480,1508,16064
2018,5617,156145,164982,1990318,1972708,21728,13.29,18753,11.47,303114,89686,213428,4.546,15.365,265580,91689,173891,4.648,13.463,37534,1.903,26.925,13501,13588,58522
2018,5619,15716,17657,296561,290704,1774,10.07,1695,9.621,50154,11056,39098,3.803,17.253,39302,11347,27955,3.903,13.52,10852,3.733,27.039,1196,1219,7130
2018,5621,7341,11258,224642,220545,734,6.545,647,5.769,26624,8461,18163,3.836,12.072,18198,6562,11636,2.975,8.251,8426,3.821,16.503,467,473,3856
2018,5622,1230,2557,59070,58633,127,4.966,128,5.005,3728,833,2895,1.421,6.358,2824,883,1941,1.506,4.816,904,1.542,9.633,86,86,578
2018,5629,8705,10232,142737,138893,915,9.011,760,7.484,25664,8291,17373,5.969,18.478,17946,5720,12226,4.118,12.921,7718,5.557,25.841,538,548,3356
2018,6111,18701,21384,1065132,1057750,767,3.581,835,3.899,74879,14108,60771,1.334,7.079,60190,15119,45071,1.429,5.69,14689,1.389,11.381,611,621,12139
2018,6112,407,764,57596,59355,27,3.491,46,5.947,3756,124,3632,0.209,6.328,7143,1056,6087,1.779,12.034,-3387,-5.706,12.656,21,23,589
2018,6113,2356,4269,1866959,1867609,153,3.552,230,5.34,89840,4686,85154,0.251,4.81,90351,15079,75272,0.807,4.838,-511,-0.027,9.621,66,70,1800
2018,6114,6557,6993,63302,62494,857,12.27,840,12.027,11037,3845,7192,6.153,17.661,9505,4236,5269,6.778,15.209,1532,2.451,30.419,560,579,2645
2018,6115,6251,7679,110602,111888,627,8.123,706,9.147,14771,3779,10992,3.377,13.202,17336,5475,11861,4.893,15.494,-2565,-2.292,26.403,443,466,3205
2018,6116,43654,47141,460432,451934,5606,12.06,4291,9.231,77941,25181,52760,5.572,17.246,60955,20796,40159,4.602,13.488,16986,3.759,26.975,3360,3389,16718
2018,6117,6883,7653,103848,100550,1259,16.812,930,12.419,19272,7421,11851,7.38,19.167,12433,5593,6840,5.562,12.365,6839,6.802,24.73,653,657,2802
2018,6211,153175,204470,2536750,2519670,14594,7.103,16566,8.063,337675,116942,220733,4.641,13.402,302825,99802,203023,3.961,12.018,34850,1.383,24.037,11301,11716,57453
2018,6212,117854,128795,947121,945337,6755,5.235,7258,5.624,115101,35235,79866,3.727,12.176,111070,38226,72844,4.044,11.749,4031,0.426,23.499,6002,6086,30406
2018,6213,123087,145030,902321,881380,14035,9.793,10618,7.409,148069,49643,98426,5.632,16.8,106164,38001,68163,4.312,12.045,41905,4.754,24.09,7474,7740,26980
2018,6214,17673,44523,1145328,1134369,3452,7.846,2403,5.462,141960,40993,100967,3.614,12.514,119152,38826,80326,3.423,10.504,22808,2.011,21.008,991,1050,14408
2018,6215,6665,17133,295894,293452,2781,16.757,1708,10.291,44936,15183,29753,5.174,15.313,39910,13303,26607,4.533,13.6,5026,1.713,27.2,638,673,7113
2018,6216,21666,31077,1453777,1419014,3408,11.045,2967,9.615,231429,52522,178907,3.701,16.309,162665,49921,112744,3.518,11.463,68764,4.846,22.926,1904,1978,28334
2018,6219,6494,11306,340734,340007,1384,12.457,993,8.937,47615,16095,31520,4.734,14.004,45766,12607,33159,3.708,13.46,1849,0.544,26.921,466,491,5895
2018,6221,2465,5273,5489679,5479792,241,4.645,71,1.369,206312,41146,165166,0.751,3.765,188271,17777,170494,0.324,3.436,18041,0.329,6.871,23,23,6047
2018,6222,414,673,246909,246528,55,8.449,11,1.69,19052,13577,5475,5.507,7.728,18002,1950,16052,0.791,7.302,1050,0.426,14.604,6,6,1343
2018,6223,298,773,243505,243598,31,4.01,31,4.01,12718,2990,9728,1.227,5.221,13180,2761,10419,1.133,5.411,-462,-0.19,10.442,4,4,223
2018,6231,8472,15884,1581885,1592227,1082,6.852,895,5.668,144288,70243,74045,4.412,9.062,165443,61385,104058,3.855,10.391,-21155,-1.329,18.124,469,527,30841
2018,6232,10155,41621,787189,786772,1982,4.781,1652,3.985,91476,22155,69321,2.816,11.627,90784,20697,70087,2.631,11.539,692,0.088,23.078,523,630,8933
2018,6233,17132,24983,1036470,1021534,1934,7.766,1775,7.128,119063,40292,78771,3.944,11.655,89634,33078,56556,3.238,8.774,29429,2.881,17.549,1285,1326,21174
2018,6239,2953,4819,121241,120709,314,6.484,362,7.475,15819,3297,12522,2.731,13.105,14659,5535,9124,4.585,12.144,1160,0.961,24.288,173,185,2013
2018,6241,53984,72249,1892006,1851917,7894,11.009,6807,9.493,282202,72404,209798,3.91,15.238,198863,51902,146961,2.803,10.738,83339,4.5,21.476,4949,5044,32377
2018,6242,10499,14769,211591,211398,565,3.826,565,3.826,24909,4030,20879,1.906,11.783,24343,4076,20267,1.928,11.515,566,0.268,23.031,268,271,1449
2018,6243,3757,7042,285280,287180,329,4.634,444,6.254,31002,4062,26940,1.414,10.795,34726,5502,29224,1.916,12.092,-3724,-1.297,21.591,168,201,2077
2018,6244,56658,72449,986473,977092,5992,8.279,5849,8.081,124682,38748,85934,3.966,12.761,106299,37657,68642,3.854,10.879,18383,1.881,21.758,4319,4421,27440
2018,7111,7332,7468,123042,122506,848,11.463,707,9.557,19070,5199,13871,4.244,15.567,17968,4583,13385,3.741,14.667,1102,0.9,29.334,497,497,3510
2018,7112,3398,3584,135238,132694,454,12.819,369,10.419,16948,3939,13009,2.968,12.772,11694,2616,9078,1.971,8.813,5254,3.959,17.626,283,283,1950
2018,7113,6437,6875,194218,188944,721,10.528,668,9.754,28226,4644,23582,2.458,14.939,17581,5594,11987,2.961,9.305,10645,5.634,18.61,499,502,3264
2018,7114,3155,3283,22350,21816,429,13.17,378,11.604,3748,1063,2685,4.873,17.18,2605,1351,1254,6.193,11.941,1143,5.239,23.882,276,279,906
2018,7115,17765,17810,53005,51694,3557,20.411,2791,16.015,14399,7690,6709,14.876,27.855,11784,5813,5971,11.245,22.796,2615,5.059,45.592,1854,1856,3856
2018,7121,6712,7199,157815,156567,287,4.001,234,3.262,12325,1101,11224,0.703,7.872,9670,1127,8543,0.72,6.176,2655,1.696,12.353,157,157,860
2018,7131,2764,3367,229027,227702,660,20.153,476,14.534,20427,8710,11717,3.825,8.971,17550,3313,14237,1.455,7.707,2877,1.263,15.415,240,245,2475
2018,7132,1777,2924,134378,134946,197,6.758,179,6.141,8749,2434,6315,1.804,6.483,9753,3023,6730,2.24,7.227,-1004,-0.744,12.967,116,126,1738
2018,7139,55039,64373,1387332,1371181,7482,11.766,5911,9.296,193666,77583,116083,5.658,14.124,161171,51935,109236,3.788,11.754,32495,2.37,23.508,4662,4761,38578
2018,7211,42413,53884,2058910,2057012,4978,9.296,4305,8.04,230578,105166,125412,5.113,11.209,226470,86786,139684,4.219,11.01,4108,0.2,22.019,3107,3198,53822
2018,7212,5608,6225,48774,48267,534,8.644,440,7.122,6948,1617,5331,3.35,14.395,5938,1658,4280,3.435,12.302,1010,2.093,24.605,308,311,900
2018,7213,1617,1787,9722,9578,114,6.381,113,6.325,1641,591,1050,6.17,17.133,1338,229,1109,2.391,13.97,303,3.163,27.939,83,83,169
2018,7223,15841,39396,815071,850970,4215,10.414,6374,15.748,70038,28937,41101,3.4,8.23,147817,102488,45329,12.044,17.37,-77779,-9.14,16.461,1883,1898,11364
2018,7224,34614,35366,339964,337741,3432,9.67,3683,10.377,61206,28190,33016,8.347,18.122,56862,24461,32401,7.243,16.836,4344,1.286,33.672,3083,3089,21112
2018,7225,384607,529654,11053594,10918954,52562,9.988,45778,8.699,1702606,722191,980415,6.614,15.593,1435190,540805,894385,4.953,13.144,267416,2.449,26.288,35499,37471,410095
2018,8111,135185,150309,928441,918639,11997,7.978,12147,8.077,141008,47425,93583,5.163,15.35,121647,43849,77798,4.773,13.242,19361,2.108,26.484,9279,9551,34480
2018,8112,9876,11217,101561,100525,1014,8.947,1247,11.003,16392,5416,10976,5.388,16.306,14218,6742,7476,6.707,14.144,2174,2.163,28.288,939,955,3500
2018,8113,18054,19882,200608,199724,1679,8.471,1558,7.86,27734,7772,19962,3.891,13.886,26056,9905,16151,4.959,13.046,1678,0.84,26.092,1174,1182,4418
2018,8114,17661,18361,72858,72301,1979,10.752,2069,11.241,11371,4521,6850,6.253,15.727,10299,4515,5784,6.245,14.245,1072,1.483,28.489,1568,1568,3258
2018,8121,105117,120797,737363,725998,15566,12.99,13632,11.376,135390,63769,71621,8.784,18.649,112836,50254,62582,6.922,15.542,22554,3.107,31.084,9891,10107,38552
2018,8122,13965,19835,135404,139263,670,3.362,855,4.291,11822,2559,9263,1.838,8.489,19169,3893,15276,2.795,13.765,-7347,-5.276,16.978,534,596,2979
2018,8123,26152,31180,283473,285924,2039,6.46,2810,8.902,30677,11000,19677,3.847,10.729,35847,12858,22989,4.497,12.537,-5170,-1.808,21.458,2163,2267,9509
2018,8129,32408,42028,344979,332320,6098,14.746,4747,11.479,73577,26805,46772,8.066,22.14,46838,20680,26158,6.223,14.094,26739,8.046,28.189,3022,3139,13307
2018,8131,178473,179270,1694560,1691961,7251,4.041,7591,4.23,135980,21659,114321,1.28,8.037,130481,23013,107468,1.36,7.712,5499,0.325,15.424,5357,5357,15896
2018,8132,17372,19458,197121,194172,1719,8.976,1106,5.775,24397,7556,16841,3.891,12.565,18480,4969,13511,2.559,9.517,5917,3.047,19.035,825,836,3157
2018,8133,14620,17329,185378,184410,1266,7.348,1068,6.198,21637,3936,17701,2.134,11.733,19747,4678,15069,2.537,10.708,1890,1.025,21.416,694,717,2766
2018,8134,22426,23972,220352,220937,1378,5.744,1418,5.91,23265,4429,18836,2.005,10.53,24547,5676,18871,2.569,11.11,-1282,-0.58,21.06,1017,1028,4143
2018,8139,52805,54855,493030,489828,2736,4.985,2790,5.084,47960,11145,36815,2.275,9.791,41309,10413,30896,2.126,8.433,6651,1.358,16.867,2127,2146,7741
2019,1131,404,427,3625,3630,44,10.451,32,7.601,423,76,347,2.094,11.653,436,106,330,2.92,12.011,-13,-0.358,23.306,22,22,34
2019,1132,126,141,1022,1059,16,11.388,15,10.676,169,53,116,5.005,15.958,237,94,143,8.876,22.38,-68,-6.421,31.917,14,14,93
2019,1133,6944,7016,47501,48244,615,8.686,744,10.508,5842,1696,4146,3.515,12.109,7253,2173,5080,4.504,15.034,-1411,-2.925,24.219,596,596,1797
2019,1141,1352,1369,5585,5537,243,17.934,215,15.867,982,546,436,9.862,17.737,891,391,500,7.062,16.093,91,1.644,32.186,155,155,280
2019,1142,312,314,1720,1701,34,10.915,29,9.31,239,97,142,5.704,14.055,198,102,96,5.998,11.644,41,2.411,23.287,25,25,91
2019,1151,3846,4189,70351,69324,451,10.837,396,9.516,11126,3247,7879,4.684,16.049,9078,2384,6694,3.439,13.095,2048,2.954,26.19,301,301,1964
2019,1152,4162,4251,21709,21240,571,13.613,458,10.919,4001,1931,2070,9.092,18.838,3119,1189,1930,5.598,14.685,882,4.153,29.37,386,386,1018
2019,1153,1376,1481,13003,13045,178,12.179,139,9.511,2018,649,1369,4.975,15.47,2121,530,1591,4.063,16.259,-103,-0.79,30.939,109,109,368
2019,2111,4379,5631,108324,107460,422,7.447,493,8.7,13026,4104,8922,3.819,12.122,11426,3023,8403,2.813,10.633,1600,1.489,21.266,312,320,1217
2019,2121,337,644,50913,50287,82,12.995,56,8.875,7061,1715,5346,3.41,14.042,5859,1908,3951,3.794,11.651,1202,2.39,23.302,35,35,461
2019,2122,181,245,37607,36662,21,8.502,25,10.121,3410,356,3054,0.971,9.301,1532,707,825,1.928,4.179,1878,5.122,8.357,18,18,86
2019,2123,2478,4666,90020,88221,273,5.879,228,4.91,11735,3586,8149,4.065,13.302,7993,1328,6665,1.505,9.06,3742,4.242,18.12,122,131,635
2019,2131,9430,11875,341049,333914,1340,11.276,1357,11.419,58075,14531,43544,4.352,17.392,43783,16111,27672,4.825,13.112,14292,4.28,26.224,956,999,8752
2019,2211,1792,11374,502794,506339,562,4.957,489,4.313,28427,10952,17475,2.163,5.614,35840,11284,24556,2.229,7.078,-7413,-1.464,11.228,97,98,781
2019,2212,399,2462,92739,91984,148,6.02,141,5.735,6634,1987,4647,2.16,7.212,5265,1321,3944,1.436,5.724,1369,1.488,11.448,22,24,161
2019,2213,3520,4650,46319,46242,218,4.695,205,4.415,3834,725,3109,1.568,8.291,3597,1130,2467,2.444,7.779,237,0.513,15.557,107,107,580
2019,2361,149027,150492,756787,739121,27097,18.385,20878,14.166,169195,78945,90250,10.681,22.891,133938,56604,77334,7.658,18.121,35257,4.77,36.243,15993,15997,44561
2019,2362,37179,38663,698645,686225,3576,9.275,3364,8.725,109372,22305,87067,3.25,15.938,84816,18355,66461,2.675,12.36,24556,3.578,24.72,2637,2639,13302
2019,2371,16175,17755,641460,629030,1381,7.797,1296,7.317,102552,12634,89918,2.008,16.303,79196,12803,66393,2.035,12.59,23356,3.713,25.18,907,919,7486
2019,2372,3834,3938,21961,21998,344,8.619,450,11.275,3275,1000,2275,4.546,14.888,3314,1544,1770,7.019,15.065,-39,-0.177,29.776,367,368,1099
2019,2373,7837,8711,304398,302308,542,6.223,538,6.178,37217,4202,33015,1.39,12.311,32929,4476,28453,1.481,10.893,4288,1.418,21.785,383,388,2773
2019,2379,3670,3786,73203,71740,375,9.958,335,8.895,13176,3019,10157,4.208,18.366,10404,2305,8099,3.213,14.502,2772,3.864,29.005,235,235,1787
2019,2381,80593,81535,896569,892880,10554,13.086,8784,10.892,153098,41603,111495,4.659,17.147,145325,36139,109186,4.047,16.276,7773,0.871,32.552,6524,6537,27773
2019,2382,165470,170375,2151764,2107518,15963,9.442,13330,7.885,321341,68580,252761,3.254,15.247,233047,63630,169417,3.019,11.058,88294,4.189,22.116,10524,10557,48472
2019,2383,103065,104349,845390,833364,13779,13.34,11658,11.287,149832,44983,104849,5.398,17.979,126010,37422,88588,4.49,15.121,23822,2.859,30.241,8807,8832,29321
2019,2389,60166,60986,660855,649705,7667,12.764,5829,9.704,103933,26527,77406,4.083,15.997,81507,22676,58831,3.49,12.545,22426,3.452,25.09,4232,4234,17171
2019,3111,1096,1730,56858,54671,106,6.127,106,6.127,8293,2018,6275,3.691,15.169,3991,1471,2520,2.691,7.3,4302,7.869,14.6,80,84,1182
2019,3112,534,879,58736,59002,43,4.909,37,4.224,3142,351,2791,0.595,5.325,3682,789,2893,1.337,6.241,-540,-0.915,10.651,18,18,150
2019,3113,1624,1792,81453,80615,128,7.107,146,8.107,7624,1579,6045,1.959,9.457,5916,1545,4371,1.917,7.339,1708,2.119,14.677,125,126,1338
2019,3114,1474,1848,163066,163157,158,8.632,123,6.719,15360,2678,12682,1.641,9.414,15327,6416,8911,3.932,9.394,33,0.02,18.788,79,84,2346
2019,3115,1071,1584,151053,149466,97,6.11,104,6.551,10701,1154,9547,0.772,7.159,7712,2121,5591,1.419,5.16,2989,2,10.319,84,85,744
2019,3116,2675,3326,531393,527331,174,5.233,172,5.173,32425,5846,26579,1.109,6.149,24318,3914,20404,0.742,4.612,8107,1.537,9.223,128,128,1237
2019,3117,412,508,31049,31213,35,6.89,35,6.89,2555,429,2126,1.374,8.186,2847,584,2263,1.871,9.121,-292,-0.936,16.371,25,25,235
2019,3118,9825,10638,296040,294974,951,8.948,930,8.751,32951,9377,23574,3.179,11.171,30842,8569,22273,2.905,10.456,2109,0.715,20.912,776,782,6515
2019,3119,3266,3766,222361,219022,409,11.05,280,7.565,24324,4968,19356,2.268,11.106,17556,4947,12609,2.259,8.016,6768,3.09,16.031,224,224,2560
2019,3121,8904,9640,241469,233535,1307,14.107,557,6.012,34761,8974,25787,3.843,14.885,19164,5856,13308,2.508,8.206,15597,6.679,16.412,436,438,3122
2019,3122,106,131,12667,12947,9,6.792,12,9.057,1277,50,1227,0.386,9.863,1698,191,1507,1.475,13.115,-421,-3.252,19.727,10,10,53
2019,3131,197,248,21175,21739,13,5.179,19,7.57,1223,281,942,1.293,5.626,2325,607,1718,2.792,10.695,-1102,-5.069,11.252,12,12,130
2019,3132,704,790,46390,46346,34,4.279,43,5.412,3249,232,3017,0.501,7.01,3152,765,2387,1.651,6.801,97,0.209,13.602,36,37,563
2019,3133,722,761,25514,25818,60,7.884,60,7.884,2080,565,1515,2.188,8.057,2672,722,1950,2.797,10.35,-592,-2.293,16.113,46,46,444
2019,3141,1382,1475,47900,48493,63,4.169,135,8.934,3688,486,3202,1.002,7.605,4916,1253,3663,2.584,10.138,-1228,-2.532,15.211,108,108,925
2019,3149,3629,3724,58197,57727,277,7.383,333,8.875,6774,1301,5473,2.254,11.735,5770,1620,4150,2.806,9.995,1004,1.739,19.991,260,260,1108
2019,3151,190,198,10426,10582,16,8.04,18,9.045,731,216,515,2.041,6.908,1058,267,791,2.523,9.998,-327,-3.09,13.816,16,17,253
2019,3152,3987,4039,61934,63614,566,13.859,656,16.063,9018,3252,5766,5.112,14.176,12415,5172,7243,8.13,19.516,-3397,-5.34,28.352,587,588,4624
2019,3159,509,517,8352,8261,68,13.255,60,11.696,1167,386,781,4.673,14.127,983,284,699,3.438,11.9,184,2.227,23.8,52,52,217
2019,3161,154,162,3299,3303,14,8.75,10,6.25,271,73,198,2.21,8.205,273,42,231,1.272,8.265,-2,-0.061,16.409,8,8,37
2019,3162,188,202,12220,12216,12,5.797,22,10.628,1080,68,1012,0.557,8.841,1074,528,546,4.322,8.792,6,0.049,17.583,19,21,527
2019,3169,704,714,11682,11515,82,11.566,72,10.155,1544,618,926,5.367,13.409,1201,293,908,2.545,10.43,343,2.979,20.86,59,59,256
2019,3211,2516,2970,91220,91551,173,5.779,220,7.349,7557,2344,5213,2.56,8.254,8321,2405,5916,2.627,9.089,-764,-0.835,16.509,178,178,1719
2019,3212,1019,1389,78289,78788,43,3.071,65,4.643,6226,806,5420,1.023,7.902,7181,1864,5317,2.366,9.114,-955,-1.212,15.804,51,52,841
2019,3219,7933,9094,247245,245766,670,7.354,704,7.727,26301,7012,19289,2.853,10.702,23217,5361,17856,2.181,9.447,3084,1.255,18.894,570,572,3652
2019,3221,211,425,99032,96691,17,4,17,4,8443,1588,6855,1.642,8.732,3530,579,2951,0.599,3.651,4913,5.081,7.302,13,13,390
2019,3222,2123,3423,248625,248408,119,3.451,169,4.901,19406,4351,15055,1.752,7.812,19269,5883,13386,2.368,7.757,137,0.055,15.514,118,121,3065
2019,3231,21482,22868,429602,432251,1297,5.607,1828,7.902,34631,9855,24776,2.28,8.012,39808,14047,25761,3.25,9.209,-5177,-1.198,16.024,1538,1544,8401
2019,3241,882,2061,108230,107631,98,4.774,82,3.994,7381,1628,5753,1.513,6.858,6134,971,5163,0.902,5.699,1247,1.159,11.398,31,34,215
2019,3251,1209,2382,156028,155774,88,3.704,75,3.157,12482,2784,9698,1.787,8.013,11910,1765,10145,1.133,7.646,572,0.367,15.291,46,46,553
2019,3252,1042,1396,107034,106551,50,3.565,63,4.492,8356,1233,7123,1.157,7.842,7136,1692,5444,1.588,6.697,1220,1.145,13.395,42,42,777
2019,3253,692,945,34007,33612,54,5.754,41,4.369,2806,757,2049,2.252,8.348,1995,285,1710,0.848,5.935,811,2.413,11.871,30,30,92
2019,3254,1866,2406,267683,261951,276,11.7,182,7.715,26768,6958,19810,2.656,10.219,15271,4003,11268,1.528,5.83,11497,4.389,11.659,115,119,1549
2019,3255,1278,1630,63873,63941,56,3.396,94,5.7,5105,646,4459,1.01,7.984,5340,1257,4083,1.966,8.352,-235,-0.368,15.968,68,69,739
2019,3256,1975,2186,104298,102362,158,7.269,133,6.119,11998,2979,9019,2.91,11.721,7969,2938,5031,2.87,7.785,4029,3.936,15.57,113,114,1451
2019,3259,1648,2127,84739,84125,154,7.233,158,7.421,9094,2951,6143,3.508,10.81,7849,2409,5440,2.864,9.33,1245,1.48,18.66,100,116,778
2019,3261,7397,9836,656088,651546,384,3.891,449,4.55,54964,8968,45996,1.376,8.436,46159,10349,35810,1.588,7.085,8805,1.351,14.169,325,331,6104
2019,3262,1319,1770,142756,140220,59,3.3,95,5.313,12731,2023,10708,1.443,9.079,7929,2185,5744,1.558,5.655,4802,3.425,11.309,62,62,794
2019,3271,813,983,36412,36195,56,5.611,86,8.617,3036,372,2664,1.028,8.388,2623,759,1864,2.097,7.247,413,1.141,14.494,60,60,305
2019,3272,1296,1550,90338,89931,84,5.371,112,7.161,5693,835,4858,0.928,6.33,4720,1591,3129,1.769,5.248,973,1.082,10.497,92,93,897
2019,3273,3761,8518,177322,176165,488,5.754,415,4.893,21225,6426,14799,3.648,12.048,18886,5455,13431,3.097,10.721,2339,1.328,21.441,200,221,2682
2019,3274,143,291,14526,14469,10,3.419,13,4.444,1202,46,1156,0.318,8.308,1135,189,946,1.306,7.845,67,0.463,15.689,8,8,20
2019,3279,2615,3089,83773,82003,179,5.789,185,5.983,10528,1486,9042,1.812,12.839,7088,2335,4753,2.847,8.644,3440,4.195,17.287,140,140,976
2019,3311,265,404,88696,87166,45,11.364,29,7.323,6117,432,5685,0.496,7.018,3223,556,2667,0.638,3.698,2894,3.32,7.395,24,24,350
2019,3312,525,701,51662,50963,39,5.583,34,4.868,4844,987,3857,1.937,9.505,3391,910,2481,1.786,6.654,1453,2.851,13.308,28,28,599
2019,3313,346,481,63064,61304,29,6.073,22,4.607,6174,1333,4841,2.174,10.071,2760,628,2132,1.024,4.502,3414,5.569,9.004,18,18,535
2019,3314,614,796,59492,58963,24,2.968,49,6.061,4660,757,3903,1.284,7.903,3563,1021,2542,1.732,6.043,1097,1.861,12.086,39,39,713
2019,3315,1287,1475,121371,119387,48,3.213,86,5.756,10817,2130,8687,1.784,9.06,6990,2222,4768,1.861,5.855,3827,3.206,11.71,64,65,1065
2019,3321,1971,2224,109251,107174,71,3.177,92,4.117,10273,1165,9108,1.087,9.585,6135,1837,4298,1.714,5.724,4138,3.861,11.449,70,70,1407
2019,3322,939,1010,35353,34944,48,4.731,57,5.619,2838,844,1994,2.415,8.122,2052,539,1513,1.542,5.872,786,2.249,11.745,47,48,347
2019,3323,11788,12841,387677,381242,713,5.542,763,5.93,43608,10384,33224,2.724,11.438,31028,9212,21816,2.416,8.139,12580,3.3,16.277,601,603,5807
2019,3324,1133,1444,89416,88481,50,3.435,73,5.015,7810,997,6813,1.127,8.827,6118,1638,4480,1.851,6.915,1692,1.912,13.829,54,54,838
2019,3325,524,565,29060,28787,24,4.233,28,4.938,1945,235,1710,0.816,6.757,1392,200,1192,0.695,4.836,553,1.921,9.671,22,22,122
2019,3326,898,1052,38082,38338,29,2.732,48,4.522,2711,320,2391,0.835,7.071,3199,799,2400,2.084,8.344,-488,-1.273,14.143,41,41,282
2019,3327,21115,21694,386529,383927,924,4.224,1282,5.861,35838,5659,30179,1.474,9.335,30511,8720,21791,2.271,7.947,5327,1.388,15.894,1078,1081,6536
2019,3328,4766,5329,133075,131934,187,3.476,287,5.336,13173,1902,11271,1.442,9.985,11008,4022,6986,3.049,8.344,2165,1.641,16.687,220,223,2423
2019,3329,5278,5803,261039,257960,398,6.865,387,6.675,25524,4215,21309,1.634,9.895,19146,5862,13284,2.272,7.422,6378,2.472,14.844,281,282,2370
2019,3331,2380,2762,196521,192713,151,5.445,173,6.239,19107,3085,16022,1.601,9.915,11519,2412,9107,1.252,5.977,7588,3.937,11.955,121,121,1192
2019,3332,2744,2929,112115,111017,156,5.322,160,5.459,10379,1780,8599,1.603,9.349,8024,1572,6452,1.416,7.228,2355,2.121,14.455,129,130,1160
2019,3333,1642,1778,75004,74158,101,5.652,119,6.659,7509,2866,4643,3.865,10.126,5593,1586,4007,2.139,7.542,1916,2.584,15.084,98,98,945
2019,3334,1346,1605,133301,131016,72,4.451,97,5.997,13989,3544,10445,2.705,10.677,9262,3714,5548,2.835,7.069,4727,3.608,14.139,79,79,1349
2019,3335,5802,6071,150263,149864,180,2.936,301,4.909,11436,2283,9153,1.523,7.631,10666,2425,8241,1.618,7.117,770,0.514,14.234,248,249,1738
2019,3336,750,949,101728,101779,39,4.071,57,5.95,6638,267,6371,0.262,6.522,6628,2780,3848,2.731,6.512,10,0.01,13.024,36,36,446
2019,3339,4947,5693,312847,309194,229,3.981,347,6.033,26446,2718,23728,0.879,8.553,19456,6182,13274,1.999,6.292,6990,2.261,12.585,187,188,2334
2019,3341,781,807,39458,39689,54,6.626,70,8.589,2427,193,2234,0.486,6.115,2846,603,2243,1.519,7.171,-419,-1.056,12.23,54,55,318
2019,3342,1041,1149,76782,78339,66,5.685,90,7.752,6455,1994,4461,2.545,8.24,9567,1309,8258,1.671,12.212,-3112,-3.972,16.48,76,76,652
2019,3343,407,425,9258,9127,39,9.231,34,8.047,935,208,727,2.279,10.245,664,317,347,3.473,7.276,271,2.969,14.551,27,27,286
2019,3344,3112,3572,265145,260851,173,4.8,237,6.576,24150,3444,20706,1.32,9.258,15734,4395,11339,1.685,6.032,8416,3.226,12.064,184,185,2746
2019,3345,4106,4910,395002,389108,290,5.885,325,6.596,36773,7913,28860,2.034,9.451,24270,6155,18115,1.582,6.237,12503,3.213,12.475,213,214,1988
2019,3346,342,349,6396,6900,24,6.799,32,9.065,536,157,379,2.276,7.769,1497,793,704,11.494,21.697,-961,-13.929,15.537,27,27,105
2019,3351,946,1003,42052,42338,69,6.775,100,9.818,3469,668,2801,1.578,8.194,4031,2198,1833,5.192,9.521,-562,-1.327,16.387,77,79,1104
2019,3352,248,299,52075,52091,31,10.544,21,7.143,2860,625,2235,1.2,5.49,2964,289,2675,0.555,5.69,-104,-0.2,10.981,19,19,196
2019,3353,1614,1916,118771,117439,68,3.489,134,6.875,10183,943,9240,0.803,8.671,7388,3722,3666,3.169,6.291,2795,2.38,12.582,74,74,742
2019,3359,1686,1956,137108,135979,118,6.019,127,6.478,10047,1899,8148,1.397,7.389,7787,2728,5059,2.006,5.727,2260,1.662,11.453,99,99,1458
2019,3361,244,299,236139,224172,29,9.898,17,5.802,28985,1663,27322,0.742,12.93,5315,146,5169,0.065,2.371,23670,10.559,4.742,14,14,46
2019,3362,1523,1863,168335,168098,109,5.871,96,5.171,15305,2184,13121,1.299,9.105,14770,2316,12454,1.378,8.787,535,0.318,17.573,72,72,815
2019,3363,3620,4679,615379,611294,202,4.301,238,5.067,47830,7321,40509,1.198,7.824,39785,7235,32550,1.184,6.508,8045,1.316,13.017,176,179,2248
2019,3364,1249,1798,389079,386933,120,6.586,168,9.221,25376,5813,19563,1.502,6.558,20520,8558,11962,2.212,5.303,4856,1.255,10.607,57,57,650
2019,3365,143,235,30834,29140,17,7.328,11,4.741,4409,721,3688,2.474,15.13,967,271,696,0.93,3.318,3442,11.812,6.637,5,5,52
2019,3366,1215,1339,136893,137605,94,6.955,119,8.805,8827,1669,7158,1.213,6.415,10029,3998,6031,2.905,7.288,-1202,-0.874,12.829,94,95,1976
2019,3369,737,764,34084,33693,68,8.803,85,11.003,3316,276,3040,0.819,9.842,2506,887,1619,2.633,7.438,810,2.404,14.875,67,67,729
2019,3371,9052,9303,223098,224682,617,6.558,827,8.79,17652,3843,13809,1.71,7.856,20400,6499,13901,2.893,9.08,-2748,-1.223,15.713,685,693,4850
2019,3372,3346,3490,115068,115632,157,4.456,224,6.357,9351,1476,7875,1.276,8.087,10518,2856,7662,2.47,9.096,-1167,-1.009,16.174,170,170,1082
2019,3379,583,684,31155,32160,39,5.727,33,4.846,2136,507,1629,1.577,6.642,4172,368,3804,1.144,12.973,-2036,-6.331,13.284,24,24,181
2019,3391,8126,9027,289159,287196,539,5.878,824,8.986,26727,6026,20701,2.098,9.306,22950,7745,15205,2.697,7.991,3777,1.315,15.982,672,677,3096
2019,3399,13390,14083,263647,265579,1143,8.052,1369,9.644,25788,6227,19561,2.345,9.71,29317,9513,19804,3.582,11.039,-3529,-1.329,19.42,1032,1038,5667
2019,4231,13933,22068,418210,414093,1192,5.375,1413,6.371,42907,10878,32029,2.627,10.362,33944,10803,23141,2.609,8.197,8963,2.164,16.394,1009,1047,5985
2019,4232,9792,11775,167723,167352,655,5.509,883,7.427,16645,3745,12900,2.238,9.946,15870,4907,10963,2.932,9.483,775,0.463,18.966,692,708,3952
2019,4233,9409,16918,262722,259128,1336,7.965,1047,6.242,33132,12164,20968,4.694,12.786,26208,9778,16430,3.773,10.114,6924,2.672,20.228,601,617,3922
2019,4234,20388,32768,644784,644132,2609,8.009,2227,6.836,61348,16103,45245,2.5,9.524,60338,17848,42490,2.771,9.367,1010,0.157,18.735,1637,1676,10051
2019,4235,6561,9014,153569,152039,377,4.159,478,5.273,14718,3062,11656,2.014,9.68,11493,3656,7837,2.405,7.559,3225,2.121,15.118,323,335,2256
2019,4236,16886,26594,520022,521299,1377,5.12,1982,7.369,55995,14951,41044,2.868,10.741,59007,18387,40620,3.527,11.319,-3012,-0.578,21.483,1248,1290,8108
2019,4237,9325,18976,260476,258925,735,3.871,760,4.002,25163,6516,18647,2.517,9.718,21837,6360,15477,2.456,8.434,3326,1.285,16.867,510,543,3413
2019,4238,36661,53857,786929,776657,2495,4.609,3045,5.625,81361,16250,65111,2.092,10.476,60693,21738,38955,2.799,7.815,20668,2.661,15.629,2024,2109,12146
2019,4239,25514,28759,326683,326139,2353,8.156,2538,8.797,39000,9906,29094,3.037,11.958,37696,15085,22611,4.625,11.558,1304,0.4,23.117,2059,2089,9555
2019,4241,6318,8432,147453,148556,326,3.798,628,7.317,10156,2185,7971,1.471,6.837,12241,4565,7676,3.073,8.24,-2085,-1.404,13.673,441,462,2101
2019,4242,6438,9764,303569,307311,827,8.535,678,6.997,27591,5486,22105,1.785,8.978,35102,13438,21664,4.373,11.422,-7511,-2.444,17.956,515,520,5330
2019,4243,12255,13263,192910,194342,1113,8.302,1401,10.45,21708,4204,17504,2.163,11.17,24917,8167,16750,4.202,12.821,-3209,-1.651,22.34,1185,1203,5479
2019,4244,24940,32639,858552,858438,2553,7.802,2722,8.318,78419,22325,56094,2.601,9.135,77712,24113,53599,2.809,9.053,707,0.082,18.105,1941,1973,13073
2019,4245,3069,5862,62301,61346,303,5.182,274,4.686,7854,2203,5651,3.591,12.803,5958,1288,4670,2.1,9.712,1896,3.091,19.424,169,174,764
2019,4246,7305,11581,160895,161509,454,3.891,629,5.391,14551,3141,11410,1.945,9.009,15609,3952,11657,2.447,9.664,-1058,-0.655,18.019,450,466,2366
2019,4247,3643,5984,100909,100331,253,4.174,409,6.747,12369,2147,10222,2.14,12.328,11090,3774,7316,3.762,11.053,1279,1.275,22.107,188,202,1861
2019,4248,3235,4287,206167,203604,389,9.134,333,7.819,23505,8980,14525,4.411,11.544,18131,5461,12670,2.682,8.905,5374,2.639,17.81,244,254,2453
2019,4249,19005,25648,333851,334010,1664,6.425,2167,8.367,35201,7059,28142,2.113,10.539,35689,13705,21984,4.103,10.685,-488,-0.146,21.078,1534,1578,7784
2019,4251,30406,32514,272786,278276,3172,9.604,4200,12.716,29791,9720,20071,3.493,10.706,41342,13065,28277,4.695,14.856,-11551,-4.151,21.411,3474,3503,10682
2019,4411,37008,43409,1333133,1333167,3366,7.735,3580,8.227,111140,41371,69769,3.103,8.337,111638,39875,71763,2.991,8.374,-498,-0.037,16.673,3013,3066,34130
2019,4412,10864,12685,152930,152463,789,6.199,876,6.882,16921,6915,10006,4.536,11.098,15906,5189,10717,3.403,10.433,1015,0.666,20.865,719,725,4303
2019,4413,25374,55902,537015,531013,2524,4.526,2242,4.021,50142,13647,36495,2.57,9.443,37605,9678,27927,1.823,7.082,12537,2.361,14.163,1745,1808,7555
2019,4421,12202,21934,205307,206692,1524,6.942,1562,7.115,22756,9589,13167,4.639,11.01,25440,6782,18658,3.281,12.308,-2684,-1.299,22.019,1136,1310,5612
2019,4422,16683,24624,266586,263992,1359,5.454,1942,7.794,30286,7972,22314,3.02,11.472,24719,12140,12579,4.599,9.364,5567,2.109,18.727,1232,1265,3997
2019,4431,15172,24953,295017,300745,1350,5.283,2549,9.976,23711,5997,17714,1.994,7.884,34553,11559,22994,3.843,11.489,-10842,-3.605,15.768,1858,1971,7581
2019,4441,32411,54372,1184213,1193789,2310,4.231,2766,5.066,68039,15209,52830,1.274,5.699,86297,19626,66671,1.644,7.229,-18258,-1.529,11.399,1816,1897,9948
2019,4442,11822,15949,154436,154797,819,5.111,970,6.053,15224,3937,11287,2.543,9.835,15842,4190,11652,2.707,10.234,-618,-0.399,19.67,741,766,3233
2019,4451,60041,86216,2810150,2780685,7101,8.227,7291,8.447,241572,67058,174514,2.412,8.687,185228,60401,124827,2.172,6.661,56344,2.026,13.322,5770,5844,31433
2019,4452,16338,20051,162539,162456,2105,10.509,2064,10.304,26662,10588,16074,6.517,16.412,26375,11989,14386,7.38,16.235,287,0.177,32.47,1557,1619,7588
2019,4453,28369,32430,174585,174952,2348,7.251,2252,6.954,22664,8242,14422,4.711,12.954,23320,7495,15825,4.284,13.329,-656,-0.375,25.909,1830,1849,6103
2019,4461,39540,90201,1030554,1034413,5825,6.488,4980,5.547,95757,48295,47462,4.669,9.257,105407,24588,80819,2.377,10.19,-9650,-0.933,18.514,3360,3568,16115
2019,4471,61064,107812,993138,985265,6346,5.881,6538,6.059,127523,41353,86170,4.197,12.943,112037,33346,78691,3.384,11.371,15486,1.572,22.743,4736,5112,23563
2019,4481,31845,88773,1325286,1332886,5334,5.985,6037,6.774,124414,40041,84373,3.004,9.334,141628,45745,95883,3.432,10.626,-17214,-1.291,18.668,3484,3737,13387
2019,4482,4384,22191,222816,231169,650,2.877,1455,6.44,19889,7055,12834,3.052,8.604,35408,10066,25342,4.354,15.317,-15519,-6.713,17.207,442,577,1951
2019,4483,13694,20287,118699,119396,1064,5.186,1521,7.414,14222,3696,10526,3.096,11.912,15539,5842,9697,4.893,13.015,-1317,-1.103,23.823,982,1032,3120
2019,4511,23127,33185,413212,434818,2269,6.726,3372,9.995,39025,12365,26660,2.844,8.975,86044,50626,35418,11.643,19.789,-47019,-10.813,17.95,2192,2266,7597
2019,4512,3054,6595,64286,66975,374,5.616,504,7.568,6961,1416,5545,2.114,10.393,12534,2734,9800,4.082,18.714,-5573,-8.321,20.787,278,284,1172
2019,4522,16,3847,425887,440943,11,0.277,272,6.838,10792,911,9881,0.207,2.447,40127,21519,18608,4.88,9.1,-29335,-6.653,4.895,(D),(D),(D)
2019,4523,6967,49939,2311742,2263251,3012,6.142,1215,2.478,150042,34050,115992,1.504,6.629,61060,12983,48077,0.574,2.698,88982,3.932,5.396,789,804,3324
2019,4531,10624,11078,54592,55104,880,7.854,1134,10.12,7956,2579,5377,4.68,14.438,8973,3284,5689,5.96,16.284,-1017,-1.846,28.877,973,979,2851
2019,4532,15105,23584,204087,205103,1461,6.111,2110,8.825,23707,5468,18239,2.666,11.559,25717,8940,16777,4.359,12.539,-2010,-0.98,23.117,1590,1658,6071
2019,4533,11980,18163,201565,202114,1268,6.94,1483,8.117,23227,8512,14715,4.211,11.492,24477,5832,18645,2.886,12.11,-1250,-0.618,22.984,1204,1218,4064
2019,4539,34327,46034,308779,302292,5007,11.017,3833,8.434,49710,20182,29528,6.676,16.444,37004,14373,22631,4.755,12.241,12706,4.203,24.482,3100,3192,11833
2019,4541,34803,36476,575746,567228,5786,16.131,4570,12.741,106158,32326,73832,5.699,18.715,88948,37636,51312,6.635,15.681,17210,3.034,31.362,3719,3744,15059
2019,4542,2723,3296,43286,42408,305,9.156,375,11.258,5403,1643,3760,3.874,12.741,3720,1374,2346,3.24,8.772,1683,3.969,17.544,318,321,1101
2019,4543,21522,26734,181545,180985,2558,9.566,2572,9.618,24614,8289,16325,4.58,13.6,23266,10116,13150,5.589,12.855,1348,0.745,25.71,1966,1981,7453
2019,4811,396,2160,457050,446774,156,7.309,105,4.919,39108,3466,35642,0.776,8.753,17942,1052,16890,0.235,4.016,21166,4.738,8.032,37,40,255
2019,4812,1727,1968,44273,43109,240,12.286,211,10.801,5133,994,4139,2.306,11.907,2817,859,1958,1.993,6.535,2316,5.372,13.069,168,170,625
2019,4831,605,916,42869,42989,115,12.568,113,12.35,4870,1199,3671,2.789,11.329,5127,1782,3345,4.145,11.926,-257,-0.598,22.657,55,55,204
2019,4832,441,506,20159,19645,65,13.198,38,7.716,1869,179,1690,0.911,9.514,885,160,725,0.814,4.505,984,5.009,9.01,30,30,112
2019,4841,62602,73994,1077335,1047208,13799,19.284,8922,12.469,162238,56469,105769,5.392,15.492,103464,34358,69106,3.281,9.88,58774,5.612,19.76,7015,7035,22606
2019,4842,40288,43970,503478,499429,5430,12.416,4957,11.335,68811,20406,48405,4.086,13.778,60816,21069,39747,4.219,12.177,7995,1.601,24.354,3894,3979,16403
2019,4851,404,678,55329,55559,47,6.866,60,8.766,3056,770,2286,1.386,5.501,3525,938,2587,1.688,6.345,-469,-0.844,11.001,48,48,422
2019,4852,285,589,18488,18393,41,6.897,52,8.747,3350,1842,1508,10.015,18.213,3130,574,2556,3.121,17.017,220,1.196,34.035,20,20,66
2019,4853,6497,6692,71931,72663,1070,15.964,1091,16.278,11251,4019,7232,5.531,15.484,12746,4464,8282,6.143,17.541,-1495,-2.057,30.968,946,952,3892
2019,4854,2452,4166,235724,235442,222,5.337,209,5.025,19605,5636,13969,2.394,8.327,19159,6302,12857,2.677,8.137,446,0.189,16.275,145,153,3335
2019,4855,1015,1139,30958,31914,70,6.011,121,10.391,2429,399,2030,1.25,7.611,4508,1410,3098,4.418,14.125,-2079,-6.514,15.222,98,106,1286
2019,4859,4450,4904,100252,99193,818,17.02,622,12.942,15399,6698,8701,6.752,15.524,13301,5589,7712,5.634,13.409,2098,2.115,26.818,531,536,5107
2019,4861,78,723,11387,12095,14,1.883,55,7.397,793,133,660,1.1,6.557,2133,1086,1047,8.979,17.636,-1340,-11.079,13.113,8,8,95
2019,4862,108,1974,27256,26729,57,2.897,44,2.236,2684,1129,1555,4.224,10.042,1727,396,1331,1.482,6.461,957,3.58,12.923,10,10,118
2019,4869,74,670,8577,8464,18,2.669,27,4.003,764,63,701,0.744,9.027,506,136,370,1.607,5.979,258,3.048,11.957,6,6,8
2019,4871,612,653,11126,11403,90,13.997,70,10.886,1409,431,978,3.78,12.356,1980,498,1482,4.367,17.364,-571,-5.007,24.713,57,60,424
2019,4872,1353,1404,14964,14995,195,14.069,159,11.472,2133,648,1485,4.321,14.225,2144,517,1627,3.448,14.298,-11,-0.073,28.449,123,123,463
2019,4879,197,228,3549,3509,24,10.714,16,7.143,369,55,314,1.568,10.517,296,53,243,1.511,8.437,73,2.081,16.873,11,11,28
2019,4881,3925,5809,224231,216590,412,7.127,355,6.141,28581,6246,22335,2.884,13.196,12995,4024,8971,1.858,6,15586,7.196,12,250,253,2067
2019,4882,528,1403,42225,41989,127,8.925,167,11.736,5912,1391,4521,3.313,14.08,5474,2131,3343,5.075,13.037,438,1.043,26.074,48,77,1091
2019,4883,1813,2397,102711,100356,151,6.28,166,6.904,11658,3738,7920,3.725,11.617,7055,1141,5914,1.137,7.03,4603,4.587,14.06,105,106,611
2019,4884,9929,11582,114038,109386,1393,12.17,1122,9.802,22330,6000,16330,5.485,20.414,12835,4869,7966,4.451,11.734,9495,8.68,23.467,877,891,3844
2019,4885,13748,19907,297337,283608,1645,8.314,1403,7.091,51675,15178,36497,5.352,18.221,24410,8708,15702,3.07,8.607,27265,9.614,17.214,962,998,5252
2019,4889,1512,1604,19012,18561,242,15.331,191,12.1,3581,1646,1935,8.868,19.293,2563,1412,1151,7.607,13.809,1018,5.485,27.617,161,164,1347
2019,4921,3755,9455,779541,699575,638,6.767,584,6.194,171435,10799,160636,1.544,24.506,15571,5412,10159,0.774,2.226,155864,22.28,4.452,446,454,4094
2019,4922,3351,3933,76059,65783,512,12.972,540,13.681,29681,16173,13508,24.586,45.12,9521,5275,4246,8.019,14.473,20160,30.646,28.947,448,455,4279
2019,4931,7711,16680,1099058,1035594,1385,8.415,941,5.718,213464,37977,175487,3.667,20.613,84194,22112,62082,2.135,8.13,129270,12.483,16.26,426,438,6228
2019,5111,10031,14224,318228,333600,1051,7.332,1271,8.867,19847,5757,14090,1.726,5.949,50613,12839,37774,3.849,15.172,-30766,-9.222,11.899,918,951,6234
2019,5112,9547,12878,654141,640793,1847,14.574,1437,11.339,88897,21420,67477,3.343,13.873,62227,23198,39029,3.62,9.711,26670,4.162,19.422,996,1006,7776
2019,5121,14744,17992,302180,303510,2793,15.795,2175,12.3,42612,17865,24747,5.886,14.04,45433,11714,33719,3.86,14.969,-2821,-0.929,28.079,1476,1486,6222
2019,5122,2848,3053,22868,23109,459,15.211,388,12.858,2722,1213,1509,5.249,11.779,3263,1441,1822,6.236,14.12,-541,-2.341,23.558,288,288,1072
2019,5151,3657,6999,211516,205811,392,5.567,476,6.76,32231,8078,24153,3.925,15.661,20968,5804,15164,2.82,10.188,11263,5.473,20.376,238,251,2147
2019,5152,346,919,55327,53148,305,38.534,50,6.317,9592,6354,3238,11.955,18.048,5547,420,5127,0.79,10.437,4045,7.611,20.874,19,19,91
2019,5173,7311,56710,1012552,1041606,5868,10.43,4972,8.837,130627,47499,83128,4.56,12.541,189546,34151,155395,3.279,18.197,-58919,-5.657,25.082,854,1013,5290
2019,5174,268,349,8186,8316,49,13.499,77,21.212,930,386,544,4.642,11.184,1194,720,474,8.659,14.359,-264,-3.175,22.368,40,40,166
2019,5179,2732,4073,60378,58969,894,22.873,565,14.456,12401,6046,6355,10.253,21.03,9754,4105,5649,6.961,16.541,2647,4.489,33.082,351,386,2213
2019,5182,9436,16111,554625,555047,1332,8.197,1609,9.902,76982,22044,54938,3.972,13.869,77240,35407,41833,6.379,13.916,-258,-0.046,27.739,874,924,9504
2019,5191,8817,10971,335894,324240,1502,13.88,1202,11.108,63227,18599,44628,5.736,19.5,39733,10303,29430,3.178,12.254,23494,7.246,24.508,896,905,5240
2019,5211,13,58,19987,19886,(D),(D),(D),(D),377,(D),357,(D),1.896,178,(D),177,(D),0.895,199,1.001,1.79,0,0,0
2019,5221,10062,114313,1950964,1950454,3014,2.622,4269,3.714,159317,27891,131426,1.43,8.168,159044,31637,127407,1.622,8.154,273,0.014,16.308,348,617,6353
2019,5222,12684,43748,605594,615687,4047,9.242,4126,9.423,75961,27711,48250,4.501,12.338,96092,35981,60111,5.844,15.607,-20131,-3.27,24.675,1149,1307,7153
2019,5223,11406,25815,309991,306217,3019,11.787,2613,10.202,61741,33494,28247,10.938,20.162,55399,21954,33445,7.169,18.091,6342,2.071,36.183,1030,1069,4452
2019,5231,8909,26752,351984,354601,2074,7.666,2678,9.899,29361,5329,24032,1.503,8.28,34471,11864,22607,3.346,9.721,-5110,-1.441,16.56,775,795,2550
2019,5232,11,32,11266,10557,(D),(D),(D),(D),2348,(D),2257,(D),22.242,862,(D),858,(D),8.166,1486,14.077,16.331,0,0,0
2019,5239,46758,66556,573065,569050,6248,9.469,5109,7.742,72579,24187,48392,4.25,12.754,65002,22811,42191,4.009,11.423,7577,1.332,22.846,3850,3874,13355
2019,5241,4721,29770,1567913,1557420,3490,11.312,5653,18.323,207996,65542,142454,4.208,13.355,186108,68337,117771,4.388,11.95,21888,1.405,23.9,349,356,3847
2019,5242,118604,137846,1145167,1116922,13163,9.608,11461,8.366,189308,89176,100132,7.984,16.949,129721,47611,82110,4.263,11.614,59587,5.335,23.228,8688,8787,29386
2019,5259,1038,1098,7610,7699,272,25.685,194,18.319,2340,1048,1292,13.613,30.396,2543,1773,770,23.03,33.032,-203,-2.637,60.791,164,164,1646
2019,5311,87350,119141,603575,600585,11311,9.534,10310,8.69,96247,44032,52215,7.332,16.026,91557,37884,53673,6.308,15.245,4690,0.781,30.489,7529,7696,24031
2019,5312,86880,102384,349782,345686,16411,16.39,11896,11.881,60122,33785,26337,9.773,17.392,52490,22988,29502,6.65,15.184,7632,2.208,30.369,7471,7583,14370
2019,5313,70806,88984,724415,716714,9983,11.333,8189,9.296,100382,40290,60092,5.621,14.006,85182,34392,50790,4.799,11.885,15200,2.121,23.77,5511,5690,21406
2019,5321,3441,15492,177651,175097,1201,7.744,1235,7.963,24360,7362,16998,4.205,13.912,19703,8600,11103,4.912,11.253,4657,2.66,22.505,354,374,1696
2019,5322,6667,15816,131543,131590,847,5.23,1602,9.893,18210,4373,13837,3.323,13.838,18252,9002,9250,6.841,13.87,-42,-0.032,27.677,709,759,4030
2019,5323,2058,2842,19618,19587,207,7.156,308,10.648,2396,726,1670,3.707,12.233,2369,1007,1362,5.141,12.095,27,0.138,24.19,114,122,598
2019,5324,7512,14749,199290,195809,1007,6.847,925,6.289,25110,5531,19579,2.825,12.824,18258,6682,11576,3.413,9.324,6852,3.499,18.649,562,571,3865
2019,5331,2174,2346,35699,37516,258,10.986,263,11.199,4490,1337,3153,3.564,11.968,7875,1359,6516,3.622,20.991,-3385,-9.023,23.936,193,196,1162
2019,5411,154307,166263,1149044,1148532,12152,7.288,13104,7.859,113576,30883,82693,2.689,9.889,112391,36669,75722,3.193,9.786,1185,0.103,19.571,10561,10682,28147
2019,5412,99653,119354,1159010,1154617,9462,7.925,9557,8.004,128331,33191,95140,2.875,11.115,121071,45327,75744,3.926,10.486,7260,0.629,20.972,6821,6962,29633
2019,5413,82375,102394,1572309,1555004,8819,8.641,8150,7.986,204859,58996,145863,3.794,13.174,171226,54604,116622,3.512,11.011,33633,2.163,22.023,5634,5720,25568
2019,5414,27368,27754,122694,122433,3800,13.778,3453,12.52,19530,8247,11283,6.736,15.952,18769,8140,10629,6.649,15.33,761,0.622,30.66,2691,2694,6538
2019,5415,99038,119237,1931837,1913773,16247,13.668,15513,13.05,266480,75247,191233,3.932,13.924,228897,79677,149220,4.163,11.961,37583,1.964,23.921,11784,11866,48804
2019,5416,134343,145128,1384865,1360506,26398,18.523,21178,14.86,256037,92300,163737,6.784,18.819,208833,96679,112154,7.106,15.35,47204,3.47,30.699,16144,16205,55668
2019,5417,14188,17598,764052,753252,2194,12.639,1716,9.885,92469,17816,74653,2.365,12.276,72127,18351,53776,2.436,9.575,20342,2.701,19.151,1228,1255,7445
2019,5418,28470,32445,470043,480281,3300,10.125,3598,11.039,49512,14274,35238,2.972,10.309,69840,23982,45858,4.993,14.541,-20328,-4.233,20.618,2748,2778,14285
2019,5419,56248,64185,700342,686600,7826,12.353,6158,9.72,110752,41773,68979,6.084,16.131,84607,37006,47601,5.39,12.323,26145,3.808,24.645,4745,4816,27640
2019,5511,25201,52524,3514586,3529398,2022,3.802,3336,6.273,381036,64965,316071,1.841,10.796,414780,112815,301965,3.196,11.752,-33744,-0.956,21.592,797,832,12278
2019,5611,26981,30142,524550,514049,3749,12.562,3153,10.565,88666,31125,57541,6.055,17.249,67909,26214,41695,5.1,13.211,20757,4.038,26.421,2395,2454,19358
2019,5612,1995,7512,296217,283375,1730,25.469,291,4.284,45545,24752,20793,8.735,16.072,20871,5595,15276,1.974,7.365,24674,8.707,14.73,126,130,3068
2019,5613,24664,49393,6123675,6114224,4727,9.589,4532,9.194,937506,158795,778711,2.597,15.333,931795,201476,730319,3.295,15.24,5711,0.093,30.48,2398,2441,68430
2019,5614,20899,28137,794956,812570,2542,8.991,2816,9.96,108783,38181,70602,4.699,13.388,146538,55917,90621,6.882,18.034,-37755,-4.646,26.775,2040,2081,15516
2019,5615,12535,16195,226713,224376,1412,8.672,1587,9.747,25890,7531,18359,3.356,11.539,21315,8302,13013,3.7,9.5,4575,2.039,18.999,1022,1028,5322
2019,5616,18394,23608,1010515,999265,2995,12.784,2635,11.247,178099,91519,86580,9.159,17.823,154615,83428,71187,8.349,15.473,23484,2.35,30.946,1531,1577,17216
2019,5617,159997,168899,2028531,2009969,22814,13.665,18932,11.339,316005,101787,214218,5.064,15.722,278780,93392,185388,4.646,13.87,37225,1.852,27.74,14425,14482,66007
2019,5619,15832,17795,304844,301358,1773,10.016,1588,8.97,40102,10285,29817,3.413,13.307,33607,12741,20866,4.228,11.152,6495,2.155,22.304,1227,1241,7582
2019,5621,7263,11163,229785,226870,661,5.908,712,6.364,21174,4418,16756,1.947,9.333,15495,7940,7555,3.5,6.83,5679,2.503,13.66,553,579,5377
2019,5622,1219,2543,59426,59047,121,4.77,108,4.258,4682,1147,3535,1.943,7.929,3883,1435,2448,2.43,6.576,799,1.353,13.152,79,79,866
2019,5629,8937,10477,148569,145532,929,8.942,754,7.257,23270,5906,17364,4.058,15.99,17317,5364,11953,3.686,11.899,5953,4.091,23.798,579,585,3848
2019,6111,18919,21814,1097863,1089937,900,4.133,826,3.793,78900,20165,58735,1.85,7.239,63062,19609,43453,1.799,5.786,15838,1.453,11.572,629,651,15443
2019,6112,412,781,59132,60332,18,2.224,75,9.265,4292,134,4158,0.222,7.114,6803,2874,3929,4.764,11.276,-2511,-4.162,14.228,23,30,1115
2019,6113,2374,3987,1898965,1890556,114,2.736,472,11.33,79615,2564,77051,0.136,4.211,63318,7542,55776,0.399,3.349,16297,0.862,6.698,84,87,2328
2019,6114,6695,7095,71621,68703,882,12.416,899,12.656,14483,3676,10807,5.351,21.081,8453,3318,5135,4.829,12.304,6030,8.777,24.607,653,670,2636
2019,6115,6178,7565,104245,104313,667,8.849,613,8.132,14765,4218,10547,4.044,14.155,14779,4944,9835,4.74,14.168,-14,-0.013,28.309,450,479,2573
2019,6116,44652,47989,468005,457314,5720,12.073,4500,9.498,82482,29744,52738,6.504,18.036,60750,21092,39658,4.612,13.284,21732,4.752,26.568,3563,3656,17683
2019,6117,7262,8055,105751,103831,1412,17.942,1042,13.24,19892,9434,10458,9.086,19.158,16553,4852,11701,4.673,15.942,3339,3.216,31.885,782,789,3123
2019,6211,150433,203757,2564013,2525860,17329,8.518,16702,8.21,358656,140243,218413,5.552,14.199,280139,118321,161818,4.684,11.091,78517,3.109,22.182,11493,11970,64621
2019,6212,117393,129172,975400,967145,7738,5.993,7622,5.903,129820,47004,82816,4.86,13.423,112807,38024,74783,3.932,11.664,17013,1.759,23.328,6617,6716,33579
2019,6213,126754,149240,958664,935876,13937,9.434,10906,7.383,153556,49088,104468,5.245,16.408,107543,41751,65792,4.461,11.491,46013,4.917,22.982,8053,8292,29016
2019,6214,18170,46001,1166992,1150356,3704,8.185,2205,4.873,142021,47264,94757,4.109,12.346,109249,30667,78582,2.666,9.497,32772,2.849,18.994,1089,1161,12771
2019,6215,6483,17162,286627,290740,1690,9.863,1636,9.548,33941,7926,26015,2.726,11.674,42516,14781,27735,5.084,14.623,-8575,-2.949,23.348,695,728,5393
2019,6216,21849,31449,1528739,1498575,3272,10.459,2942,9.404,217943,63274,154669,4.222,14.543,158369,41314,117055,2.757,10.568,59574,3.975,21.136,2020,2073,28348
2019,6219,6375,11473,343270,339697,1058,9.327,800,7.052,37832,10467,27365,3.081,11.137,30569,9738,20831,2.867,8.999,7263,2.138,17.998,496,526,5432
2019,6221,2422,5375,5559507,5534877,140,2.614,102,1.904,205679,15693,189986,0.284,3.716,162102,46301,115801,0.837,2.929,43577,0.787,5.857,32,36,11462
2019,6222,423,700,251048,248018,19,2.742,5,0.722,10848,3548,7300,1.431,4.374,4767,174,4593,0.07,1.922,6081,2.452,3.844,3,3,149
2019,6223,296,751,239636,241923,18,2.354,45,5.886,9443,759,8684,0.314,3.903,14209,6547,7662,2.706,5.873,-4766,-1.97,7.807,12,13,3779
2019,6231,8942,16519,1621859,1624598,1068,6.502,882,5.37,145422,70405,75017,4.334,8.951,150253,57140,93113,3.517,9.249,-4831,-0.297,17.903,493,548,34674
2019,6232,10398,42777,793973,795263,2484,5.856,1759,4.147,84644,22659,61985,2.849,10.644,87262,18719,68543,2.354,10.973,-2618,-0.329,21.287,498,586,7102
2019,6233,16742,24589,1003122,991844,2131,8.74,1720,7.054,106188,43518,62670,4.388,10.706,85036,30343,54693,3.059,8.574,21152,2.133,17.147,1304,1321,19351
2019,6239,3030,5485,124568,123089,982,18.928,388,7.479,15410,5823,9587,4.731,12.519,12188,3335,8853,2.709,9.902,3222,2.618,19.804,196,199,1571
2019,6241,56840,75895,1938914,1907406,8910,12.025,5315,7.173,246381,58332,188049,3.058,12.917,184282,43660,140622,2.289,9.661,62099,3.256,19.323,3703,3759,27638
2019,6242,10398,14508,213744,206609,825,5.738,563,3.916,30553,10455,20098,5.06,14.788,15597,3826,11771,1.852,7.549,14956,7.239,15.098,314,356,2566
2019,6243,3780,7159,275392,280030,438,6.15,365,5.125,29736,6796,22940,2.427,10.619,39453,7872,31581,2.811,14.089,-9717,-3.47,21.238,145,151,1323
2019,6244,56738,72586,1002751,993679,6103,8.428,5750,7.941,121556,40496,81060,4.075,12.233,103054,37279,65775,3.752,10.371,18502,1.862,20.742,4432,4613,30107
2019,7111,7633,7760,126833,124990,984,12.917,700,9.189,19936,5801,14135,4.641,15.95,16150,4585,11565,3.668,12.921,3786,3.029,25.842,538,542,3557
2019,7112,3253,3440,138529,135739,515,15.234,396,11.714,17898,4816,13082,3.548,13.186,12309,2103,10206,1.549,9.068,5589,4.117,18.136,326,327,1722
2019,7113,6633,7151,199645,197466,796,11.288,597,8.466,21872,4945,16927,2.504,11.076,17565,2503,15062,1.268,8.895,4307,2.181,17.79,474,475,2053
2019,7114,3253,3391,23105,22828,502,15.032,399,11.948,3196,1135,2061,4.972,14,2671,987,1684,4.324,11.701,525,2.3,23.401,318,321,811
2019,7115,18556,18601,57037,55301,3774,20.764,2924,16.087,15226,7712,7514,13.945,27.533,11771,6129,5642,11.083,21.285,3455,6.248,42.571,2049,2051,4195
2019,7121,6802,7279,160044,158903,349,4.825,258,3.567,10967,1761,9206,1.108,6.902,8752,1257,7495,0.791,5.508,2215,1.394,11.016,187,187,1052
2019,7131,2854,3299,207510,206718,509,15.262,581,17.421,19856,8843,11013,4.278,9.605,18822,4768,14054,2.307,9.105,1034,0.5,18.21,372,374,4223
2019,7132,1794,2950,137214,136070,210,7.12,209,7.086,8799,3584,5215,2.634,6.467,6630,1833,4797,1.347,4.873,2169,1.594,9.745,156,166,1586
2019,7139,56608,66374,1424920,1406762,7803,11.907,6126,9.348,197920,72340,125580,5.142,14.069,161083,54954,106129,3.906,11.451,36837,2.619,22.901,4897,4975,42875
2019,7211,42974,54514,2106697,2085251,4748,8.748,4271,7.869,228642,92273,136369,4.425,10.965,184608,73697,110911,3.534,8.853,44034,2.112,17.706,3158,3226,48713
2019,7212,5554,6207,48448,48171,513,8.299,462,7.474,6834,2287,4547,4.748,14.187,6310,1575,4735,3.27,13.099,524,1.088,26.198,342,343,1212
2019,7213,1546,1726,10753,10240,147,8.348,217,12.323,3233,1956,1277,19.102,31.574,2133,979,1154,9.561,20.831,1100,10.743,41.662,168,173,817
2019,7223,17202,42684,851547,837319,5851,14.174,3044,7.374,119160,51588,67572,6.161,14.231,91474,26334,65140,3.145,10.925,27686,3.307,21.849,2055,2114,11304
2019,7224,35696,36510,381006,376013,3566,9.757,3645,9.973,67904,30379,37525,8.079,18.059,57988,23551,34437,6.263,15.422,9916,2.637,30.844,3142,3152,20894
2019,7225,388719,534311,11112564,11058826,52665,9.919,45969,8.658,1537164,724311,812853,6.55,13.9,1423315,521344,901971,4.714,12.87,113849,1.029,25.741,37187,38371,399911
2019,8111,134653,150054,931384,928614,12249,8.161,12319,8.208,123811,48073,75738,5.177,13.333,118804,44940,73864,4.839,12.794,5007,0.539,25.587,9993,10171,37764
2019,8112,9672,10966,100957,100771,994,8.974,1215,10.969,12724,3971,8753,3.941,12.627,12527,5201,7326,5.161,12.431,197,0.195,24.862,949,995,3631
2019,8113,18241,19982,204851,203739,1564,7.803,1685,8.407,27824,7109,20715,3.489,13.657,25309,11248,14061,5.521,12.422,2515,1.234,24.845,1304,1315,5110
2019,8114,17745,18541,72559,72662,2215,12.01,2018,10.942,11517,5038,6479,6.933,15.85,11746,5242,6504,7.214,16.165,-229,-0.315,31.7,1619,1623,3922
2019,8121,109042,124712,762530,750066,16494,13.439,12537,10.215,132844,64329,68515,8.576,17.711,108391,46714,61677,6.228,14.451,24453,3.26,28.902,10104,10314,37616
2019,8122,13815,19659,134105,134533,568,2.875,757,3.832,10561,1909,8652,1.419,7.85,11298,3131,8167,2.327,8.398,-737,-0.548,15.7,540,585,2511
2019,8123,25649,30626,282018,282878,2020,6.535,2593,8.388,27908,10120,17788,3.578,9.866,29752,10741,19011,3.797,10.518,-1844,-0.652,19.731,2213,2288,9651
2019,8129,34217,43842,363111,354257,6169,14.376,4311,10.046,63997,24373,39624,6.88,18.065,45796,17756,28040,5.012,12.927,18201,5.138,25.855,3314,3342,13423
2019,8131,178213,179022,1686616,1691026,7073,3.948,7355,4.105,123460,21243,102217,1.256,7.301,132019,20710,111309,1.225,7.807,-8559,-0.506,14.602,5650,5650,15973
2019,8132,17628,19537,198114,197082,1524,7.859,1236,6.373,22499,6851,15648,3.476,11.416,20333,6669,13664,3.384,10.317,2166,1.099,20.634,878,880,3175
2019,8133,15073,17877,182994,183924,1517,8.603,1031,5.847,21188,4657,16531,2.532,11.52,23420,4108,19312,2.234,12.734,-2232,-1.214,23.04,733,737,2943
2019,8134,22426,23996,220363,219670,1465,6.11,1426,5.947,23212,4823,18389,2.196,10.567,22031,5140,16891,2.34,10.029,1181,0.538,20.058,1124,1139,3995
2019,8139,51561,53732,487403,490378,2223,4.1,3211,5.922,40669,8389,32280,1.711,8.293,46464,12687,33777,2.587,9.475,-5795,-1.182,16.587,2555,2560,9957
2020,1131,387,410,3593,3597,36,8.675,46,11.084,330,102,228,2.836,9.174,335,89,246,2.474,9.313,-5,-0.139,18.349,42,42,78
2020,1132,133,148,978,1006,20,13.841,13,8.997,125,59,66,5.868,12.432,176,45,131,4.475,17.504,-51,-5.072,24.863,11,11,42
2020,1133,6743,6814,46083,46725,569,8.241,750,10.862,5522,1573,3949,3.367,11.818,6833,2135,4698,4.569,14.624,-1311,-2.806,23.636,611,611,1798
2020,1141,1285,1298,5304,5425,186,14.006,246,18.524,889,522,367,9.623,16.389,1133,613,520,11.301,20.887,-244,-4.498,32.777,175,176,455
2020,1142,307,308,1751,1713,29,9.508,23,7.541,236,64,172,3.737,13.781,155,46,109,2.686,9.051,81,4.73,18.102,16,16,25
2020,1151,3876,4206,73345,71681,478,11.46,408,9.782,12869,3627,9242,5.06,17.953,9340,2951,6389,4.117,13.03,3529,4.923,26.06,335,335,2274
2020,1152,4019,4101,21857,21604,485,11.768,526,12.762,3714,1458,2256,6.749,17.192,3197,1271,1926,5.883,14.799,517,2.393,29.597,449,449,1090
2020,1153,1349,1473,13587,13334,163,11.058,165,11.194,2441,582,1859,4.365,18.307,1959,713,1246,5.347,14.692,482,3.615,29.384,114,114,470
2020,2111,4162,5369,100557,104367,352,6.392,627,11.387,10115,3418,6697,3.275,9.692,17643,5885,11758,5.639,16.905,-7528,-7.213,19.384,444,471,2755
2020,2121,319,548,43620,46683,28,4.742,113,19.136,4078,1553,2525,3.327,8.736,10280,4095,6185,8.772,22.021,-6202,-13.285,17.471,35,38,1225
2020,2122,190,255,39336,38164,27,10.693,22,8.713,3650,238,3412,0.624,9.564,1383,107,1276,0.28,3.624,2267,5.94,7.248,18,18,43
2020,2123,2471,4696,88155,88955,290,6.187,272,5.803,9325,2627,6698,2.953,10.483,10861,2587,8274,2.908,12.21,-1536,-1.727,20.966,147,170,1282
2020,2131,9009,11374,306880,323400,1094,9.419,1576,13.569,44218,14053,30165,4.345,13.673,77642,25404,52238,7.855,24.008,-33424,-10.335,27.346,1155,1199,9608
2020,2211,1857,11614,501393,502337,575,5.003,334,2.906,29905,6988,22917,1.391,5.953,31597,5243,26354,1.044,6.29,-1692,-0.337,11.906,81,87,1719
2020,2212,393,2431,90282,91560,105,4.294,134,5.479,5160,1576,3584,1.721,5.636,7710,2356,5354,2.573,8.421,-2550,-2.785,11.271,19,21,246
2020,2213,3478,4595,46374,46123,215,4.65,273,5.904,3934,1133,2801,2.456,8.529,3419,1306,2113,2.832,7.413,515,1.117,14.826,183,185,591
2020,2361,152224,153779,783114,769175,26702,17.564,23203,15.262,163705,70064,93641,9.109,21.283,135566,59561,76005,7.743,17.625,28139,3.658,35.25,18690,18699,48430
2020,2362,36683,38184,711346,705263,3127,8.13,3688,9.588,101872,21003,80869,2.978,14.445,89388,21178,68210,3.003,12.674,12484,1.77,25.349,3039,3049,15560
2020,2371,16041,17739,634767,639497,1352,7.612,1397,7.865,89096,19611,69485,3.067,13.932,98256,16175,82081,2.529,15.365,-9160,-1.432,27.864,1099,1109,10213
2020,2372,3782,3891,21964,21904,349,8.927,386,9.873,3443,1236,2207,5.643,15.719,3349,1612,1737,7.359,15.289,94,0.429,30.579,339,340,1160
2020,2373,7730,8601,313134,308494,475,5.486,591,6.825,38341,3939,34402,1.277,12.428,28924,5273,23651,1.709,9.376,9417,3.053,18.752,452,455,3245
2020,2379,3766,3878,78670,76283,409,10.63,348,9.045,13918,3485,10433,4.569,18.245,9271,2291,6980,3.003,12.154,4647,6.092,24.307,261,262,1127
2020,2381,81081,82037,914360,905391,10163,12.425,9678,11.832,158661,39783,118878,4.394,17.524,141335,39369,101966,4.348,15.61,17326,1.914,31.221,7655,7662,31925
2020,2382,165962,170986,2189448,2170122,15593,9.133,15082,8.834,291749,67359,224390,3.104,13.444,253653,70980,182673,3.271,11.688,38096,1.755,23.377,12308,12381,56705
2020,2383,102804,104144,843126,844321,13061,12.523,13363,12.813,135620,39367,96253,4.663,16.063,137908,45743,92165,5.418,16.334,-2288,-0.271,32.125,10751,10758,35882
2020,2389,61295,62131,689953,676719,7486,12.151,6441,10.455,111303,27816,83487,4.11,16.447,84891,25519,59372,3.771,12.545,26412,3.903,25.089,5141,5146,19896
2020,3111,1107,1741,57380,56916,86,4.96,72,4.152,6103,2546,3557,4.473,10.723,5312,907,4405,1.594,9.333,791,1.39,18.666,47,50,562
2020,3112,532,900,57287,57700,76,8.563,51,5.746,5105,1383,3722,2.397,8.847,6043,1038,5005,1.799,10.473,-938,-1.626,17.695,36,36,356
2020,3113,1572,1739,83068,82281,109,6.204,145,8.253,8247,2284,5963,2.776,10.023,6611,1438,5173,1.748,8.035,1636,1.988,16.069,120,122,927
2020,3114,1441,1804,162437,162299,128,7.033,160,8.791,13847,3494,10353,2.153,8.532,13654,3650,10004,2.249,8.413,193,0.119,16.826,123,126,2579
2020,3115,1075,1584,153419,151810,95,6.001,93,5.875,9911,1629,8282,1.073,6.529,6681,1099,5582,0.724,4.401,3230,2.128,8.802,73,73,581
2020,3116,2580,3234,542928,536763,148,4.518,232,7.082,40017,4503,35514,0.839,7.455,28343,6169,22174,1.149,5.28,11674,2.175,10.561,187,189,3074
2020,3117,410,503,30503,30788,25,4.926,34,6.7,2732,694,2038,2.254,8.874,3350,491,2859,1.595,10.881,-618,-2.007,17.747,26,26,83
2020,3118,10181,10956,297976,296951,1091,9.991,1018,9.323,30750,9120,21630,3.071,10.355,28916,8222,20694,2.769,9.738,1834,0.618,19.475,864,867,6006
2020,3119,3382,3906,228146,226244,443,11.523,320,8.324,24517,6031,18486,2.666,10.837,20612,4899,15713,2.165,9.111,3905,1.726,18.221,255,257,3096
2020,3121,9253,9990,252522,246780,1141,11.671,714,7.303,37717,7912,29805,3.206,15.284,26730,7396,19334,2.997,10.832,10987,4.452,21.663,571,572,3903
2020,3122,104,126,11309,12001,5,3.861,12,9.266,513,29,484,0.242,4.275,1934,162,1772,1.35,16.116,-1421,-11.841,8.55,10,10,81
2020,3131,209,252,18472,19920,29,11.531,28,11.133,2528,1339,1189,6.722,12.691,5329,2001,3328,10.045,26.753,-2801,-14.062,25.382,15,15,328
2020,3132,696,780,43426,44747,47,6.006,52,6.645,2814,648,2166,1.448,6.289,5391,899,4492,2.009,12.048,-2577,-5.759,12.578,45,45,498
2020,3133,717,757,24534,25153,75,9.947,69,9.151,1986,661,1325,2.628,7.896,3249,671,2578,2.668,12.917,-1263,-5.021,15.792,62,62,561
2020,3141,1280,1373,49603,48676,61,4.314,143,10.113,7189,552,6637,1.134,14.769,5247,845,4402,1.736,10.78,1942,3.99,21.559,121,121,578
2020,3149,3479,3577,58003,57979,243,6.705,337,9.299,6539,1879,4660,3.241,11.278,6417,1324,5093,2.284,11.068,122,0.21,22.136,289,289,1086
2020,3151,179,186,9394,9715,9,4.775,14,7.427,747,54,693,0.556,7.689,1368,350,1018,3.603,14.081,-621,-6.392,15.378,11,11,87
2020,3152,3660,3716,56437,59313,541,14.052,809,21.013,7106,2892,4214,4.876,11.981,12938,5580,7358,9.408,21.813,-5832,-9.833,23.961,729,730,4846
2020,3159,503,510,8444,8392,63,12.245,72,13.994,1561,602,959,7.174,18.602,1418,594,824,7.079,16.898,143,1.704,33.796,60,60,438
2020,3161,147,157,3253,3281,7,4.361,14,8.723,272,30,242,0.914,8.29,325,88,237,2.682,9.906,-53,-1.615,16.58,13,13,78
2020,3162,173,185,11022,11592,13,6.806,25,13.089,366,54,312,0.466,3.157,1524,250,1274,2.157,13.147,-1158,-9.99,6.315,19,19,111
2020,3169,672,682,11842,11721,56,8.122,71,10.297,1271,483,788,4.121,10.844,1036,301,735,2.568,8.839,235,2.005,17.678,59,59,153
2020,3211,2456,2906,87999,89216,149,5.078,206,7.02,6490,1809,4681,2.028,7.274,8813,2583,6230,2.895,9.878,-2323,-2.604,14.549,167,170,1379
2020,3212,998,1377,78679,78805,52,3.756,67,4.839,7165,1312,5853,1.665,9.092,7280,2107,5173,2.674,9.238,-115,-0.146,18.184,44,44,609
2020,3219,7469,8674,246055,246187,598,6.838,740,8.462,25624,6855,18769,2.784,10.408,25711,7696,18015,3.126,10.444,-87,-0.035,20.817,593,614,5124
2020,3221,206,420,92300,95938,12,2.837,18,4.255,3812,223,3589,0.232,3.973,11047,1689,9358,1.761,11.515,-7235,-7.541,7.947,13,13,550
2020,3222,2078,3378,248760,248612,114,3.348,168,4.934,20303,3018,17285,1.214,8.167,19693,5737,13956,2.308,7.921,610,0.245,15.842,108,111,2334
2020,3231,20680,21992,415547,422850,1154,5.139,2080,9.263,31879,6632,25247,1.568,7.539,46449,16168,30281,3.824,10.985,-14570,-3.446,15.078,1720,1730,10104
2020,3241,863,2100,111624,109933,122,5.863,84,4.037,12297,1609,10688,1.464,11.186,8885,1420,7465,1.292,8.082,3412,3.104,16.164,41,49,358
2020,3251,1202,2405,157609,156864,116,4.84,99,4.131,11773,3149,8624,2.007,7.505,10332,1231,9101,0.785,6.587,1441,0.919,13.173,54,55,663
2020,3252,1015,1361,104329,104580,46,3.349,71,5.169,8176,1788,6388,1.71,7.818,8641,1480,7161,1.415,8.263,-465,-0.445,15.636,45,45,807
2020,3253,696,955,32725,33167,75,7.895,65,6.842,2931,969,1962,2.922,8.837,3812,1294,2518,3.901,11.493,-881,-2.656,17.674,43,43,287
2020,3254,1985,2518,273201,271904,287,11.615,193,7.811,27333,6244,21089,2.296,10.052,24530,4406,20124,1.62,9.022,2803,1.031,18.043,140,140,2518
2020,3255,1268,1614,64988,64651,63,3.879,83,5.111,6046,575,5471,0.889,9.352,5315,1193,4122,1.845,8.221,731,1.131,16.442,60,61,530
2020,3256,1970,2183,103475,103998,171,7.828,174,7.965,8641,1671,6970,1.607,8.309,9677,1503,8174,1.445,9.305,-1036,-0.996,16.618,143,143,946
2020,3259,1651,2117,86641,85959,136,6.403,150,7.062,8612,2159,6453,2.512,10.019,7423,2311,5112,2.688,8.636,1189,1.383,17.271,101,101,1439
2020,3261,7259,9714,655689,656846,388,3.966,524,5.357,54061,9756,44305,1.485,8.23,56259,13467,42792,2.05,8.565,-2198,-0.335,16.461,376,383,5507
2020,3262,1294,1737,138592,139887,59,3.372,84,4.801,7792,1201,6591,0.859,5.57,10285,1831,8454,1.309,7.352,-2493,-1.782,11.14,54,55,604
2020,3271,812,983,36728,36396,66,6.728,62,6.32,3977,471,3506,1.294,10.927,3240,749,2491,2.058,8.902,737,2.025,17.804,48,48,333
2020,3272,1260,1523,87547,88389,93,6.051,121,7.872,6051,969,5082,1.096,6.846,7749,1671,6078,1.891,8.767,-1698,-1.921,13.692,105,105,1207
2020,3273,3692,8544,180443,179836,383,4.487,368,4.311,21656,5080,16576,2.825,12.042,20402,5388,15014,2.996,11.345,1254,0.697,22.69,167,236,3581
2020,3274,128,287,14339,14440,16,5.556,18,6.25,1012,539,473,3.733,7.008,1157,123,1034,0.852,8.012,-145,-1.004,14.017,12,13,98
2020,3279,2549,3026,78285,80166,163,5.341,215,7.045,6490,1679,4811,2.094,8.096,10178,2340,7838,2.919,12.696,-3688,-4.6,16.191,156,163,1559
2020,3311,248,394,88453,90239,25,6.41,17,4.359,2858,426,2432,0.472,3.167,6435,631,5804,0.699,7.131,-3577,-3.964,6.334,15,15,571
2020,3312,505,683,50810,50949,27,3.95,28,4.097,3857,433,3424,0.85,7.57,4129,389,3740,0.764,8.104,-272,-0.534,15.141,24,24,223
2020,3313,347,483,61256,62108,26,5.394,24,4.979,3672,1316,2356,2.119,5.912,5430,1269,4161,2.043,8.743,-1758,-2.831,11.825,14,14,368
2020,3314,598,778,58115,58759,32,4.071,48,6.107,3285,294,2991,0.5,5.591,4644,1135,3509,1.932,7.903,-1359,-2.313,11.181,35,36,719
2020,3315,1250,1437,113698,117367,33,2.269,68,4.675,4572,657,3915,0.56,3.895,11984,1501,10483,1.279,10.211,-7412,-6.315,7.791,58,58,884
2020,3321,1898,2148,102809,105821,59,2.7,134,6.131,5242,617,4625,0.583,4.954,11358,1536,9822,1.452,10.733,-6116,-5.78,9.907,109,112,1276
2020,3322,915,986,33468,34139,53,5.343,65,6.552,1842,127,1715,0.372,5.396,3146,1071,2075,3.137,9.215,-1304,-3.82,10.791,47,48,636
2020,3323,11643,12710,387421,388493,683,5.335,868,6.78,35429,7501,27928,1.931,9.12,37720,9724,27996,2.503,9.709,-2291,-0.59,18.239,686,693,5663
2020,3324,1098,1396,87268,88140,45,3.168,94,6.617,5855,835,5020,0.947,6.643,7601,1949,5652,2.211,8.624,-1746,-1.981,13.286,66,67,940
2020,3325,503,547,29102,28991,24,4.32,41,7.381,1994,704,1290,2.428,6.878,1765,296,1469,1.021,6.088,229,0.79,12.176,30,30,174
2020,3326,865,1015,36798,37249,23,2.23,56,5.429,2876,755,2121,2.027,7.721,3770,740,3030,1.987,10.121,-894,-2.4,15.442,45,45,463
2020,3327,20480,21074,376625,382115,836,3.909,1459,6.822,28165,5948,22217,1.557,7.371,39148,10102,29046,2.644,10.245,-10983,-2.874,14.742,1221,1227,7587
2020,3328,4651,5222,127767,129840,209,3.968,299,5.677,9623,1881,7742,1.449,7.411,13747,3283,10464,2.528,10.588,-4124,-3.176,14.823,244,247,2617
2020,3329,5237,5782,254854,257952,364,6.271,409,7.046,18103,3871,14232,1.501,7.018,24406,5291,19115,2.051,9.461,-6303,-2.443,14.036,338,342,3417
2020,3331,2339,2716,187639,191677,139,5.08,179,6.542,9839,1737,8102,0.906,5.133,17917,2953,14964,1.541,9.347,-8078,-4.214,10.266,134,135,1658
2020,3332,2684,2865,109204,110315,158,5.473,202,6.997,7770,1410,6360,1.278,7.043,9983,2849,7134,2.583,9.05,-2213,-2.006,14.087,154,154,1515
2020,3333,1575,1714,72641,73472,81,4.654,134,7.699,5512,1789,3723,2.435,7.502,7120,2216,4904,3.016,9.691,-1608,-2.189,15.004,104,106,1204
2020,3334,1342,1602,135660,134749,79,4.918,88,5.478,15180,7976,7204,5.919,11.265,13419,1600,11819,1.187,9.959,1761,1.307,19.917,69,70,849
2020,3335,5600,5885,144246,147360,210,3.512,400,6.689,8966,2931,6035,1.989,6.084,15153,3867,11286,2.624,10.283,-6187,-4.199,12.169,326,329,2525
2020,3336,730,924,97467,99842,25,2.671,49,5.235,4538,266,4272,0.266,4.545,9499,1783,7716,1.786,9.514,-4961,-4.969,9.09,33,33,493
2020,3339,4862,5615,306759,311094,246,4.353,319,5.645,19793,5234,14559,1.682,6.362,27990,8824,19166,2.836,8.997,-8197,-2.635,12.725,252,252,2634
2020,3341,756,785,38184,39097,62,7.828,76,9.596,2529,520,2009,1.33,6.469,4322,419,3903,1.072,11.055,-1793,-4.586,12.937,65,65,376
2020,3342,1023,1133,77883,77624,70,6.119,92,8.042,7495,726,6769,0.935,9.656,6963,2126,4837,2.739,8.97,532,0.685,17.94,71,73,1157
2020,3343,417,434,9517,9424,43,10.058,30,7.018,928,141,787,1.496,9.848,743,176,567,1.868,7.885,185,1.963,15.769,23,23,117
2020,3344,3022,3468,262090,262982,173,4.922,266,7.569,21634,3820,17814,1.453,8.226,23299,6857,16442,2.607,8.86,-1665,-0.633,16.453,206,211,4290
2020,3345,4102,4871,403132,398808,246,5.023,299,6.105,29442,5063,24379,1.27,7.383,21005,4827,16178,1.21,5.267,8437,2.116,10.534,208,209,2415
2020,3346,329,335,5974,6203,29,8.492,42,12.299,763,239,524,3.853,12.301,1220,396,824,6.385,19.669,-457,-7.368,24.603,33,33,377
2020,3351,902,954,38942,40366,49,5.02,93,9.529,3374,1335,2039,3.307,8.359,6002,3066,2936,7.596,14.869,-2628,-6.51,16.717,76,76,706
2020,3352,256,301,50223,50770,32,10.702,28,9.365,2735,153,2582,0.301,5.387,3899,1077,2822,2.121,7.68,-1164,-2.293,10.774,18,18,131
2020,3353,1561,1845,118427,118159,63,3.353,131,6.972,9255,1190,8065,1.007,7.833,8786,2061,6725,1.744,7.436,469,0.397,14.872,81,81,737
2020,3359,1674,1948,135108,135735,122,6.263,122,6.263,10548,2381,8167,1.754,7.771,11592,1979,9613,1.458,8.54,-1044,-0.769,15.542,98,98,1135
2020,3361,246,314,224061,229751,43,14.238,19,6.291,9215,2611,6604,1.136,4.011,21281,1872,19409,0.815,9.263,-12066,-5.252,8.022,15,15,332
2020,3362,1511,1838,161519,166360,108,5.839,131,7.083,12586,2793,9793,1.679,7.566,22078,10071,12007,6.054,13.271,-9492,-5.706,15.131,90,98,1975
2020,3363,3522,4526,595324,606199,177,3.851,318,6.918,35083,8150,26933,1.344,5.787,57001,7628,49373,1.258,9.403,-21918,-3.616,11.575,180,184,3327
2020,3364,1260,1741,395498,392407,102,5.769,156,8.824,24233,3440,20793,0.877,6.175,18661,5303,13358,1.351,4.756,5572,1.42,9.511,78,78,1223
2020,3365,135,222,28419,29537,6,2.643,16,7.048,2096,254,1842,0.86,7.096,4412,874,3538,2.959,14.937,-2316,-7.841,14.193,7,7,33
2020,3366,1166,1296,140133,137803,83,6.302,125,9.491,12414,2771,9643,2.011,9.009,7784,1738,6046,1.261,5.649,4630,3.36,11.297,106,108,1657
2020,3369,726,755,35502,34971,73,9.58,87,11.417,3515,513,3002,1.467,10.051,2434,786,1648,2.248,6.96,1081,3.091,13.92,75,75,250
2020,3371,8966,9208,214929,218566,599,6.4,903,9.647,16425,3911,12514,1.789,7.515,23460,8570,14890,3.921,10.734,-7035,-3.219,15.03,728,739,5847
2020,3372,3302,3443,113117,114152,191,5.478,278,7.974,8128,1749,6379,1.532,7.12,10305,3092,7213,2.709,9.027,-2177,-1.907,14.241,232,234,2204
2020,3379,583,686,33150,33050,35,5.069,44,6.372,2399,574,1825,1.737,7.259,2181,459,1722,1.389,6.599,218,0.66,13.198,35,35,269
2020,3391,7746,8650,292125,289566,513,5.806,883,9.994,29661,6172,23489,2.131,10.243,24525,9128,15397,3.152,8.47,5136,1.774,16.939,693,694,3837
2020,3399,13033,13632,256668,259026,1001,7.228,1436,10.369,22884,6248,16636,2.412,8.835,27369,7845,19524,3.029,10.566,-4485,-1.731,17.669,1132,1134,5490
2020,4231,13532,21557,417296,417843,1119,5.132,1614,7.402,36462,8432,28030,2.018,8.726,37717,11017,26700,2.637,9.027,-1255,-0.3,17.453,1133,1192,5779
2020,4232,9407,11304,164603,166250,629,5.449,1109,9.607,13878,2572,11306,1.547,8.348,17064,6338,10726,3.812,10.264,-3186,-1.916,16.695,859,937,4761
2020,4233,9331,16905,266131,264206,1020,6.028,1050,6.206,30834,8771,22063,3.32,11.67,26755,9191,17564,3.479,10.127,4079,1.544,20.253,657,706,4583
2020,4234,19889,32271,664072,652470,1873,5.757,2396,7.365,76871,17134,59737,2.626,11.782,54111,18548,35563,2.843,8.293,22760,3.488,16.587,1741,1789,9929
2020,4235,6351,8762,151234,152256,308,3.465,561,6.312,11315,2250,9065,1.478,7.432,13432,3383,10049,2.222,8.822,-2117,-1.39,14.863,399,423,2241
2020,4236,16320,25795,516612,519244,1359,5.182,2224,8.48,44603,10696,33907,2.06,8.59,49650,18650,31000,3.592,9.562,-5047,-0.972,17.18,1391,1449,8152
2020,4237,9124,19014,262652,262388,841,4.422,847,4.454,22383,5439,16944,2.073,8.53,22077,8511,13566,3.244,8.414,306,0.117,16.828,572,610,3429
2020,4238,35763,53002,781785,783205,2259,4.227,3137,5.87,67598,18465,49133,2.358,8.631,70165,22429,47736,2.864,8.959,-2567,-0.328,17.262,2208,2321,12713
2020,4239,24705,28022,321778,324358,2242,7.899,2967,10.453,34151,9818,24333,3.027,10.529,39378,13052,26326,4.024,12.14,-5227,-1.611,21.058,2364,2419,9878
2020,4241,6031,8142,143301,145145,338,4.079,627,7.567,12371,3369,9002,2.321,8.523,16057,5447,10610,3.753,11.063,-3686,-2.54,17.046,470,482,2655
2020,4242,6391,9578,301500,301860,763,7.889,951,9.833,27618,6244,21374,2.069,9.149,28770,11690,17080,3.873,9.531,-1152,-0.382,18.299,636,651,3886
2020,4243,11713,12659,182785,187569,1057,8.152,1671,12.888,18648,4544,14104,2.423,9.942,28068,8845,19223,4.716,14.964,-9420,-5.022,19.884,1364,1393,6980
2020,4244,24555,32027,827281,842453,2291,7.081,2946,9.105,85129,21391,63738,2.539,10.105,117221,50025,67196,5.938,13.914,-32092,-3.809,20.21,2068,2090,12966
2020,4245,3028,5793,60686,61495,278,4.768,352,6.038,6737,2215,4522,3.602,10.955,8280,2222,6058,3.613,13.465,-1543,-2.509,21.911,189,203,918
2020,4246,7062,11381,160866,160850,515,4.485,716,6.236,14114,3536,10578,2.198,8.775,14078,4584,9494,2.85,8.752,36,0.022,17.505,481,505,2516
2020,4247,3570,6006,101746,101517,368,6.136,350,5.836,11807,3304,8503,3.255,11.631,11416,3350,8066,3.3,11.245,391,0.385,22.491,190,204,1016
2020,4248,3217,4300,207784,206938,311,7.238,305,7.098,17240,4492,12748,2.171,8.331,15760,3567,12193,1.724,7.616,1480,0.715,15.232,250,256,2589
2020,4249,18570,25356,338346,336978,1909,7.483,2218,8.694,41183,9745,31438,2.892,12.221,38602,11690,26912,3.469,11.455,2581,0.766,22.911,1692,1736,8151
2020,4251,29349,31424,267404,269460,3145,9.883,3943,12.39,33447,12894,20553,4.785,12.413,37593,15880,21713,5.893,13.951,-4146,-1.539,24.825,3210,3217,8254
2020,4411,36380,42912,1340161,1336123,3369,7.808,3840,8.9,115599,42649,72950,3.192,8.652,107551,38123,69428,2.853,8.049,8048,0.602,16.099,3229,3292,32652
2020,4412,10499,12391,155986,154372,782,6.243,1052,8.399,18629,6960,11669,4.509,12.068,15623,5954,9669,3.857,10.12,3006,1.947,20.241,828,861,4982
2020,4413,24644,55279,543092,540090,2189,3.937,2831,5.092,57400,11423,45977,2.115,10.628,51234,14768,36466,2.734,9.486,6166,1.142,18.972,1892,1952,8498
2020,4421,11784,21199,204913,205242,2129,9.867,2884,13.366,25057,8683,16374,4.231,12.209,25302,9898,15404,4.823,12.328,-245,-0.119,24.417,1210,1425,6017
2020,4422,16139,23745,257325,262487,1172,4.846,2052,8.485,16382,5521,10861,2.103,6.241,26284,8637,17647,3.29,10.013,-9902,-3.772,12.482,1325,1443,4843
2020,4431,13443,23111,269727,281123,1003,4.221,2302,9.688,17832,5333,12499,1.897,6.343,40418,10718,29700,3.813,14.377,-22586,-8.034,12.686,1731,1831,7009
2020,4441,31325,53517,1188404,1185694,2125,3.942,2895,5.371,63566,16603,46963,1.4,5.361,57039,13988,43051,1.18,4.811,6527,0.55,9.621,2081,2178,10371
2020,4442,11413,15633,156894,155468,756,4.79,1053,6.672,17512,4235,13277,2.724,11.264,14564,4652,9912,2.992,9.368,2948,1.896,18.736,862,889,3746
2020,4451,59974,86321,2841930,2824935,7721,8.959,7451,8.645,243391,98927,144464,3.502,8.616,207377,61912,145465,2.192,7.341,36014,1.275,14.682,5796,5933,31379
2020,4452,16122,19796,165445,163883,1872,9.402,2101,10.552,27626,10029,17597,6.12,16.857,24776,9681,15095,5.907,15.118,2850,1.739,30.236,1690,1727,8043
2020,4453,28306,32328,177847,176378,2358,7.281,2476,7.645,25241,7662,17579,4.344,14.311,22108,8533,13575,4.838,12.534,3133,1.776,25.069,2002,2042,6873
2020,4461,39457,90357,1029506,1030063,7794,8.634,7612,8.433,95705,46741,48964,4.538,9.291,99649,43905,55744,4.262,9.674,-3944,-0.383,18.582,3832,4151,19610
2020,4471,60289,106904,993730,994318,6489,6.039,7582,7.056,121916,42097,79819,4.234,12.261,124234,41585,82649,4.182,12.494,-2318,-0.233,24.523,5018,5378,24503
2020,4481,31004,85358,1287147,1307701,4851,5.569,8343,9.578,146032,33834,112198,2.587,11.167,186717,67164,119553,5.136,14.278,-40685,-3.111,22.334,3899,5910,39394
2020,4482,4090,21510,211363,217049,515,2.358,1185,5.425,23227,3356,19871,1.546,10.701,36448,6360,30088,2.93,16.793,-13221,-6.091,21.403,462,490,1621
2020,4483,13141,19437,114948,116791,926,4.663,1770,8.913,11943,2933,9010,2.511,10.226,15552,6302,9250,5.396,13.316,-3609,-3.09,20.452,1119,1222,3810
2020,4511,22311,32190,402944,408248,2058,6.294,3075,9.404,42348,14009,28339,3.431,10.373,53251,18086,35165,4.43,13.044,-10903,-2.671,20.746,2233,2424,9313
2020,4512,2956,6275,62644,63466,392,6.093,709,11.02,8230,2367,5863,3.73,12.968,9451,4457,4994,7.023,14.892,-1221,-1.924,25.935,335,344,1145
2020,4522,15,3773,450495,438006,14,0.367,88,2.31,47623,639,46984,0.146,10.873,20835,5971,14864,1.363,4.757,26788,6.116,9.514,(D),(D),(D)
2020,4523,6834,50261,2319382,2315679,2899,5.785,2604,5.196,129537,25811,103726,1.115,5.594,119396,46044,73352,1.988,5.156,10141,0.438,10.312,853,884,2846
2020,4531,10222,10642,51769,53202,819,7.544,1247,11.487,6903,2331,4572,4.381,12.975,9685,3751,5934,7.051,18.204,-2782,-5.229,25.95,1032,1070,3109
2020,4532,14231,22214,186162,194890,1422,6.212,2776,12.127,19001,5638,13363,2.893,9.75,36568,14180,22388,7.276,18.763,-17567,-9.014,19.499,1843,2182,9138
2020,4533,11511,17659,205883,203676,1127,6.295,1614,9.016,27690,6752,20938,3.315,13.595,23197,7890,15307,3.874,11.389,4493,2.206,22.778,1258,1290,4391
2020,4539,34850,46672,322483,316240,5188,11.177,4678,10.078,54289,23154,31135,7.322,17.167,41926,16474,25452,5.209,13.258,12363,3.909,26.515,3736,3923,13765
2020,4541,35523,37394,648155,607033,6325,17.134,5366,14.536,153791,102679,51112,16.915,25.335,67753,33685,34068,5.549,11.161,86038,14.174,22.323,4475,4524,17882
2020,4542,2567,3220,41047,42164,386,11.866,452,13.895,4602,1685,2917,3.996,10.915,6751,2929,3822,6.947,16.011,-2149,-5.097,21.829,354,359,1502
2020,4543,20798,26014,177285,179226,2229,8.475,2805,10.665,20904,7041,13863,3.929,11.663,24681,10172,14509,5.676,13.771,-3777,-2.107,23.327,2277,2312,8361
2020,4811,409,2124,480078,474322,92,4.31,113,5.294,32683,3244,29439,0.684,6.89,20787,4821,15966,1.016,4.382,11896,2.508,8.765,30,59,394
2020,4812,1743,2012,46906,46529,206,10.251,201,10.002,5307,804,4503,1.728,11.406,4462,1409,3053,3.028,9.59,845,1.816,19.18,158,159,769
2020,4831,637,942,44965,43889,108,11.588,88,9.442,5358,663,4695,1.511,12.208,3314,1137,2177,2.591,7.551,2044,4.657,15.102,57,57,545
2020,4832,460,527,20030,20126,67,12.872,54,10.375,2874,240,2634,1.192,14.28,3020,1596,1424,7.93,15.005,-146,-0.725,28.56,37,37,124
2020,4841,63706,75348,1125708,1104031,13348,17.857,12149,16.253,176946,84975,91971,7.697,16.027,132608,48245,84363,4.37,12.011,44338,4.016,24.023,9318,9401,32823
2020,4842,39407,43193,502182,502359,5006,11.49,5754,13.207,71032,26747,44285,5.324,14.14,70881,24620,46261,4.901,14.11,151,0.03,28.219,4657,4720,18233
2020,4851,383,634,53509,54243,39,5.963,79,12.08,4147,600,3547,1.106,7.645,5447,2317,3130,4.272,10.042,-1300,-2.397,15.29,49,49,449
2020,4852,271,567,18261,18423,20,3.445,47,8.096,1595,223,1372,1.21,8.658,1914,654,1260,3.55,10.389,-319,-1.732,17.316,33,33,243
2020,4853,6079,6263,68734,70258,963,14.901,1362,21.075,9853,3835,6018,5.458,14.024,12920,5316,7604,7.566,18.389,-3067,-4.365,28.048,1199,1203,4261
2020,4854,2383,3937,239942,237971,221,5.451,456,11.247,23023,7841,15182,3.295,9.675,19020,8237,10783,3.461,7.993,4003,1.682,15.985,212,212,2862
2020,4855,948,1076,29868,30395,68,6.121,138,12.421,3033,662,2371,2.178,9.979,4037,791,3246,2.602,13.282,-1004,-3.303,19.958,120,122,579
2020,4859,4599,5088,101949,101053,866,17.26,725,14.449,16869,5761,11108,5.701,16.693,15099,6918,8181,6.846,14.942,1770,1.752,29.883,618,618,6049
2020,4861,67,605,10222,10780,16,2.413,132,19.91,1066,110,956,1.02,9.889,2206,1005,1201,9.323,20.465,-1140,-10.576,19.778,10,13,70
2020,4862,106,2084,26773,27021,225,11.095,113,5.572,4167,1193,2974,4.415,15.421,4649,598,4051,2.213,17.205,-482,-1.784,30.843,9,20,101
2020,4869,77,718,9325,8952,72,10.375,24,3.458,1469,657,812,7.339,16.41,708,108,600,1.206,7.909,761,8.501,15.818,4,4,32
2020,4871,574,617,10590,10845,70,11.006,108,16.981,1239,307,932,2.831,11.425,1725,299,1426,2.757,15.907,-486,-4.482,22.85,94,94,249
2020,4872,1368,1415,14310,14768,195,13.835,184,13.054,1779,761,1018,5.153,12.047,2712,836,1876,5.661,18.365,-933,-6.318,24.093,143,143,372
2020,4879,191,222,3338,3426,24,10.738,27,12.081,271,48,223,1.401,7.91,443,82,361,2.393,12.931,-172,-5.02,15.82,23,23,77
2020,4881,3932,5761,222731,223710,382,6.596,442,7.633,19139,3500,15639,1.565,8.555,20590,7182,13408,3.21,9.204,-1451,-0.649,17.111,296,325,4729
2020,4882,534,1622,45503,43968,350,23.125,133,8.788,8538,5928,2610,13.483,19.419,5735,1140,4595,2.593,13.044,2803,6.375,26.087,37,42,334
2020,4883,1795,2387,80350,91258,169,7.074,173,7.242,6812,1045,5767,1.145,7.465,27673,1251,26422,1.371,30.324,-20861,-22.859,14.929,122,122,894
2020,4884,10186,11809,115313,114553,1616,13.812,1398,11.949,18429,6728,11701,5.873,16.088,17035,7418,9617,6.476,14.871,1394,1.217,29.742,1118,1134,5227
2020,4885,13607,19703,304285,300911,1420,7.172,1611,8.137,41841,13892,27949,4.617,13.905,35330,12836,22494,4.266,11.741,6511,2.164,23.482,1102,1131,5856
2020,4889,1558,1646,20443,19660,228,14.001,193,11.851,4006,1081,2925,5.498,20.376,2399,947,1452,4.817,12.202,1607,8.174,24.405,160,164,748
2020,4921,3972,9474,857216,817256,840,8.906,756,8.015,108648,28093,80555,3.437,13.294,28271,14014,14257,1.715,3.459,80377,9.835,6.919,451,465,6032
2020,4922,3553,4148,101936,89380,714,17.647,510,12.605,39946,25532,14414,28.566,44.692,14265,3467,10798,3.879,15.96,25681,28.732,31.92,422,429,2930
2020,4931,7720,16776,1144269,1124278,1659,9.921,1551,9.275,166210,80261,85949,7.139,14.784,126411,60949,65462,5.421,11.244,39799,3.54,22.487,479,504,6021
2020,5111,9638,13661,309049,314475,769,5.52,1309,9.396,28002,11341,16661,3.606,8.904,39060,10706,28354,3.404,12.421,-11058,-3.516,17.809,917,1015,6526
2020,5112,9793,13334,693918,674943,1963,14.963,1533,11.685,104293,29932,74361,4.435,15.452,66778,21621,45157,3.203,9.894,37515,5.558,19.788,1216,1235,14525
2020,5121,15227,18418,297462,300704,2911,15.992,2480,13.625,43183,18373,24810,6.11,14.361,48733,20156,28577,6.703,16.206,-5550,-1.846,28.721,1814,1854,11305
2020,5122,2895,3105,23906,23287,444,14.444,382,12.427,3781,1401,2380,6.016,16.237,2601,1228,1373,5.273,11.169,1180,5.067,22.339,293,293,927
2020,5151,3590,6882,221769,216493,414,5.958,548,7.886,40694,19735,20959,9.116,18.797,30514,13907,16607,6.424,14.095,10180,4.702,28.189,221,238,1624
2020,5152,341,1036,53386,54368,270,27.565,157,16.029,7609,4573,3036,8.411,13.995,9345,7330,2015,13.482,17.189,-1736,-3.193,27.991,19,19,56
2020,5173,7355,56388,954432,981288,3706,6.554,4027,7.121,88759,22163,66596,2.259,9.045,141993,31434,110559,3.203,14.47,-53234,-5.425,18.09,987,1194,6024
2020,5174,284,409,10188,10347,39,9.375,53,12.74,988,126,862,1.218,9.549,1299,577,722,5.576,12.554,-311,-3.006,19.097,40,40,176
2020,5179,2859,4275,58284,59448,638,15.136,518,12.289,8619,3944,4675,6.634,14.499,10773,4300,6473,7.233,18.122,-2154,-3.623,28.997,329,393,1935
2020,5182,9390,15932,561203,558288,1278,7.974,1467,9.154,69352,16742,52610,2.999,12.422,63212,21923,41289,3.927,11.322,6140,1.1,22.645,970,995,10591
2020,5191,9031,11149,329287,318189,1529,13.818,1361,12.3,52638,15133,37505,4.756,16.543,29624,11917,17707,3.745,9.31,23014,7.233,18.62,946,964,6552
2020,5211,12,58,20213,20090,(D),(D),0,0,344,(D),342,(D),1.712,105,0,105,0,0.523,239,1.19,1.045,0,0,0
2020,5221,9757,112559,1967001,1958588,3226,2.844,4952,4.366,190270,38063,152207,1.943,9.715,170855,34731,136124,1.773,8.723,19415,0.991,17.447,287,499,5238
2020,5222,12656,43384,640538,623589,4045,9.285,4411,10.125,100915,31194,69721,5.002,16.183,66647,25155,41492,4.034,10.688,34268,5.495,21.375,1062,1468,7823
2020,5223,11884,25829,318598,314287,2204,8.54,2163,8.381,41547,16422,25125,5.225,13.219,33102,13598,19504,4.327,10.532,8445,2.687,21.065,963,1064,5543
2020,5231,8733,25709,349631,351444,1412,5.383,2460,9.378,36870,6582,30288,1.873,10.491,39817,10486,29331,2.984,11.33,-2947,-0.839,20.982,765,789,2891
2020,5232,23,45,6063,8789,11,26.829,(D),(D),622,314,308,3.573,7.077,6219,(D),631,(D),70.763,-5597,-63.685,14.155,0,0,0
2020,5239,47846,68250,581122,577401,7208,10.692,5539,8.216,73829,22502,51327,3.897,12.786,67297,23765,43532,4.116,11.655,6532,1.131,23.31,4048,4146,13345
2020,5241,4907,29775,1570885,1560165,2718,9.167,2467,8.321,168702,47517,121185,3.046,10.813,146923,40332,106591,2.585,9.417,21779,1.396,18.834,349,379,1987
2020,5242,117240,136707,1192884,1178192,11070,8.058,12401,9.027,175931,57384,118547,4.871,14.932,145856,60468,85388,5.132,12.38,30075,2.553,24.759,9143,9332,34070
2020,5259,1169,1225,8083,7511,371,32.601,197,17.311,2273,1479,794,19.691,30.262,1117,737,380,9.812,14.872,1156,15.391,29.743,166,166,620
2020,5311,86488,118711,615275,608465,11182,9.417,11252,9.476,99129,44019,55110,7.234,16.292,84481,38388,46093,6.309,13.884,14648,2.407,27.769,8450,8667,25621
2020,5312,91302,107400,361847,356745,18265,17.407,13319,12.694,63716,35827,27889,10.043,17.86,54510,26415,28095,7.404,15.28,9206,2.581,30.56,8961,9073,15398
2020,5313,72221,90778,748919,738734,9840,10.933,8294,9.215,115143,47067,68076,6.371,15.587,94706,39083,55623,5.291,12.82,20437,2.766,25.64,6134,6307,23842
2020,5321,3396,15240,176438,176871,793,5.162,1036,6.744,17243,3624,13619,2.049,9.749,17817,6396,11421,3.616,10.073,-574,-0.325,19.498,361,372,1370
2020,5322,6524,15236,123349,127539,1112,7.162,1693,10.904,14084,4212,9872,3.303,11.043,22200,7350,14850,5.763,17.407,-8116,-6.364,22.086,763,799,3953
2020,5323,1982,2640,19592,19551,100,3.652,296,10.811,2371,437,1934,2.235,12.127,2307,943,1364,4.823,11.8,64,0.327,23.6,140,160,639
2020,5324,7476,14497,205660,202341,937,6.405,1203,8.223,31843,10110,21733,4.997,15.737,25649,8861,16788,4.379,12.676,6194,3.061,25.352,622,673,3534
2020,5331,2103,2246,37155,36087,252,11.043,324,14.198,6534,1184,5350,3.281,18.106,4502,1648,2854,4.567,12.475,2032,5.631,24.951,257,262,1318
2020,5411,152783,164845,1160775,1155225,11873,7.173,13230,7.993,117226,30455,86771,2.636,10.147,106297,34553,71744,2.991,9.201,10929,0.946,18.403,10974,11065,28103
2020,5412,101256,120821,1177974,1167225,11334,9.438,9872,8.221,158664,41412,117252,3.548,13.593,136592,67059,69533,5.745,11.702,22072,1.891,23.405,7346,7453,31400
2020,5413,81789,102208,1607930,1590366,8732,8.54,8804,8.611,189665,52345,137320,3.291,11.926,154464,54955,99509,3.455,9.712,35201,2.213,19.425,6342,6467,28435
2020,5414,27340,27723,122572,122654,3748,13.505,3809,13.724,18761,7497,11264,6.112,15.296,18893,8343,10550,6.802,15.403,-132,-0.108,30.592,3078,3084,6889
2020,5415,100024,121027,2018412,1980597,17103,14.237,15317,12.75,333007,119545,213462,6.036,16.813,259979,79686,180293,4.023,13.126,73028,3.687,26.253,12040,12140,52228
2020,5416,138853,149763,1458499,1421736,27461,18.61,23056,15.625,303597,124995,178602,8.792,21.354,228923,103711,125212,7.295,16.102,74674,5.252,32.203,18278,18374,61435
2020,5417,14396,17898,810788,792766,2131,11.983,1902,10.695,101342,17862,83480,2.253,12.783,65729,21699,44030,2.737,8.291,35613,4.492,16.582,1387,1429,9934
2020,5418,28434,32312,468667,469006,3484,10.743,3719,11.468,47580,13982,33598,2.981,10.145,47839,18506,29333,3.946,10.2,-259,-0.055,20.29,2962,3009,14091
2020,5419,56535,64727,702961,701913,7296,11.336,6567,10.203,97905,29697,68208,4.231,13.948,95129,35686,59443,5.084,13.553,2776,0.395,27.106,5280,5328,29381
2020,5511,25031,51102,3592941,3553137,2807,5.416,4255,8.21,511749,162131,349618,4.563,14.403,428595,129962,298633,3.658,12.062,83154,2.34,24.125,828,886,17462
2020,5611,26864,30116,545010,534623,3408,11.322,3379,11.225,91951,38837,53114,7.264,17.199,72017,26898,45119,5.031,13.471,19934,3.729,26.941,2663,2673,19319
2020,5612,1973,8289,288122,291696,1163,14.703,405,5.12,35902,16113,19789,5.524,12.308,43065,9463,33602,3.244,14.764,-7163,-2.456,24.616,149,156,2649
2020,5613,24416,48991,6045979,6084713,4336,8.815,4727,9.61,1009120,338855,670265,5.569,16.585,1097289,256275,841014,4.212,18.034,-88169,-1.449,33.169,2677,2760,91413
2020,5614,20424,30675,786129,790491,5338,18.149,2811,9.557,133026,49721,83305,6.29,16.828,143301,45697,97604,5.781,18.128,-10275,-1.3,33.657,2064,2114,13522
2020,5615,12065,15764,221418,223840,1353,8.476,1749,10.957,21585,6609,14976,2.953,9.643,26456,8551,17905,3.82,11.819,-4871,-2.176,19.286,1443,1460,5351
2020,5616,18241,23766,1003251,1007077,2596,10.954,2464,10.397,123248,39851,83397,3.957,12.238,131091,38246,92845,3.798,13.017,-7843,-0.779,24.476,1749,1766,24948
2020,5617,161859,170864,2062780,2051696,23220,13.673,21140,12.448,338912,125467,213445,6.115,16.519,315773,121732,194041,5.933,15.391,23139,1.128,30.782,16701,16725,71565
2020,5619,15875,17864,305832,305095,1921,10.776,1846,10.355,39945,11765,28180,3.856,13.093,38058,10705,27353,3.509,12.474,1887,0.618,24.948,1512,1522,7728
2020,5621,7226,11204,236707,233315,748,6.685,718,6.417,24090,9096,14994,3.899,10.325,17478,6230,11248,2.67,7.491,6612,2.834,14.982,572,582,4836
2020,5622,1217,2573,61383,60355,176,6.882,145,5.67,6428,2846,3582,4.715,10.65,4575,1457,3118,2.414,7.58,1853,3.07,15.16,100,100,743
2020,5629,8996,10612,152121,150354,965,9.139,859,8.135,22338,6273,16065,4.172,14.857,18909,5331,13578,3.546,12.576,3429,2.281,25.153,666,675,3888
2020,6111,18653,21635,1107637,1102454,791,3.641,976,4.492,77367,14544,62823,1.319,7.018,67403,18731,48672,1.699,6.114,9964,0.904,12.228,736,749,14310
2020,6112,396,739,56394,57487,15,1.979,53,6.992,3029,224,2805,0.39,5.269,5160,627,4533,1.091,8.976,-2131,-3.707,10.538,18,23,191
2020,6113,2349,4024,1813681,1825981,249,6.219,209,5.22,61867,10656,51211,0.584,3.388,86198,7148,79050,0.391,4.721,-24331,-1.332,6.776,81,82,3547
2020,6114,6622,7041,73828,72671,870,12.367,858,12.196,12164,3881,8283,5.341,16.738,9755,3654,6101,5.028,13.424,2409,3.315,26.847,704,706,2882
2020,6115,6204,7596,107442,105970,695,9.153,690,9.087,15634,4838,10796,4.565,14.753,12803,3185,9618,3.006,12.082,2831,2.672,24.164,500,530,2177
2020,6116,45611,49093,477182,472511,6123,12.611,5045,10.39,82496,31664,50832,6.701,17.459,72892,22736,50156,4.812,15.427,9604,2.033,30.853,4071,4176,17698
2020,6117,7611,8467,116507,111704,1408,17.007,1032,12.465,23240,7785,15455,6.969,20.805,13868,4886,8982,4.374,12.415,9372,8.39,24.83,832,835,3780
2020,6211,148609,204124,2644480,2602205,17693,8.679,17167,8.421,379847,149801,230046,5.757,14.597,295394,105538,189856,4.056,11.352,84453,3.245,22.703,12017,12386,56229
2020,6212,115925,128097,974221,975155,7216,5.609,8318,6.466,116766,41367,75399,4.242,11.974,118488,41652,76836,4.271,12.151,-1722,-0.177,23.948,7044,7181,36598
2020,6213,128266,151576,996488,981680,14594,9.704,12240,8.138,160328,54977,105351,5.6,16.332,129868,48813,81055,4.972,13.229,30460,3.103,26.458,9202,9438,35428
2020,6214,18448,46179,1193361,1179445,3039,6.589,2922,6.336,126077,35504,90573,3.01,10.69,99052,31802,67250,2.696,8.398,27025,2.291,16.796,1263,1416,13839
2020,6215,6369,16565,289191,288045,1049,6.22,1647,9.766,46107,11701,34406,4.062,16.007,43491,15038,28453,5.221,15.099,2616,0.908,30.197,644,676,7407
2020,6216,22289,32315,1589209,1564179,4326,13.593,3346,10.514,229499,64898,164601,4.149,14.672,180710,58573,122137,3.745,11.553,48789,3.119,23.106,2195,2238,27008
2020,6219,6370,11636,347321,345361,1301,11.256,1146,9.915,51124,16882,34242,4.888,14.803,47444,16710,30734,4.838,13.738,3680,1.066,27.475,484,534,6338
2020,6221,2393,5425,5615418,5589948,164,3.04,105,1.946,229834,19952,209882,0.357,4.112,178467,45989,132478,0.823,3.193,51367,0.919,6.385,29,29,5610
2020,6222,423,723,251406,251317,35,4.923,11,1.547,7497,1781,5716,0.709,2.983,7284,1437,5847,0.572,2.898,213,0.085,5.797,4,5,571
2020,6223,290,752,251236,245223,24,3.194,23,3.061,22987,5390,17597,2.198,9.374,10961,2576,8385,1.05,4.47,12026,4.904,8.94,8,8,1024
2020,6231,9036,16582,1589330,1604277,1132,6.842,1058,6.395,135114,64876,70238,4.044,8.422,164884,66086,98798,4.119,10.278,-29770,-1.856,16.844,659,729,44661
2020,6232,10296,42788,794318,793880,1829,4.278,1769,4.137,84095,21834,62261,2.75,10.593,83294,22184,61110,2.794,10.492,801,0.101,20.984,589,714,9653
2020,6233,16760,24718,1029374,1017872,2020,8.18,1975,7.997,112392,46490,65902,4.567,11.042,89212,37686,51526,3.702,8.765,23180,2.277,17.529,1469,1559,24250
2020,6239,3080,5713,128605,127264,541,9.641,338,6.023,14779,3850,10929,3.025,11.613,11815,2963,8852,2.328,9.284,2964,2.329,18.568,217,223,1707
2020,6241,58394,77334,1985864,1954219,8631,11.346,6109,8.03,254447,56663,197784,2.9,13.02,190406,55636,134770,2.847,9.743,64041,3.277,19.487,4378,4482,34202
2020,6242,10454,14615,219210,217235,692,4.753,581,3.991,22977,4736,18241,2.18,10.577,19157,4984,14173,2.294,8.819,3820,1.758,17.637,341,349,2309
2020,6243,3741,7062,270683,273140,335,4.715,422,5.939,29217,5532,23685,2.025,10.697,33983,7420,26563,2.717,12.442,-4766,-1.745,21.393,181,184,1585
2020,6244,56450,72452,1014200,1008846,6411,8.842,6520,8.992,129994,45801,84193,4.54,12.885,119479,45418,74061,4.502,11.843,10515,1.042,23.686,5017,5114,33071
2020,7111,7698,7821,124179,125550,972,12.454,940,12.044,16681,4553,12128,3.626,13.286,19678,5522,14156,4.398,15.673,-2997,-2.387,26.573,773,773,4678
2020,7112,3339,3536,138078,138208,493,14.1,414,11.84,17106,2811,14295,2.034,12.377,17115,4566,12549,3.304,12.384,-9,-0.007,24.754,351,352,2608
2020,7113,6535,7070,195070,196757,647,9.09,742,10.425,21595,3270,18325,1.662,10.975,25218,5165,20053,2.625,12.817,-3623,-1.841,21.951,623,628,3761
2020,7114,3333,3480,25136,24096,531,15.459,441,12.838,4996,2899,2097,12.031,20.734,2759,1269,1490,5.266,11.45,2237,9.284,22.9,373,373,1124
2020,7115,19533,19578,56755,56805,4227,22.128,3276,17.15,14630,8248,6382,14.52,25.755,14819,6792,8027,11.957,26.088,-189,-0.333,51.51,2546,2550,5630
2020,7121,6820,7277,160474,160291,368,5.053,379,5.204,10857,1433,9424,0.894,6.773,10430,1932,8498,1.205,6.507,427,0.266,13.014,274,276,1477
2020,7131,2883,3414,200135,204211,568,16.867,475,14.105,23394,12682,10712,6.21,11.456,31035,4885,26150,2.392,15.198,-7641,-3.742,22.912,428,428,4266
2020,7132,1812,2942,138427,138471,190,6.461,187,6.359,8183,2053,6130,1.483,5.91,8254,2166,6088,1.564,5.961,-71,-0.051,11.819,131,141,1523
2020,7139,57105,67234,1434049,1428742,8005,11.983,7148,10.7,207238,84536,122702,5.917,14.505,196632,60870,135762,4.26,13.763,10606,0.742,27.525,5715,5875,47848
2020,7211,43279,55119,2100592,2104346,5040,9.19,4483,8.175,221418,112363,109055,5.34,10.522,226784,85859,140925,4.08,10.777,-5366,-0.255,21.044,3416,3536,48258
2020,7212,5547,6193,47641,47971,517,8.336,535,8.626,6872,1958,4914,4.082,14.325,7442,1884,5558,3.927,15.514,-570,-1.188,28.651,418,418,1547
2020,7213,1488,1661,10206,10496,115,6.803,174,10.293,1670,559,1111,5.326,15.911,2254,483,1771,4.602,21.475,-584,-5.564,31.822,141,142,366
2020,7223,17826,43628,796543,816100,5531,12.809,4633,10.73,111883,43748,68135,5.361,13.709,146595,43335,103260,5.31,17.963,-34712,-4.253,27.419,2582,2644,13733
2020,7224,35193,36058,374091,379319,3453,9.468,4280,11.735,61120,28930,32190,7.627,16.113,71655,27041,44614,7.129,18.89,-10535,-2.777,32.226,3648,3654,22791
2020,7225,386593,532626,11034952,11073885,49929,9.364,51058,9.576,1494995,658428,836567,5.946,13.5,1580917,551195,1029722,4.977,14.276,-85922,-0.776,27,40928,42911,431828
2020,8111,132734,148386,922903,927422,11904,7.975,13648,9.144,116609,43592,73017,4.7,12.573,126253,49203,77050,5.305,13.613,-9644,-1.04,25.147,11109,11283,40836
2020,8112,9336,10608,102146,101391,905,8.368,1320,12.205,13527,3471,10056,3.423,13.341,11873,5637,6236,5.56,11.71,1654,1.631,23.42,1032,1048,3258
2020,8113,17931,19709,207124,206790,1423,7.16,1755,8.83,25934,8244,17690,3.987,12.541,25306,8670,16636,4.193,12.238,628,0.304,24.475,1429,1431,5784
2020,8114,17516,18294,72416,72455,2102,11.416,2339,12.703,11273,5007,6266,6.91,15.559,11346,5410,5936,7.467,15.659,-73,-0.101,31.117,1908,1912,4288
2020,8121,110113,124421,748274,755898,16892,13.559,17209,13.814,134458,68023,66435,8.999,17.788,147864,70002,77862,9.261,19.561,-13406,-1.774,35.576,12309,12586,47538
2020,8122,13521,19316,134119,134486,543,2.786,892,4.577,12549,2448,10101,1.82,9.331,13226,3623,9603,2.694,9.835,-677,-0.503,18.662,633,716,3029
2020,8123,24673,29642,280033,281087,2181,7.239,3151,10.459,41096,15368,25728,5.467,14.62,42889,19645,23244,6.989,15.258,-1793,-0.638,29.241,2468,2556,10393
2020,8129,35611,46231,384322,373409,8332,18.507,5912,13.132,87121,39678,47443,10.626,23.331,64958,24647,40311,6.601,17.396,22163,5.935,34.792,3991,4033,15806
2020,8131,174914,175847,1651277,1668398,6512,3.671,9561,5.39,117610,18696,98914,1.121,7.049,152481,36316,116165,2.177,9.139,-34871,-2.09,14.099,7865,7865,28951
2020,8132,17942,20030,205888,202873,1532,7.7,1262,6.343,22702,5775,16927,2.847,11.19,16698,5365,11333,2.645,8.231,6004,2.959,16.462,990,990,3548
2020,8133,15465,18251,190818,187042,1491,8.24,1179,6.516,23671,5319,18352,2.844,12.655,16190,3974,12216,2.125,8.656,7481,4,17.312,853,858,2935
2020,8134,21954,23433,221554,223356,1353,5.712,1860,7.853,22891,5354,17537,2.397,10.249,26216,7117,19099,3.186,11.737,-3325,-1.489,20.497,1427,1439,5465
2020,8139,51062,53244,488127,487892,2526,4.722,3029,5.662,47308,10638,36670,2.18,9.696,46619,12480,34139,2.558,9.555,689,0.141,19.11,2534,2537,10158
