year,sector,firms,estabs,emp,denom,estabs_entry,estabs_entry_rate,estabs_exit,estabs_exit_rate,job_creation,job_creation_births,job_creation_continuers,job_creation_rate_births,job_creation_rate,job_destruction,job_destruction_deaths,job_destruction_continuers,job_destruction_rate_deaths,job_destruction_rate,net_job_creation,net_job_creation_rate,reallocation_rate,firmdeath_firms,firmdeath_estabs,firmdeath_emp,
1978,11,20326,20982,186614,179569,4006,19.234,3697,17.751,56893,20326,36567,11.319,31.683,43244,17353,25891,9.664,24.082,13649,7.601,48.164,2691,2717,12161,3621670
1978,21,19243,24859,708993,710882,4004,16.364,3223,13.172,166291,58323,107968,8.204,23.392,169910,60736,109174,8.544,23.901,-3619,-0.509,46.784,1761,1793,16862,0.07241466
1978,22,5656,11817,656971,641929,914,7.849,570,4.895,81580,19818,61762,3.087,12.709,51893,13416,38477,2.09,8.084,29687,4.625,16.168,211,213,1807,
1978,23,426023,431678,4091918,3818618,91811,22.169,56728,13.698,1334289,420628,913661,11.015,34.942,786575,272937,513638,7.148,20.598,547714,14.343,41.197,43831,43871,189753,
1978,31-33,262262,310077,18305175,17873947,33347,10.868,26858,8.753,2402465,504670,1897795,2.823,13.441,1542228,526448,1015780,2.945,8.628,860237,4.813,17.257,18962,19106,222424,
1978,42,245236,320176,3981333,3850138,39720,12.606,29535,9.374,827131,269885,557246,7.01,21.483,564569,248333,316236,6.45,14.664,262562,6.82,29.327,18654,19057,102434,
1978,44-45,732673,988446,9816501,9499180,134884,13.771,116925,11.938,2069303,808769,1260534,8.514,21.784,1437149,633833,803316,6.673,15.129,632154,6.655,30.258,77251,79088,315352,
1978,48-49,90462,110710,2435720,2346861,18508,16.974,15168,13.91,542784,163997,378787,6.988,23.128,364492,137935,226557,5.877,15.531,178292,7.597,31.062,10822,10872,57665,
1978,51,38543,63081,2161301,2103291,7910,12.719,6126,9.851,374747,83924,290823,3.99,17.817,258207,79688,178519,3.789,12.276,116540,5.541,24.553,3364,3479,31034,
1978,52,145744,233054,4099554,3977997,25047,10.959,16029,7.013,679751,169651,510100,4.265,17.088,434628,138948,295680,3.493,10.926,245123,6.162,21.852,8600,8704,41370,
1978,53,169276,178121,1021689,978243,30616,17.543,23416,13.417,292753,122464,170289,12.519,29.926,204660,98192,106468,10.038,20.921,88093,9.005,41.842,18273,18327,60025,
1978,54,233729,248950,2202730,2099737,42169,17.551,24799,10.322,530793,195546,335247,9.313,25.279,325699,147603,178096,7.03,15.511,205094,9.768,31.023,17499,17760,95263,
1978,55,18969,36093,2434778,2368434,3915,10.958,3184,8.912,524823,137318,387505,5.798,22.159,391336,97684,293652,4.124,16.523,133487,5.636,33.046,402,433,4303,
1978,56,109204,122292,1965495,1840871,26377,22.519,16056,13.708,619950,206701,413249,11.228,33.677,371813,137025,234788,7.443,20.198,248137,13.479,40.395,11888,11975,74627,
1978,61,29441,31407,1274436,1201111,4319,14.036,3047,9.902,270127,31776,238351,2.646,22.49,125775,57204,68571,4.763,10.472,144352,12.018,20.943,2248,2281,46529,
1978,62,313919,340645,5572254,5307995,40901,12.363,21265,6.428,999783,295852,703931,5.574,18.835,469869,192327,277542,3.623,8.852,529914,9.983,17.704,14693,14874,107374,
1978,71,43359,45513,663139,626727,7815,17.656,5315,12.008,171688,61371,110317,9.792,27.394,98894,37138,61756,5.926,15.779,72794,11.615,31.559,3926,3945,23843,
1978,72,286506,342501,5222425,4941125,61638,18.217,53339,15.764,1520375,776179,744196,15.709,30.77,955202,485913,469289,9.834,19.332,565173,11.438,38.663,38258,38835,301333,
1978,81,431099,464378,3167340,3022839,62321,13.645,47061,10.303,763703,240524,523179,7.957,25.264,473065,180252,292813,5.963,15.65,290638,9.615,31.299,33751,34098,115057,
1979,11,19992,20597,187512,187701,3600,17.461,3640,17.655,50537,19497,31040,10.387,26.924,51041,20438,30603,10.889,27.193,-504,-0.269,53.849,2606,2650,13733,
1979,21,19961,25723,818197,764727,4182,16.601,3118,12.377,217969,52615,165354,6.88,28.503,110967,45819,65148,5.992,14.511,107002,13.992,29.021,1878,1895,19127,
1979,22,5925,12100,683038,670901,795,6.639,544,4.543,62367,21905,40462,3.265,9.296,38455,7137,31318,1.064,5.732,23912,3.564,11.464,213,213,957,
1979,23,448015,453702,4575364,4349905,84784,19.13,63759,14.386,1379220,388675,990545,8.935,31.707,928281,305945,622336,7.033,21.34,450939,10.367,42.681,49595,49626,224567,
1979,31-33,259253,307698,19091435,18712544,31369,10.228,29354,9.571,2443010,513018,1929992,2.742,13.055,1680444,551595,1128849,2.948,8.98,762566,4.075,17.961,19378,19560,221763,
1979,42,257246,333496,4252980,4144541,36663,11.121,29002,8.797,781970,239235,542735,5.772,18.867,564868,215852,349016,5.208,13.629,217102,5.238,27.258,18284,18638,98173,
1979,44-45,744718,1008061,10297332,10080415,123161,12.324,105781,10.585,1867519,742863,1124656,7.369,18.526,1428096,524722,903374,5.205,14.167,439423,4.359,28.334,72602,74226,298204,
1979,48-49,93759,114628,2601209,2517765,18969,16.877,14499,12.9,496400,148398,348002,5.894,19.716,329053,103908,225145,4.127,13.069,167347,6.647,26.139,10786,10825,54915,
1979,51,40793,65018,2280122,2227873,8041,12.533,6318,9.848,413663,82534,331129,3.705,18.568,309814,82517,227297,3.704,13.906,103849,4.661,27.813,3385,3413,25413,
1979,52,151882,245659,4448006,4279899,26499,11.05,14809,6.175,724528,194263,530265,4.539,16.929,389402,102422,286980,2.393,9.098,335126,7.83,18.197,8911,8962,37282,
1979,53,178841,188888,1119759,1074472,31942,17.302,23396,12.673,302833,122110,180723,11.365,28.184,212752,93877,118875,8.737,19.801,90081,8.384,39.601,18438,18484,62976,
1979,54,251454,267285,2433408,2321863,44411,17.179,26877,10.397,534549,196589,337960,8.467,23.022,311004,125228,185776,5.393,13.395,223545,9.628,26.789,19646,19840,78564,
1979,55,20050,37783,2578026,2506857,4334,11.702,2841,7.671,463198,144551,318647,5.766,18.477,319000,77808,241192,3.104,12.725,144198,5.752,25.45,421,426,4282,
1979,56,118974,133072,2216606,2097329,27774,21.768,16816,13.179,628830,209520,419310,9.99,29.982,390015,129983,260032,6.198,18.596,238815,11.387,37.192,12749,12831,77974,
1979,61,30072,32051,1311555,1261031,4021,12.706,3213,10.153,202119,29095,173024,2.307,16.028,100216,23073,77143,1.83,7.947,101903,8.081,15.894,2422,2456,15016,
1979,62,330219,359045,5928645,5749337,38884,11.102,21251,6.068,853531,257818,595713,4.484,14.846,496155,176673,319482,3.073,8.63,357376,6.216,17.26,15424,15605,115711,
1979,71,45614,47779,714926,689516,7821,16.752,5636,12.072,174492,52437,122055,7.605,25.306,123422,39131,84291,5.675,17.9,51070,7.407,35.8,4155,4176,28027,
1979,72,292962,352392,5550908,5402082,58834,16.901,50284,14.445,1395063,713171,681892,13.202,25.825,1102251,457904,644347,8.476,20.404,292812,5.42,40.808,36250,36776,293864,
1979,81,445022,479546,3339858,3256034,60080,12.718,45784,9.692,682410,227940,454470,7.001,20.958,515128,168706,346422,5.181,15.821,167282,5.138,31.641,33620,33944,116824,
1980,11,19937,20543,189577,189657,3276,15.9,3397,16.487,45922,16027,29895,8.451,24.213,46232,14981,31251,7.899,24.377,-310,-0.163,48.426,2590,2590,10891,
1980,21,21191,27037,854331,838011,4340,16.446,3045,11.539,171868,56118,115750,6.697,20.509,139146,44036,95110,5.255,16.604,32722,3.905,33.209,2015,2057,22228,
1980,22,5940,12205,698399,690477,585,4.813,483,3.974,42573,10573,32000,1.531,6.166,26798,7634,19164,1.106,3.881,15775,2.285,7.762,278,281,1252,
1980,23,439655,445114,4423006,4480037,71342,15.881,79561,17.711,1095045,323510,771535,7.221,24.443,1209442,350381,859061,7.821,26.996,-114397,-2.553,48.886,61212,61239,258581,
1980,31-33,263644,312128,18732427,18885819,32276,10.421,27473,8.87,1972635,500846,1471789,2.652,10.445,2285247,568094,1717153,3.008,12.1,-312612,-1.655,20.89,19879,20029,239104,
1980,42,262671,339700,4298526,4284130,35790,10.618,30506,9.051,660640,215606,445034,5.033,15.421,632196,221900,410296,5.18,14.757,28444,0.664,29.513,19976,20342,105017,
1980,44-45,743448,1013744,10176874,10243058,114678,11.34,109658,10.844,1565263,698266,866997,6.817,15.281,1693755,537600,1156155,5.248,16.536,-128492,-1.254,30.562,76167,78268,319234,
1980,48-49,94457,115837,2567937,2586077,17657,15.323,16442,14.269,388167,130632,257535,5.051,15.01,424453,113020,311433,4.37,16.413,-36286,-1.403,30.02,12626,12698,60354,
1980,51,42873,67615,2350431,2312181,8486,12.797,5878,8.864,488658,83391,405267,3.607,21.134,412629,65690,346939,2.841,17.846,76029,3.288,35.692,3824,3913,32124,
1980,52,154159,251235,4655956,4558014,23048,9.276,17512,7.048,630790,181806,448984,3.989,13.839,435210,123327,311883,2.706,9.548,195580,4.291,19.096,10397,10481,46300,
1980,53,179292,189599,1118468,1119616,28905,15.273,28222,14.912,267474,111134,156340,9.926,23.89,269112,114081,155031,10.189,24.036,-1638,-0.146,47.78,22380,22438,76982,
1980,54,264347,280957,2571224,2509277,44588,16.263,31012,11.311,496306,183715,312591,7.321,19.779,371598,135417,236181,5.397,14.809,124708,4.97,29.618,22929,23069,87600,
1980,55,20626,38984,2657290,2613436,3975,10.357,2769,7.215,418856,122162,296694,4.674,16.027,329186,93027,236159,3.56,12.596,89670,3.431,25.192,566,590,6192,
1980,56,126983,141959,2325510,2272535,27728,20.156,18944,13.771,560856,203304,357552,8.946,24.68,455451,128721,326730,5.664,20.042,105405,4.638,40.083,14493,14554,78934,
1980,61,30432,32439,1393757,1370248,3627,11.248,3242,10.054,155673,20696,134977,1.51,11.361,109413,21708,87705,1.584,7.985,46260,3.376,15.97,2521,2541,14871,
1980,62,344233,374825,6132182,6018590,39710,10.829,23437,6.392,774914,256889,518025,4.268,12.875,546618,177776,368842,2.954,9.082,228296,3.793,18.164,17053,17234,116874,
1980,71,47106,49539,729332,723090,7887,16.206,6142,12.621,145619,51014,94605,7.055,20.138,132871,41586,91285,5.751,18.375,12748,1.763,36.751,4581,4602,28245,
1980,72,292547,355240,5659201,5607343,55662,15.73,52909,14.952,1307778,696290,611488,12.417,23.323,1206774,478057,728717,8.526,21.521,101004,1.801,43.043,38596,39174,309700,
1980,81,448725,484578,3350794,3347080,55472,11.506,50570,10.489,584837,204424,380413,6.108,17.473,577717,175400,402317,5.24,17.26,7120,0.213,34.521,37786,38079,125044,
1981,11,19162,19746,180639,184687,2783,13.845,3492,17.373,40848,14352,26496,7.771,22.117,49000,19127,29873,10.356,26.531,-8152,-4.414,44.235,2486,2489,11484,
1981,21,23967,30116,957551,906529,6131,21.437,3100,10.839,234303,80507,153796,8.881,25.846,131574,48487,83087,5.349,14.514,102729,11.332,29.028,2074,2092,25061,
1981,22,5932,12275,721398,711252,615,5.04,469,3.844,43740,9643,34097,1.356,6.15,23642,6402,17240,0.9,3.324,20098,2.826,6.648,265,266,1383,
1981,23,420646,426212,4274103,4347181,62202,14.281,80873,18.568,1046046,310157,735889,7.135,24.063,1189197,340848,848349,7.841,27.356,-143151,-3.293,48.125,60926,60959,255589,
1981,31-33,271375,320073,18156066,18437245,35151,11.121,27147,8.589,1869363,622709,1246654,3.377,10.139,2431596,606110,1825486,3.287,13.189,-562233,-3.049,20.278,19708,19857,230966,
1981,42,269076,347920,4372219,4331711,39223,11.413,30739,8.944,724547,280130,444417,6.467,16.727,643516,212771,430745,4.912,14.856,81031,1.871,29.712,20821,21310,111670,
1981,44-45,734689,1017642,10107114,10136442,115569,11.385,110410,10.877,1592962,724533,868429,7.148,15.715,1649291,543136,1106155,5.358,16.271,-56329,-0.556,31.43,77386,80029,328360,
1981,48-49,93943,116174,2506908,2541011,16773,14.465,16330,14.083,348745,126996,221749,4.998,13.725,416665,113245,303420,4.457,16.398,-67920,-2.673,27.449,12404,12453,64765,
1981,51,45541,70536,2460317,2406155,9345,13.53,6409,9.279,503950,94511,409439,3.928,20.944,401783,67999,333784,2.826,16.698,102167,4.246,33.396,4114,4190,32937,
1981,52,155902,256302,4903836,4773028,24646,9.713,19527,7.696,754255,222990,531265,4.672,15.802,494729,179917,314812,3.769,10.365,259526,5.437,20.73,11246,11345,74196,
1981,53,176323,187254,1137755,1125317,26835,14.258,28758,15.279,265010,117459,147551,10.438,23.55,240541,103205,137336,9.171,21.375,24469,2.174,42.751,22680,22813,72734,
1981,54,276682,294454,2733067,2651434,47356,16.468,33566,11.673,548571,214590,333981,8.093,20.69,384764,138750,246014,5.233,14.512,163807,6.178,29.023,25232,25405,90413,
1981,55,21470,41405,2772589,2717928,4903,12.162,2719,6.745,455964,154354,301610,5.679,16.776,346447,68250,278197,2.511,12.747,109517,4.029,25.493,560,571,5679,
1981,56,134504,150705,2367489,2344088,29117,19.894,20429,13.958,555225,218078,337147,9.303,23.686,508384,150767,357617,6.432,21.688,46841,1.998,43.376,15662,15771,94017,
1981,61,30717,32796,1466962,1433023,3633,11.119,3387,10.366,168137,24998,143139,1.744,11.733,99557,21910,77647,1.529,6.947,68580,4.786,13.895,2641,2666,14370,
1981,62,360600,393445,6520556,6336005,43189,11.246,24384,6.349,910274,328153,582121,5.179,14.367,537429,179774,357655,2.837,8.482,372845,5.885,16.964,18070,18253,122381,
1981,71,48564,51106,754339,741965,7888,15.686,6250,12.429,152556,59438,93118,8.011,20.561,127436,36983,90453,4.984,17.175,25121,3.386,34.351,4617,4640,25018,
1981,72,292954,358518,5767379,5712169,55565,15.573,52132,14.611,1255383,692721,562662,12.127,21.977,1144755,463740,681015,8.118,20.041,110628,1.937,40.081,38519,39232,313450,
1981,81,449408,486322,3398990,3375092,54498,11.228,52588,10.835,611921,225469,386452,6.68,18.13,564514,187109,377405,5.544,16.726,47407,1.405,33.452,38590,39024,131800,
1982,11,17907,18559,171368,174154,2590,13.643,3441,18.125,42436,15755,26681,9.047,24.367,47837,16355,31482,9.391,27.468,-5401,-3.101,48.734,2397,2401,11429,
1982,21,26428,32887,1013013,985210,6750,21.398,4067,12.892,257269,89469,167800,9.081,26.113,202539,72006,130533,7.309,20.558,54730,5.555,41.116,2744,2765,32526,
1982,22,5848,12233,744604,733503,458,3.747,437,3.575,46449,7102,39347,0.968,6.332,24562,5198,19364,0.709,3.349,21887,2.984,6.697,282,282,1767,
1982,23,388964,395044,3894742,4060949,54052,13.199,83012,20.27,920439,261243,659196,6.433,22.666,1253505,365775,887730,9.007,30.867,-333066,-8.202,45.331,58023,58056,263074,
1982,31-33,272136,320722,17304437,17762236,30258,9.427,30756,9.582,1664773,442989,1221784,2.494,9.373,2580166,602088,1978078,3.39,14.526,-915393,-5.154,18.745,22296,22463,246366,
1982,42,273600,352955,4366869,4379846,38750,11.017,36283,10.316,748410,249260,499150,5.691,17.088,775225,259555,515670,5.926,17.7,-26815,-0.612,34.175,23430,23887,130019,
1982,44-45,717611,1012061,10009461,10057045,117663,11.597,122757,12.099,1676411,699275,977136,6.953,16.669,1770425,620623,1149802,6.171,17.604,-94014,-0.935,33.338,84533,87149,357105,
1982,48-49,92461,115514,2442160,2476821,16384,14.169,16616,14.37,345962,113434,232528,4.58,13.968,414819,110185,304634,4.449,16.748,-68857,-2.78,27.936,12455,12547,67735,
1982,51,46691,72250,2477015,2474444,9198,12.916,7126,10.006,322669,92917,229752,3.755,13.04,318677,64088,254589,2.59,12.879,3992,0.161,25.757,4933,5012,37703,
1982,52,155750,255779,4752326,4710443,21741,8.5,21727,8.495,608663,172792,435871,3.668,12.922,522233,158995,363238,3.375,11.087,86430,1.835,22.173,12680,12799,67407,
1982,53,169354,181050,1124161,1134092,24620,13.395,30132,16.393,248781,103124,145657,9.093,21.937,267784,111667,156117,9.846,23.612,-19003,-1.676,43.873,23661,23738,79991,
1982,54,278134,296835,2645334,2605073,48114,16.461,39012,13.347,575026,229055,345971,8.793,22.073,496999,189861,307138,7.288,19.078,78027,2.995,38.156,29433,29592,122295,
1982,55,22119,42816,2812646,2798687,4601,10.911,3303,7.833,521801,182081,339720,6.506,18.644,490669,113773,376896,4.065,17.532,31132,1.112,35.064,629,642,7636,
1982,56,146051,164386,2570793,2540337,30308,18.889,22441,13.986,602887,211624,391263,8.331,23.733,543171,164501,378670,6.476,21.382,59716,2.351,42.764,17017,17087,98225,
1982,61,30556,32983,1509517,1499655,3567,10.823,3515,10.665,154531,26594,127937,1.773,10.304,134602,23750,110852,1.584,8.976,19929,1.329,17.951,2698,2711,15890,
1982,62,374967,410843,6800765,6684840,44235,10.97,29010,7.194,906437,304561,601876,4.556,13.56,673922,207044,466878,3.097,10.081,232515,3.478,20.163,21903,22135,146704,
1982,71,49420,52438,756856,744265,8892,17.226,7253,14.051,161432,58244,103188,7.826,21.69,136070,42507,93563,5.711,18.282,25362,3.408,36.565,5514,5537,33030,
1982,72,289018,357715,5850292,5811127,54054,15.094,54861,15.319,1344295,675279,669016,11.62,23.133,1262795,514096,748699,8.847,21.731,81500,1.402,43.461,41396,42058,345296,
1982,81,451558,489510,3453966,3439924,55520,11.36,53959,11.041,644992,225205,419787,6.547,18.75,613960,188844,425116,5.49,17.848,31032,0.902,35.696,39382,39676,131756,
1983,11,18125,18749,169896,171337,2910,15.553,2833,15.141,42437,15344,27093,8.955,24.768,45352,16129,29223,9.414,26.47,-2915,-1.701,49.536,2023,2029,10368,
1983,21,25481,31722,788523,903017,4290,13.238,5657,17.457,120070,50844,69226,5.63,13.297,349915,87526,262389,9.693,38.75,-229845,-25.453,26.593,3923,3949,41826,
1983,22,5685,12105,749546,744900,605,5.029,455,3.782,51348,14750,36598,1.98,6.893,41873,6183,35690,0.83,5.621,9475,1.272,11.243,222,225,1009,
1983,23,391659,397642,3790556,3870483,63588,16.021,62113,15.649,957964,291898,666066,7.542,24.751,1118284,291857,826427,7.541,28.893,-160320,-4.142,49.501,43843,43891,206124,
1983,31-33,272441,320069,16156609,16753927,29833,9.31,30607,9.551,1562748,398517,1164231,2.379,9.328,2758184,610179,2148005,3.642,16.463,-1195436,-7.135,18.655,22039,22218,251533,
1983,42,276409,354946,4227519,4297590,39001,11.025,36617,10.351,651825,222137,429688,5.169,15.167,791112,252718,538394,5.88,18.408,-139287,-3.241,30.334,23961,24510,133952,
1983,44-45,722151,1017997,10006622,10016631,119187,11.737,114219,11.247,1663424,711370,952054,7.102,16.607,1686137,647843,1038294,6.468,16.833,-22713,-0.227,33.213,75132,77932,325946,
1983,48-49,93313,116269,2378650,2410946,17206,14.841,16537,14.264,367058,127024,240034,5.269,15.225,430554,129856,300698,5.386,17.858,-63496,-2.634,30.449,11526,11647,63338,
1983,51,48022,71848,2475678,2495999,9941,13.795,10374,14.395,712159,116599,(S),4.671,28.532,764832,311049,453783,12.462,30.642,-52673,-2.11,57.064,4871,4978,37970,
1983,52,164506,266747,4971148,4811258,33846,12.985,21657,8.309,905665,317199,588466,6.593,18.824,586232,204518,381714,4.251,12.185,319433,6.639,24.369,12218,12402,99393,
1983,53,170241,182336,1139281,1134208,26886,14.791,25770,14.177,260613,115085,145528,10.147,22.978,251317,106575,144742,9.396,22.158,9296,0.82,44.316,19477,19557,71424,
1983,54,313137,333866,2918252,2886181,57941,17.941,36119,11.184,570113,243428,326685,8.434,19.753,506677,168347,338330,5.833,17.555,63436,2.198,35.111,26103,26362,107354,
1983,55,22676,42568,2757148,2785990,4180,9.792,4418,10.35,447166,136589,310577,4.903,16.051,504436,121497,382939,4.361,18.106,-57270,-2.056,32.101,646,662,7502,
1983,56,141196,158399,2420523,2408627,30044,19.367,23507,15.153,578005,197226,380779,8.188,23.997,553251,181257,371994,7.525,22.97,24754,1.028,45.939,17693,17808,110596,
1983,61,30934,33144,1493010,1465722,4155,12.737,3110,9.534,156690,32206,124484,2.197,10.69,101967,19589,82378,1.336,6.957,54723,3.734,13.914,2349,2390,12997,
1983,62,391672,430386,7227402,7010488,46526,11.06,27110,6.444,1110358,540104,570254,7.704,15.839,674508,202083,472425,2.883,9.621,435850,6.217,19.243,19632,19973,129001,
1983,71,53373,56489,766036,762142,10454,19.04,7286,13.27,158575,66260,92315,8.694,20.806,150754,48520,102234,6.366,19.78,7821,1.026,39.561,5390,5428,33740,
1983,72,298547,369295,5990252,5920535,62044,17.067,50508,13.894,1363202,733016,630186,12.381,23.025,1221344,506561,714783,8.556,20.629,141858,2.396,41.258,36793,37479,319934,
1983,81,458450,497981,3452236,3424648,62129,12.626,50328,10.228,627168,234461,392707,6.846,18.313,573224,194319,378905,5.674,16.738,53944,1.575,33.476,36056,36542,132718,
1984,11,18914,19495,180089,175039,3231,16.888,2505,13.093,48114,16742,31372,9.565,27.488,38153,12244,25909,6.995,21.797,9961,5.691,43.594,1808,1813,9022,
1984,21,25425,31778,798648,790476,4502,14.172,4479,14.1,173602,43759,129843,5.536,21.962,158582,52823,105759,6.682,20.062,15020,1.9,40.123,3210,3241,27351,
1984,22,5743,12231,755794,751869,725,5.996,446,3.689,42297,11874,30423,1.579,5.626,34391,5149,29242,0.685,4.574,7906,1.052,9.148,241,241,1128,
1984,23,422310,428376,4285137,4042842,81332,19.652,52307,12.639,1354733,385755,968978,9.542,33.509,872647,249042,623605,6.16,21.585,482086,11.924,43.17,38665,38699,187084,
1984,31-33,278370,325737,17301118,16749778,33822,10.475,28086,8.699,2592232,522777,2069455,3.121,15.476,1490798,515855,974943,3.08,8.9,1101434,6.576,17.801,20847,21005,211061,
1984,42,282033,361271,4494029,4365034,40533,11.316,34349,9.59,830838,257130,573708,5.891,19.034,572270,214431,357839,4.912,13.11,258568,5.924,26.221,23623,24137,122557,
1984,44-45,733515,1034941,10639355,10328898,123008,11.98,106758,10.397,1937345,757933,1179412,7.338,18.757,1314752,520833,793919,5.042,12.729,622593,6.028,25.458,74250,76579,304287,
1984,48-49,96857,120241,2528271,2454208,19515,16.505,15501,13.11,476621,132815,343806,5.412,19.421,329466,116435,213031,4.744,13.425,147155,5.996,26.849,11131,11230,59721,
1984,51,50161,76752,2563992,2524274,13822,18.61,8863,11.933,623736,350017,273719,13.866,24.71,541782,188118,353664,7.452,21.463,81954,3.247,42.926,5070,5156,36977,
1984,52,168728,273221,4862032,4794800,31416,11.656,24039,8.919,809631,275332,534299,5.742,16.886,674153,264106,410047,5.508,14.06,135478,2.826,28.12,14950,15097,164724,
1984,53,177751,192100,1276123,1207181,33972,18.145,24225,12.939,361507,175470,186037,14.536,29.946,220175,101660,118515,8.421,18.239,141332,11.708,36.478,18764,18874,71554,
1984,54,333544,355019,3203255,3065135,59739,17.34,38749,11.247,712889,265308,447581,8.656,23.258,436262,170077,266185,5.549,14.233,276627,9.025,28.466,28536,28759,115133,
1984,55,23433,43641,2859644,2804562,4403,10.222,3265,7.58,473815,137708,336107,4.91,16.894,363702,84817,278885,3.024,12.968,110113,3.926,25.936,727,745,9442,
1984,56,151232,169124,2772533,2598688,32493,19.845,21714,13.262,766268,222090,544178,8.546,29.487,416216,150745,265471,5.801,16.016,350052,13.47,32.033,16585,16698,96421,
1984,61,32254,34589,1512810,1490141,4516,13.337,3060,9.037,160213,27148,133065,1.822,10.752,115226,21165,94061,1.42,7.733,44987,3.019,15.465,2346,2371,14532,
1984,62,405010,445656,7686081,7462078,43907,10.024,28658,6.542,1207412,637961,569451,8.549,16.181,760526,213373,547153,2.859,10.192,446886,5.989,20.384,21292,21629,144205,
1984,71,54775,57978,803505,784183,10151,17.767,8464,14.814,171648,63254,108394,8.066,21.889,133368,48013,85355,6.123,17.007,38280,4.882,34.015,6478,6533,34335,
1984,72,303235,376673,6397001,6196766,61303,16.431,54157,14.515,1478957,760373,718584,12.27,23.867,1079906,516323,563583,8.332,17.427,399051,6.44,34.854,40387,41079,331946,
1984,81,505391,545417,3758056,3610916,96397,18.469,49445,9.473,806188,330713,475475,9.159,22.326,511498,179340,332158,4.967,14.165,294690,8.161,28.331,36697,37217,126142,
1985,11,18905,19457,178340,178830,2961,15.226,2942,15.128,45094,15706,29388,8.783,25.216,46035,15420,30615,8.623,25.742,-941,-0.526,50.432,2102,2106,10409,
1985,21,25268,31537,761940,769276,4255,13.422,4586,14.466,139261,41971,97290,5.456,18.103,154336,56816,97520,7.386,20.063,-15075,-1.96,36.206,3288,3315,29961,
1985,22,5761,12188,764170,759696,621,5.101,592,4.863,44244,9060,35184,1.193,5.824,35309,8064,27245,1.061,4.648,8935,1.176,9.296,314,314,1894,
1985,23,443686,449827,4649243,4476872,84070,19.144,62689,14.276,1431391,439611,991780,9.82,31.973,1088150,356207,731943,7.957,24.306,343241,7.667,48.612,46356,46395,265398,
1985,31-33,282021,328577,17230397,17263442,34270,10.483,30932,9.462,2082581,540329,1542252,3.13,12.064,2143597,803417,1340180,4.654,12.417,-61016,-0.353,24.127,22808,23068,334185,
1985,42,284275,363535,4629152,4571798,41268,11.383,39297,10.839,819666,254050,565616,5.557,17.929,706053,306760,399293,6.71,15.444,113613,2.485,30.887,27394,28072,181551,
1985,44-45,727209,1028532,11069243,10851480,122142,11.838,128556,12.46,1973805,766222,1207583,7.061,18.189,1539306,714755,824551,6.587,14.185,434499,4.004,28.37,87492,91309,420463,
1985,48-49,99065,122764,2630149,2578799,20037,16.486,17592,14.474,477279,134570,342709,5.218,18.508,374584,146878,227706,5.696,14.526,102695,3.982,29.051,12887,12988,80266,
1985,51,50939,78909,2606219,2592855,11549,14.841,9370,12.041,484780,193849,290931,7.476,18.697,462109,150072,312037,5.788,17.822,22671,0.874,35.645,6081,6210,62417,
1985,52,168106,275223,5048932,4948029,31075,11.34,28688,10.469,858465,255100,603365,5.156,17.35,659483,254430,405053,5.142,13.328,198982,4.021,26.656,18049,18209,131648,
1985,53,183097,198608,1388763,1331569,36206,18.539,29593,15.152,381513,174758,206755,13.124,28.651,268125,128806,139319,9.673,20.136,113388,8.515,40.272,23032,23143,90870,
1985,54,349902,372237,3450123,3328615,63010,17.328,45813,12.599,774225,280847,493378,8.437,23.26,529461,223985,305476,6.729,15.906,244764,7.353,31.813,34696,34948,159668,
1985,55,23750,43760,3006883,2934277,4107,9.398,3985,9.119,543176,140253,402923,4.78,18.511,400625,124999,275626,4.26,13.653,142551,4.858,27.307,1000,1012,12718,
1985,56,159570,178482,3172130,2974911,35158,20.233,25721,14.802,923328,269375,653953,9.055,31.037,528470,194223,334247,6.529,17.764,394858,13.273,35.528,20026,20183,132834,
1985,61,32658,35110,1537925,1526288,4350,12.491,3779,10.852,182344,26926,155418,1.764,11.947,158775,48413,110362,3.172,10.403,23569,1.544,20.805,2916,2947,30467,
1985,62,413661,456081,8084355,7893378,45240,10.033,34900,7.74,1319081,582743,736338,7.383,16.711,936598,357819,578779,4.533,11.866,382483,4.846,23.731,26831,27250,241157,
1985,71,56661,59873,842773,823263,10669,18.106,8771,14.885,194903,68096,126807,8.271,23.674,155631,57312,98319,6.962,18.904,39272,4.77,37.808,6727,6784,42338,
1985,72,302065,377660,6686653,6546820,62000,16.433,61277,16.241,1597081,832355,764726,12.714,24.395,1312533,658012,654521,10.051,20.048,284548,4.346,40.097,45814,46861,413581,
1985,81,513947,554408,3926135,3843793,70382,12.798,61469,11.177,765103,261434,503669,6.801,19.905,601289,243255,358034,6.329,15.643,163814,4.262,31.286,44938,45527,174739,
1986,11,18515,19065,174740,176597,2831,14.713,3183,16.543,44148,15371,28777,8.704,24.999,47859,18188,29671,10.299,27.101,-3711,-2.101,49.999,2289,2290,11300,
1986,21,24240,30150,684584,723533,3446,11.167,4865,15.765,110435,37558,72877,5.191,15.263,188615,53854,134761,7.443,26.069,-78180,-10.805,30.527,3407,3440,26889,
1986,22,5921,12447,773874,770127,778,6.313,532,4.317,52173,16814,35359,2.183,6.775,43777,5913,37864,0.768,5.684,8396,1.09,11.369,265,265,1622,
1986,23,463060,468887,4820678,4719098,84067,18.306,64778,14.105,1366314,407214,959100,8.629,28.953,1161853,359040,802813,7.608,24.62,204461,4.333,49.24,47476,47529,258826,
1986,31-33,281159,327588,16769573,16895155,33143,10.123,32776,10.011,1925533,538865,1386668,3.189,11.397,2175362,680999,1494363,4.031,12.876,-249829,-1.479,22.794,24279,24466,298219,
1986,42,287271,368420,4700580,4671808,43418,11.856,39028,10.657,803019,265126,537893,5.675,17.189,744265,272776,471489,5.839,15.931,58754,1.258,31.862,26564,27141,150835,
1986,44-45,728034,1044093,11449596,11264869,132879,12.823,117230,11.313,2119927,907895,1212032,8.06,18.819,1753351,647461,1105890,5.748,15.565,366576,3.254,31.13,80289,83225,369551,
1986,48-49,100520,125170,2683215,2656596,20599,16.617,18180,14.666,483712,160372,323340,6.037,18.208,429776,143736,286040,5.411,16.178,53936,2.03,32.355,13221,13428,82394,
1986,51,51138,79524,2643264,2625838,10841,13.689,10182,12.857,435021,142403,292618,5.423,16.567,403902,123930,279972,4.72,15.382,31119,1.185,30.764,6265,6364,50596,
1986,52,170979,281766,5294263,5161249,31474,11.302,24926,8.95,916853,277937,638916,5.385,17.764,650902,218933,431969,4.242,12.611,265951,5.153,25.223,14960,15185,104887,
1986,53,189509,207182,1467620,1422039,37688,18.584,28926,14.263,387011,162656,224355,11.438,27.215,294076,130957,163119,9.209,20.68,92935,6.535,41.36,22116,22288,91700,
1986,54,366661,390597,3672836,3559645,64513,16.92,45883,12.034,801732,299071,502661,8.402,22.523,573907,216261,357646,6.075,16.123,227825,6.4,32.245,34255,34448,150191,
1986,55,24448,44734,3077117,3045080,5009,11.323,4018,9.083,542370,172998,369372,5.681,17.811,476767,114112,362655,3.747,15.657,65603,2.154,31.314,908,963,10344,
1986,56,169186,189610,3443457,3307391,37561,20.413,26357,14.324,898943,302201,596742,9.137,27.18,626765,201809,424956,6.102,18.95,272178,8.229,37.901,19965,20072,132011,
1986,61,33275,35985,1584388,1565712,4595,12.927,3718,10.46,178487,30585,147902,1.953,11.4,141668,27997,113671,1.788,9.048,36819,2.352,18.096,2842,2884,18820,
1986,62,423545,471093,8498076,8339180,48858,10.535,34219,7.378,1269208,531883,737325,6.378,15.22,944649,270198,674451,3.24,11.328,324559,3.892,22.656,25540,25882,196734,
1986,71,58382,62087,883708,863716,11050,18.115,8871,14.543,198121,75205,122916,8.707,22.938,158137,56077,102060,6.493,18.309,39984,4.629,36.618,6624,6664,39566,
1986,72,305056,386518,7072943,6885476,67251,17.599,58467,15.3,1747966,990778,757188,14.389,25.386,1372648,608968,763680,8.844,19.935,375318,5.451,39.871,42890,43816,403458,
1986,81,524933,567050,4065024,3995527,70294,12.536,57643,10.28,757475,284559,472916,7.122,18.958,618418,218440,399978,5.467,15.478,139057,3.48,30.956,41603,42209,155300,
1987,11,18429,18977,171488,170907,3115,16.552,2800,14.878,47393,17395,29998,10.178,27.73,45857,18712,27145,10.949,26.832,1536,0.899,53.663,2042,2043,11585,
1987,21,21628,27225,576321,629969,3278,11.45,6088,21.264,97684,41406,56278,6.573,15.506,204897,75279,129618,11.95,32.525,-107213,-17.019,31.012,4014,4048,31318,
1987,22,5846,12375,774392,772953,668,5.42,568,4.609,45715,13834,31881,1.79,5.914,43171,7739,35432,1.001,5.585,2544,0.329,11.17,311,313,1576,
1987,23,485890,492288,4966126,4878651,90614,18.86,66963,13.937,1407417,441867,965550,9.057,28.848,1233856,409228,824628,8.388,25.291,173561,3.558,50.582,49901,49942,283152,
1987,31-33,281833,327901,16478015,16614868,34579,10.558,33791,10.318,1889039,534079,1354960,3.214,11.37,2168271,758317,1409954,4.564,13.05,-279232,-1.681,22.739,24030,24264,299716,
1987,42,291106,373083,4838453,4802622,45023,12.085,43958,11.799,912544,319999,592545,6.663,19.001,839094,337669,501425,7.031,17.472,73450,1.529,34.943,27269,27962,164424,
1987,44-45,721826,1048507,11793895,11605905,134966,12.92,127172,12.174,2269371,977249,1292122,8.42,19.554,1892418,775429,1116989,6.681,16.306,376953,3.248,32.611,81958,85000,407753,
1987,48-49,103467,129036,2863963,2809361,22371,17.556,19148,15.027,582827,191506,391321,6.817,20.746,473102,204372,268730,7.275,16.84,109725,3.906,33.68,13169,13330,90875,
1987,51,46472,76499,2542701,2543975,12245,16.121,11162,14.695,512538,273778,238760,10.762,20.147,513525,162504,351021,6.388,20.186,-987,-0.039,40.294,6959,7139,68454,
1987,52,173381,288830,5501791,5373635,34006,11.944,25780,9.055,957552,321333,636219,5.98,17.819,698414,218523,479891,4.067,12.997,259138,4.822,25.994,15756,16112,100434,
1987,53,193517,213140,1493324,1474899,38490,18.308,32679,15.544,393898,181223,212675,12.287,26.707,359190,171532,187658,11.63,24.354,34708,2.353,48.707,24828,25036,108495,
1987,54,384183,411062,3982514,3886044,65997,16.364,50507,12.523,881418,318204,563214,8.188,22.682,686824,275957,410867,7.101,17.674,194594,5.008,35.348,37231,37447,170532,
1987,55,24506,44533,3035616,3059328,5360,12.048,5275,11.856,561966,173379,388587,5.667,18.369,611538,179801,431737,5.877,19.989,-49572,-1.62,36.738,983,1018,15236,
1987,56,178676,200573,3556968,3469479,40615,20.826,29504,15.129,988461,385043,603418,11.098,28.49,812835,289919,522916,8.356,23.428,175626,5.062,46.856,22065,22349,165010,
1987,61,33945,37551,1629363,1601800,4513,12.133,3801,10.219,183878,34560,149318,2.158,11.479,127820,29824,97996,1.862,7.98,56058,3.5,15.96,2867,2896,19339,
1987,62,430622,483153,9225812,9310839,49243,10.309,38308,8.02,1768841,908916,859925,9.762,18.998,(S),350005,(S),3.759,(S),(S),(S),(S),28124,28457,222957,
1987,71,59493,64152,946897,925471,11474,18.17,9464,14.987,221526,85424,136102,9.23,23.937,178781,63185,115596,6.827,19.318,42745,4.619,38.636,7204,7234,44863,
1987,72,309589,400064,7411478,7258218,72476,18.413,59579,15.136,1820049,999176,820873,13.766,25.076,1516000,686155,829845,9.453,20.887,304049,4.189,41.773,43961,44864,443346,
1987,81,530515,575203,4083956,4037018,70965,12.444,61098,10.714,772041,288024,484017,7.135,19.124,677541,253394,424147,6.277,16.783,94500,2.341,33.566,44238,44710,170214,
1988,11,18749,19211,179882,175595,3134,16.408,2914,15.256,51212,20212,31000,11.511,29.165,42566,18884,23682,10.754,24.241,8646,4.924,48.482,2060,2063,11303,
1988,21,21255,26490,574281,577506,3412,12.704,4146,15.437,118915,33551,85364,5.81,20.591,125709,51102,74607,8.849,21.768,-6794,-1.176,41.182,2634,2663,18796,
1988,22,6059,12617,776293,774968,953,7.627,708,5.666,53738,18510,35228,2.388,6.934,51634,17560,34074,2.266,6.663,2104,0.271,13.325,245,327,6391,
1988,23,496083,502562,5082274,5034924,83910,16.864,73952,14.862,1338799,394076,944723,7.827,26.59,1243970,392440,851530,7.794,24.707,94829,1.883,49.414,56019,56097,293837,
1988,31-33,287678,334721,17054937,16851141,35762,10.762,30938,9.31,2314247,713937,1600310,4.237,13.733,1910734,677584,1233150,4.021,11.339,403513,2.395,22.678,22991,23182,291611,
1988,42,295092,379045,4969853,4918538,44612,11.847,39682,10.537,913886,300665,613221,6.113,18.58,813221,323307,489914,6.573,16.534,100665,2.047,33.068,26549,27369,172102,
1988,44-45,728250,1068054,12237465,12043921,134389,12.68,118027,11.136,2329081,1011542,1317539,8.399,19.338,1942524,734152,1208372,6.096,16.129,386557,3.21,32.257,77020,80654,387970,
1988,48-49,105228,132455,3030699,2953010,22707,17.36,19399,14.831,647823,218266,429557,7.391,21.938,487163,183949,303214,6.229,16.497,160660,5.441,32.994,13703,13899,97002,
1988,51,47966,77770,2599153,2580424,10866,14.004,10507,13.542,391075,156183,234892,6.053,15.155,355177,132772,222405,5.145,13.764,35898,1.391,27.529,5616,5785,53010,
1988,52,172834,294519,5284102,5295480,36812,12.672,28782,9.908,887429,316497,570932,5.977,16.758,904607,289323,615284,5.464,17.083,-17178,-0.324,33.516,16059,16302,116158,
1988,53,198086,220955,1561379,1530053,36637,16.872,29018,13.363,402785,187484,215301,12.253,26.325,338556,146014,192542,9.543,22.127,64229,4.198,44.254,21886,22192,98854,
1988,54,399070,428421,4276795,4144483,69469,16.532,53038,12.622,960121,352231,607890,8.499,23.166,694386,279241,415145,6.738,16.754,265735,6.412,33.509,39341,39723,170846,
1988,55,25499,47370,3131313,3089866,8124,17.681,5279,11.489,704918,215770,489148,6.983,22.814,620331,188462,431869,6.099,20.076,84587,2.738,40.153,868,919,14203,
1988,56,187992,212170,3998172,3784581,41799,20.242,30446,14.744,1254491,435821,818670,11.516,33.147,821802,306204,515598,8.091,21.714,432689,11.433,43.429,22912,23181,179996,
1988,61,35158,39098,1691303,1672072,5002,13.037,3544,9.237,182192,33807,148385,2.022,10.896,143425,26574,116851,1.589,8.578,38767,2.319,17.155,2616,2662,18802,
1988,62,438443,496890,9452854,9304289,49999,10.202,36414,7.43,1351278,481725,869553,5.177,14.523,1055286,393813,661473,4.233,11.342,295992,3.181,22.684,26387,26894,242977,
1988,71,63448,68174,1006781,978669,13272,20.027,9468,14.287,245903,96888,149015,9.9,25.126,188865,69268,119597,7.078,19.298,57038,5.828,38.596,7048,7150,48417,
1988,72,315522,411540,7683192,7558264,69112,17.017,58288,14.352,1810524,937134,873390,12.399,23.954,1569647,645340,924307,8.538,20.767,240877,3.187,41.535,40919,41944,408552,
1988,81,540033,587149,4218357,4147362,70112,12.066,57945,9.972,799005,293461,505544,7.076,19.265,656849,227559,429290,5.487,15.838,142156,3.428,31.676,41752,42324,154648,
1989,11,19108,19613,180808,181056,3075,15.833,2691,13.856,45607,18052,27555,9.97,25.19,46132,14645,31487,8.089,25.479,-525,-0.29,50.379,1999,1999,11037,
1989,21,20592,25750,561230,569059,2961,11.326,3746,14.329,105175,38146,67029,6.703,18.482,121108,49288,71820,8.661,21.282,-15933,-2.8,36.965,2549,2585,22133,
1989,22,6305,12839,767526,772367,803,6.294,641,5.024,40836,12998,27838,1.683,5.287,50404,11299,39105,1.463,6.526,-9568,-1.239,10.574,303,303,1956,
1989,23,504486,510721,5211488,5145395,80347,15.858,72243,14.258,1363601,387628,975973,7.533,26.501,1231655,393053,838602,7.639,23.937,131946,2.564,47.874,54913,54996,287291,
1989,31-33,291039,338124,17301073,17164900,34590,10.278,31400,9.331,2154639,585486,1569153,3.411,12.553,1882942,645292,1237650,3.759,10.97,271697,1.583,21.939,23152,23404,277071,
1989,42,297022,382290,5114971,5044208,42400,11.139,39126,10.279,905539,288212,617327,5.714,17.952,764419,318620,445799,6.317,15.154,141120,2.798,30.309,26517,27386,160393,
1989,44-45,730443,1079784,12628276,12438861,125640,11.696,114518,10.661,2249130,946133,1302997,7.606,18.081,1877825,693796,1184029,5.578,15.096,371305,2.985,30.193,77533,82111,399367,
1989,48-49,107483,135345,3105322,3068076,21385,15.975,18429,13.767,583766,195344,388422,6.367,19.027,514003,186515,327488,6.079,16.753,69763,2.274,33.507,13244,13478,91211,
1989,51,49672,81907,2653885,2632166,13440,16.802,9607,12.01,454059,162099,291960,6.158,17.25,409853,150182,259671,5.706,15.571,44206,1.679,31.142,5641,5800,52591,
1989,52,174655,301500,5387760,5342170,43554,14.619,36405,12.219,956796,398472,558324,7.459,17.91,878386,339493,538893,6.355,16.442,78410,1.468,32.885,15485,15715,130027,
1989,53,201043,225455,1613474,1586525,35069,15.715,30475,13.656,389667,163679,225988,10.317,24.561,334816,142447,192369,8.979,21.104,54851,3.457,42.207,23220,23665,102562,
1989,54,410163,440924,4556121,4417433,65694,15.128,52351,12.055,995425,350959,644466,7.945,22.534,720070,295050,425020,6.679,16.301,275355,6.233,32.601,39261,39662,175036,
1989,55,26539,49774,3225916,3182298,6748,13.892,4349,8.953,632623,235011,397612,7.385,19.879,549450,127764,421686,4.015,17.266,83173,2.614,34.532,937,970,14821,
1989,56,197593,224645,4333019,4167891,42897,19.618,30935,14.147,1233306,432287,801019,10.372,29.591,910820,300429,610391,7.208,21.853,322486,7.737,43.707,23753,24007,185428,
1989,61,36605,40788,1730029,1700095,5137,12.835,3609,9.017,207391,42731,164660,2.513,12.199,147908,33802,114106,1.988,8.7,59483,3.499,17.4,2650,2714,23525,
1989,62,446483,509133,9886250,9658703,48704,9.681,36593,7.274,1346965,457405,889560,4.736,13.946,889007,335843,553164,3.477,9.204,457958,4.741,18.408,27490,28146,213988,
1989,71,65844,70774,1063148,1037242,12334,17.724,9961,14.314,236463,80940,155523,7.803,22.797,183902,64709,119193,6.239,17.73,52561,5.067,35.46,7613,7722,47918,
1989,72,321259,421210,7957397,7823209,66944,16.074,57468,13.799,1749956,886575,863381,11.333,22.369,1480856,655522,825334,8.379,18.929,269100,3.44,37.858,42027,43390,430172,
1989,81,550318,600078,4404195,4316525,69256,11.659,57118,9.616,818035,294093,523942,6.813,18.951,643050,231035,412015,5.352,14.897,174985,4.054,29.795,42591,43628,168499,
1990,11,19737,20283,187152,184226,3363,16.854,2704,13.552,49457,19912,29545,10.808,26.846,43872,15319,28553,8.315,23.814,5585,3.032,47.628,1988,2000,10442,
1990,21,20393,25460,568997,564507,2998,11.699,3331,12.998,103977,31390,72587,5.561,18.419,94758,36544,58214,6.474,16.786,9219,1.633,33.572,2242,2275,16687,
1990,22,6432,13198,776685,772181,991,7.616,620,4.765,50032,18430,31602,2.387,6.479,41470,6980,34490,0.904,5.371,8562,1.109,10.741,340,340,2066,
1990,23,513957,520159,5324415,5267957,81666,15.843,72320,14.029,1373441,383702,989739,7.284,26.072,1260380,386511,873869,7.337,23.925,113061,2.146,47.851,55053,55123,301090,
1990,31-33,293353,340883,17047989,17181603,33382,9.834,30548,8.999,1756267,516434,1239833,3.006,10.222,2022805,558654,1464151,3.251,11.773,-266538,-1.551,20.444,23274,23452,258646,
1990,42,298908,386171,5237665,5179472,41559,10.817,37624,9.793,860343,282852,577491,5.461,16.611,744324,274485,469839,5.299,14.371,116019,2.24,28.741,26428,27324,165201,
1990,44-45,726848,1083736,12841049,12740282,119149,11.012,115607,10.685,2087429,858256,1229173,6.737,16.384,1886811,682702,1204109,5.359,14.81,200618,1.575,29.62,79402,83671,413776,
1990,48-49,109183,137570,3218055,3161011,20772,15.222,18544,13.59,588821,185688,403133,5.874,18.628,473614,173220,300394,5.48,14.983,115207,3.645,29.966,13649,13838,90483,
1990,51,50855,83324,2739172,2698967,11415,13.818,9990,12.093,428168,147726,280442,5.473,15.864,348311,130629,217682,4.84,12.905,79857,2.959,25.811,5692,5793,49415,
1990,52,177308,310328,5498952,5463249,37193,12.157,28402,9.284,897382,332569,564813,6.087,16.426,825924,255401,570523,4.675,15.118,71458,1.308,30.236,15387,15510,98300,
1990,53,202800,228774,1680530,1647017,33793,14.882,30392,13.384,392535,170365,222170,10.344,23.833,325871,136399,189472,8.282,19.786,66664,4.048,39.571,23102,23508,97586,
1990,54,421809,454105,4773008,4664316,65246,14.584,51780,11.574,946962,331865,615097,7.115,20.302,731900,254914,476986,5.465,15.691,215062,4.611,31.383,39482,39798,177110,
1990,55,27609,52010,3283293,3248285,6817,13.398,4555,8.953,567889,187631,380258,5.776,17.483,496360,122519,373841,3.772,15.281,71529,2.202,30.561,1046,1075,12888,
1990,56,206404,235151,4629830,4495663,42621,18.534,32237,14.019,1228252,425313,802939,9.461,27.321,957890,320304,637586,7.125,21.307,270362,6.014,42.614,24770,25066,195726,
1990,61,38195,42535,1819839,1782912,5395,12.93,3777,9.052,223072,53786,169286,3.017,12.512,149981,39844,110137,2.235,8.412,73091,4.1,16.824,2789,2836,20935,
1990,62,455634,522929,10430524,10187435,48454,9.385,35127,6.804,1326545,418832,907713,4.111,13.021,842287,282439,559848,2.772,8.268,484258,4.753,16.536,26924,27485,182563,
1990,71,66303,71230,1133628,1097401,10848,15.294,10251,14.452,247495,81649,165846,7.44,22.553,174720,65760,108960,5.992,15.921,72775,6.632,31.843,7869,7957,48955,
1990,72,325210,428580,8156272,8057875,65639,15.447,58361,13.734,1697826,861797,836029,10.695,21.07,1500942,634103,866839,7.869,18.627,196884,2.443,37.254,42971,44156,425369,
1990,81,559269,610944,4551999,4482149,67320,11.115,56725,9.366,800973,275164,525809,6.139,17.87,660612,223298,437314,4.982,14.739,140361,3.132,29.477,42956,43667,164517,
1991,11,20195,20712,186843,189266,2931,14.142,2958,14.272,46058,15790,30268,8.343,24.335,51131,16851,34280,8.903,27.015,-5073,-2.68,48.67,2098,2103,12175,
1991,21,21049,26060,571131,572442,3038,11.612,3241,12.388,101550,39171,62379,6.843,17.74,104209,37165,67044,6.492,18.204,-2659,-0.465,35.48,2171,2202,18916,
1991,22,6496,13866,777695,778298,1238,9.094,732,5.377,57104,23919,33185,3.073,7.337,58319,10861,47458,1.395,7.493,-1215,-0.156,14.674,406,408,3062,
1991,23,510480,516729,4750950,5055828,71431,13.689,81606,15.639,999722,303122,696600,5.995,19.774,1611042,452758,1158284,8.955,31.865,-611320,-12.091,39.547,58972,59069,335366,
1991,31-33,293888,341084,16070869,16563568,29545,8.61,33703,9.821,1444053,405191,1038862,2.446,8.718,2430543,741885,1688658,4.479,14.674,-986490,-5.956,17.436,25332,25643,428126,
1991,42,286919,375252,4938594,5025295,41210,10.981,41257,10.994,727350,260971,466379,5.193,14.474,902172,357177,544995,7.108,17.953,-174822,-3.479,28.948,27921,28789,218717,
1991,44-45,708380,1067207,12558543,12699097,109511,10.186,125319,11.656,1904464,798343,1106121,6.287,14.997,2183352,799441,1383911,6.295,17.193,-278888,-2.196,29.994,82451,87379,473422,
1991,48-49,109191,138688,3204874,3210383,20851,15.083,19961,14.439,548423,190507,357916,5.934,17.083,559130,206522,352608,6.433,17.416,-10707,-0.334,34.166,14016,14243,107259,
1991,51,50401,87287,2718100,2737698,14794,17.329,10964,12.843,445577,219164,226413,8.005,16.276,486734,148565,338169,5.427,17.779,-41157,-1.503,32.551,5950,6079,56982,
1991,52,174901,333699,5570165,5617056,55284,17.164,32059,9.954,1103550,614645,488905,10.942,19.646,1205067,332734,872333,5.924,21.454,-101517,-1.807,39.293,16229,16811,146519,
1991,53,192989,226740,1584083,1609475,36394,16.198,32272,14.364,381961,203951,178010,12.672,23.732,432258,183902,248356,11.426,26.857,-50297,-3.125,47.464,24271,24685,118562,
1991,54,420565,456794,4709337,4719471,64386,14.229,55812,12.334,841880,308104,533776,6.528,17.838,863478,335657,527821,7.112,18.296,-21598,-0.458,35.677,42198,42597,223935,
1991,55,28492,54545,3293821,3286131,6871,12.862,4621,8.65,545917,184809,361108,5.624,16.613,529136,109767,419369,3.34,16.102,16781,0.511,32.204,1168,1201,14009,
1991,56,212085,243139,4554891,4588074,41684,17.383,34997,14.595,1112489,434725,677764,9.475,24.247,1179071,409184,769887,8.918,25.699,-66582,-1.451,48.495,26416,26747,273832,
1991,61,40802,45360,1913012,1889647,5518,12.347,4181,9.355,206052,45368,160684,2.401,10.904,161735,35655,126080,1.887,8.559,44317,2.345,17.118,3027,3108,25500,
1991,62,459485,533236,10728651,10576268,48409,9.168,37986,7.194,1313097,430490,882607,4.07,12.416,1007558,377793,629765,3.572,9.527,305539,2.889,19.053,28773,29330,261440,
1991,71,63501,68560,1111103,1113390,9523,13.848,9943,14.458,208594,74400,134194,6.682,18.735,213210,75645,137565,6.794,19.15,-4616,-0.415,37.47,7717,7859,55403,
1991,72,324563,430526,7962978,8054619,62179,14.502,58669,13.683,1493239,803519,689720,9.976,18.539,1674034,665967,1008067,8.268,20.784,-180795,-2.245,37.078,42800,44252,452697,
1991,81,566404,621412,4548137,4559132,64021,10.347,58733,9.492,742714,264492,478222,5.801,16.291,763700,250448,513252,5.493,16.751,-20986,-0.46,32.581,43407,44132,184267,
1992,11,20311,20813,192519,188407,3032,14.636,2838,13.7,50515,15425,35090,8.187,26.812,42439,13915,28524,7.386,22.525,8076,4.286,45.05,2101,2108,10552,
1992,21,19872,24684,522126,543732,2629,10.429,3679,14.594,89708,32589,57119,5.994,16.499,132458,45052,87406,8.286,24.361,-42750,-7.862,32.997,2316,2342,18213,
1992,22,5718,13630,772553,774301,1127,8.421,634,4.737,82547,41123,41424,5.311,10.661,85881,26439,59442,3.415,11.091,-3334,-0.431,21.322,298,299,1392,
1992,23,498444,504606,4510754,4598548,72876,14.347,79538,15.659,1067274,298165,769109,6.484,23.209,1242412,366340,876072,7.966,27.017,-175138,-3.809,46.418,57615,57675,269777,
1992,31-33,286280,332358,15838031,15952892,27412,8.183,32670,9.753,1647702,404092,1243610,2.533,10.329,1875166,598459,1276707,3.751,11.754,-227464,-1.426,20.657,24053,24223,249009,
1992,42,300180,386029,4986984,5014048,40551,10.488,41807,10.812,824938,261090,563848,5.207,16.453,879201,330426,548775,6.59,17.535,-54263,-1.082,32.905,25176,26242,142783,
1992,44-45,685998,1040119,12224743,12333328,108415,10.347,123764,11.812,1843808,775738,1068070,6.29,14.95,2067366,737539,1329827,5.98,16.762,-223558,-1.813,29.9,73823,78275,370389,
1992,48-49,111803,142589,3176954,3188158,21047,14.881,18744,13.252,519066,177755,341311,5.575,16.281,545902,165724,380178,5.198,17.123,-26836,-0.842,32.562,13066,13235,84548,
1992,51,50515,87900,2656213,2749081,11314,12.933,10483,11.983,400488,148366,252122,5.397,14.568,586735,205079,381656,7.46,21.343,-186247,-6.775,29.136,5211,5371,63489,
1992,52,173865,336530,5373517,5410189,35045,10.49,30146,9.024,885640,294162,591478,5.437,16.37,959293,307067,652226,5.676,17.731,-73653,-1.361,32.74,13916,14311,105812,
1992,53,193816,230218,1576014,1585300,31402,13.701,29342,12.803,349984,148648,201336,9.377,22.077,366467,141835,224632,8.947,23.117,-16483,-1.04,44.154,20604,21254,86668,
1992,54,429411,467026,4660703,4656962,62542,13.536,52581,11.38,871138,302776,568362,6.502,18.706,858231,351305,506926,7.544,18.429,12907,0.277,36.858,37002,37342,238388,
1992,55,28396,53475,3236929,3266986,4907,9.077,6072,11.232,583836,157267,426569,4.814,17.871,644366,179116,465250,5.483,19.724,-60530,-1.853,35.742,906,941,14708,
1992,56,211976,244524,4759216,4665772,40330,16.625,36446,15.024,1225837,439423,786414,9.418,26.273,1036741,372826,663915,7.991,22.22,189096,4.053,44.44,26705,26949,227669,
1992,61,41202,46488,1974867,1943081,5494,11.989,4169,9.098,208762,35321,173441,1.818,10.744,143326,32453,110873,1.67,7.376,65436,3.368,14.752,3023,3081,23645,
1992,62,467009,546680,11319665,11047840,49202,9.11,36049,6.674,1607031,501756,1105275,4.542,14.546,1065286,321243,744043,2.908,9.642,541745,4.904,19.285,25341,25853,201835,
1992,71,64086,69217,1158434,1130547,9753,14.204,8642,12.586,252358,81641,170717,7.221,22.322,196048,75118,120930,6.644,17.341,56310,4.981,34.682,6274,6330,53943,
1992,72,329669,437768,8156399,8082562,63153,14.515,57788,13.282,1627252,802627,824625,9.93,20.133,1483793,646514,837279,7.999,18.358,143459,1.775,36.716,39115,40164,387015,
1992,81,573552,630540,4581113,4569280,62831,10.005,57712,9.19,759410,244958,514452,5.361,16.62,735032,239060,495972,5.232,16.086,24378,0.534,32.173,40030,40575,163188,
1993,11,20742,21239,187574,189707,3034,14.36,2811,13.305,45661,15020,30641,7.917,24.069,49799,15642,34157,8.245,26.25,-4138,-2.181,48.138,2004,2006,10592,
1993,21,19250,23920,478902,498669,2568,10.591,3224,13.296,80274,27660,52614,5.547,16.098,119937,38065,81872,7.633,24.051,-39663,-7.954,32.195,2082,2102,15403,
1993,22,6023,14051,760629,766536,881,6.336,589,4.236,60456,17931,42525,2.339,7.887,72369,10417,61952,1.359,9.441,-11913,-1.554,15.774,221,225,1345,
1993,23,502783,508864,4555665,4525741,78900,15.633,70574,13.983,1143532,316487,827045,6.993,25.267,1084593,321437,763156,7.102,23.965,58939,1.302,47.93,51858,51901,241725,
1993,31-33,288722,334441,15848599,15857932,29543,8.85,28303,8.478,1668586,387225,1281361,2.442,10.522,1685963,461480,1224483,2.91,10.632,-17377,-0.11,21.044,21312,21515,212843,
1993,42,303614,388215,5048343,5012823,39630,10.233,37784,9.756,795692,229985,565707,4.588,15.873,724634,247369,477265,4.935,14.456,71058,1.418,28.911,25341,26060,138191,
1993,44-45,686948,1036007,12583636,12405455,102178,9.842,106483,10.257,2048548,785005,1263543,6.328,16.513,1696810,616224,1080586,4.967,13.678,351738,2.835,27.356,65675,69108,316562,
1993,48-49,115689,146225,3223240,3202999,21114,14.602,17859,12.351,508073,139949,368124,4.369,15.862,466198,155144,311054,4.844,14.555,41875,1.307,29.11,12550,12752,83067,
1993,51,52232,89029,2675330,2666580,11149,12.599,10077,11.387,415569,136809,278760,5.131,15.584,398555,139505,259050,5.232,14.946,17014,0.638,29.893,4868,5036,49584,
1993,52,179467,336454,5255110,5301919,34428,10.217,35465,10.525,886002,279616,606386,5.274,16.711,985043,408545,576498,7.706,18.579,-99041,-1.868,33.422,12972,13801,74517,
1993,53,198469,234795,1617038,1597726,30746,13.208,26716,11.477,357199,134984,222215,8.449,22.357,318712,124703,194009,7.805,19.948,38487,2.409,39.896,18909,19338,77165,
1993,54,445270,482118,4851319,4783696,64924,13.679,49962,10.526,902985,307443,595542,6.427,18.876,770302,235063,535239,4.914,16.103,132683,2.774,32.205,34895,36695,141638,
1993,55,28222,51384,3179832,3213262,4463,8.517,6497,12.399,533056,132087,400969,4.111,16.589,600677,158793,441884,4.942,18.694,-67621,-2.104,33.179,854,895,12059,
1993,56,220474,252856,5184695,4973690,41705,16.771,33330,13.403,1420741,439970,980771,8.846,28.565,997856,346884,650972,6.974,20.063,422885,8.502,40.125,24225,24690,223882,
1993,61,42874,48134,2020119,1980781,5726,12.106,4056,8.575,225078,46776,178302,2.361,11.363,146368,30820,115548,1.556,7.389,78710,3.974,14.779,2833,2965,21864,
1993,62,474406,557080,11720357,11524286,47739,8.651,37256,6.751,1500744,422639,1078105,3.667,13.022,1113487,358171,755316,3.108,9.662,387257,3.36,19.324,26560,27180,184895,
1993,71,66166,71344,1232371,1204413,9900,14.076,7874,11.196,252811,85462,167349,7.096,20.99,195424,57332,138092,4.76,16.226,57387,4.765,32.451,5772,5843,40635,
1993,72,338195,443672,8254826,8201346,59331,13.462,53417,12.121,1559277,739749,819528,9.02,19.012,1451430,580663,870767,7.08,17.697,107847,1.315,35.395,36501,37720,348258,
1993,81,580628,636283,4661328,4613139,59675,9.422,53812,8.496,762497,217452,545045,4.714,16.529,666798,202373,464425,4.387,14.454,95699,2.074,28.909,38373,39102,139294,
1994,11,21423,21942,188808,188267,3409,15.805,2664,12.351,44437,15258,29179,8.104,23.603,42898,13760,29138,7.309,22.786,1539,0.817,45.571,1982,1982,9774,
1994,21,18990,23829,487728,486046,2547,10.632,2801,11.692,87569,30251,57318,6.224,18.017,84442,29707,54735,6.112,17.373,3127,0.643,34.747,1869,1886,13315,
1994,22,6005,14136,740942,751139,815,5.808,609,4.34,41376,14984,26392,1.995,5.508,61756,8272,53484,1.101,8.222,-20380,-2.713,11.017,258,272,1443,
1994,23,519840,525974,4750037,4656728,83858,16.208,66707,12.893,1212081,336918,875163,7.235,26.029,1026237,308395,717842,6.623,22.038,185844,3.991,44.075,49325,49367,234611,
1994,31-33,290940,336960,16012265,15982066,29980,8.917,28454,8.463,1738357,433941,1304416,2.715,10.877,1680126,510066,1170060,3.191,10.513,58231,0.364,21.025,21522,21710,238832,
1994,42,307546,393152,5166539,5129991,40684,10.391,37428,9.56,789248,233121,556127,4.544,15.385,715067,252246,462821,4.917,13.939,74181,1.446,27.878,25733,26580,142143,
1994,44-45,687591,1042556,12947561,12794315,106178,10.201,102729,9.87,2019605,842438,1177167,6.584,15.785,1719638,603424,1116214,4.716,13.441,299967,2.345,26.881,67072,70410,311278,
1994,48-49,119444,151105,3321156,3276479,23040,15.48,18505,12.433,521482,168559,352923,5.145,15.916,433751,151560,282191,4.626,13.238,87731,2.678,26.477,13299,13581,77136,
1994,51,54414,91736,2704933,2699218,12351,13.651,9836,10.871,411732,144567,267165,5.356,15.254,400867,145573,255294,5.393,14.851,10865,0.403,29.702,5166,5351,41716,
1994,52,178948,343672,5360903,5295720,43787,12.935,33477,9.889,994583,433141,561442,8.179,18.781,857658,347869,509789,6.569,16.195,136925,2.586,32.391,14807,15461,95071,
1994,53,202190,240493,1649532,1633909,32219,13.546,26942,11.327,346047,148444,197603,9.085,21.179,317232,125642,191590,7.69,19.416,28815,1.764,38.831,19472,20136,81844,
1994,54,461871,500415,4948557,4895184,67733,13.778,50073,10.186,881715,306869,574846,6.269,18.012,774347,260551,513796,5.323,15.819,107368,2.193,31.637,36218,36603,155496,
1994,55,28463,51469,3153872,3177155,4847,9.417,4854,9.43,463385,143162,320223,4.506,14.585,511581,147605,363976,4.646,16.102,-48196,-1.517,29.17,936,989,12793,
1994,56,229892,263738,5589613,5400247,43960,17.019,33070,12.803,1471191,463686,1007505,8.586,27.243,1090858,389964,700894,7.221,20.2,380333,7.043,40.4,24990,25354,248210,
1994,61,45006,50418,2079574,2055271,6373,12.927,4140,8.397,202098,39912,162186,1.942,9.833,153631,31681,121950,1.541,7.475,48467,2.358,14.95,2994,3145,23935,
1994,62,478435,568484,12001359,11869877,49267,8.745,39077,6.936,1350970,431511,919459,3.635,11.381,1087486,340397,747089,2.868,9.162,263484,2.22,18.323,29235,30122,215883,
1994,71,68389,73867,1271462,1246799,10498,14.448,8089,11.132,255243,95283,159960,7.642,20.472,205510,69052,136458,5.538,16.483,49733,3.989,32.966,6036,6152,51587,
1994,72,343886,452572,8542975,8419314,61720,13.757,53875,12.008,1658296,871883,786413,10.356,19.696,1409764,577191,832573,6.856,16.744,248532,2.952,33.489,39699,41017,384298,
1994,81,588575,644433,4722150,4698605,61377,9.578,54168,8.453,746606,238156,508450,5.069,15.89,698117,212761,485356,4.528,14.858,48489,1.032,29.716,38846,39634,144042,
1995,11,21917,22463,188517,188269,3361,15.138,2841,12.796,41049,14777,26272,7.849,21.803,40599,14612,25987,7.761,21.564,450,0.239,43.129,2120,2123,10878,
1995,21,18620,23332,486047,485970,2278,9.662,2770,11.748,83659,24605,59054,5.063,17.215,83470,29652,53818,6.102,17.176,189,0.039,34.352,1824,1842,13090,
1995,22,6140,14497,718851,730577,969,6.769,606,4.233,40713,13262,27451,1.815,5.573,64545,6300,58245,0.862,8.835,-23832,-3.262,11.145,235,237,1266,
1995,23,541401,547634,5072439,4909594,88362,16.462,66595,12.407,1265358,358219,907139,7.296,25.773,939545,302249,637296,6.156,19.137,325813,6.636,38.274,50006,50082,232964,
1995,31-33,292684,338789,16405659,16187400,30087,8.917,27307,8.093,1864445,402789,1461656,2.488,11.518,1424637,432482,992155,2.672,8.801,439808,2.717,17.602,21007,21129,212714,
1995,42,312853,399703,5383807,5274866,42052,10.606,35629,8.986,869391,260132,609259,4.932,16.482,652484,236843,415641,4.49,12.37,216907,4.112,24.739,24839,25702,142506,
1995,44-45,689935,1047267,13434592,13191500,108252,10.361,103322,9.889,2132904,900634,1232270,6.827,16.169,1644072,657267,986805,4.983,12.463,488832,3.706,24.926,64425,68221,299307,
1995,48-49,124559,157437,3506134,3412133,24593,15.934,18396,11.919,595719,182550,413169,5.35,17.459,409949,142202,267747,4.168,12.014,185770,5.444,24.029,13490,13722,79639,
1995,51,57097,95406,2824067,2766330,13549,14.483,9843,10.521,483405,185502,297903,6.706,17.475,369566,117398,252168,4.244,13.359,113839,4.115,26.719,5336,5510,47667,
1995,52,180510,351199,5304329,5328994,38567,11.102,30968,8.914,749662,288989,460673,5.423,14.068,795699,249945,545754,4.69,14.932,-46037,-0.864,28.135,14351,15585,94537,
1995,53,204357,245661,1699877,1673270,32890,13.53,27739,11.411,357664,154337,203327,9.224,21.375,304187,121056,183131,7.235,18.179,53477,3.196,36.358,20258,20942,84438,
1995,54,481506,522078,5160781,5053033,72365,14.154,50777,9.931,944741,331241,613500,6.555,18.697,729953,236396,493557,4.678,14.446,214788,4.251,28.892,36906,37357,145373,
1995,55,28605,51880,3226956,3189239,4917,9.518,4477,8.666,533226,171349,361877,5.373,16.72,458504,127946,330558,4.012,14.377,74722,2.343,28.753,1001,1037,12416,
1995,56,241850,278053,6117410,5857158,47503,17.536,33188,12.251,1606254,573820,1032434,9.797,27.424,1081979,362805,719174,6.194,18.473,524275,8.951,36.946,25239,25739,238709,
1995,61,47089,52744,2129311,2101586,6544,12.685,4230,8.2,199034,39684,159350,1.888,9.471,143619,27774,115845,1.322,6.834,55415,2.637,13.668,3141,3251,20851,
1995,62,481327,578316,12324681,12150442,51430,8.97,41500,7.238,1484695,502567,982128,4.136,12.219,1136578,382598,753980,3.149,9.354,348117,2.865,18.708,31151,32149,252912,
1995,71,70721,76497,1339867,1302748,10624,14.131,7990,10.628,268527,104314,164213,8.007,20.612,193705,59380,134325,4.558,14.869,74822,5.743,29.738,5958,6043,42184,
1995,72,350346,463676,8845071,8686871,65233,14.239,54120,11.814,1772434,916196,856238,10.547,20.404,1459267,608369,850898,7.003,16.799,313167,3.605,33.597,39562,40947,390143,
1995,81,597748,654441,4880025,4803585,63040,9.706,53212,8.192,782171,251699,530472,5.24,16.283,626856,198567,428289,4.134,13.05,155315,3.233,26.1,39120,40066,145738,
1996,11,22048,22646,189029,188935,3178,14.084,3014,13.358,38486,13606,24880,7.201,20.37,38385,12412,25973,6.569,20.317,101,0.053,40.633,2271,2277,8990,
1996,21,17929,22654,465815,472790,2163,9.443,2669,11.651,71631,18379,53252,3.887,15.151,85685,34152,51533,7.224,18.123,-14054,-2.973,30.301,1815,1847,17101,
1996,22,6205,14952,691861,705216,1196,8.119,755,5.125,50390,25175,25215,3.57,7.145,76937,8656,68281,1.227,10.91,-26547,-3.764,14.291,257,264,1627,
1996,23,552685,558995,5200996,5119127,81853,14.788,70886,12.807,1184679,336363,848316,6.571,23.142,1021872,307229,714643,6.002,19.962,162807,3.18,39.924,53120,53167,240413,
1996,31-33,292035,338201,16120802,16204240,28505,8.433,28175,8.335,1581767,408503,1173264,2.521,9.761,1748821,502415,1246406,3.101,10.792,-167054,-1.031,19.523,21610,21843,246254,
1996,42,316211,404665,5396464,5369689,43325,10.771,38451,9.56,825874,257419,568455,4.794,15.38,771824,279099,492725,5.198,14.374,54050,1.007,28.747,26387,27224,162544,
1996,44-45,679034,1041559,13518832,13406082,107380,10.337,101842,9.804,2073210,877058,1196152,6.542,15.465,1857879,642849,1215030,4.795,13.858,215331,1.606,27.717,66395,69819,325522,
1996,48-49,127630,161101,3613433,3558779,23887,15.001,20147,12.653,585217,187337,397880,5.264,16.444,475904,188161,287743,5.287,13.373,109313,3.072,26.745,14539,14799,86266,
1996,51,59997,99593,2897703,2849916,15726,16.119,11666,11.957,530629,215296,315333,7.554,18.619,436411,151013,285398,5.299,15.313,94218,3.306,30.626,5923,6185,50826,
1996,52,184079,359345,5414320,5347738,39188,11.041,30351,8.551,860408,330497,529911,6.18,16.089,725639,236140,489499,4.416,13.569,134769,2.52,27.138,13534,14621,75443,
1996,53,204993,247645,1672279,1677254,31036,12.595,28592,11.603,327114,133516,193598,7.96,19.503,334227,124527,209700,7.424,19.927,-7113,-0.424,39.006,20421,21339,86872,
1996,54,500021,542672,5425767,5314720,74572,14.013,53574,10.067,1004860,354799,650061,6.676,18.907,783897,261798,522099,4.926,14.75,220963,4.158,29.499,39463,39896,162873,
1996,55,28290,52067,3227376,3218982,4837,9.332,4368,8.427,511863,152188,359675,4.728,15.901,495248,121302,373946,3.768,15.385,16615,0.516,30.77,999,1051,15937,
1996,56,242973,281886,6330773,6137032,47115,17.037,36421,13.17,1656082,581271,1074811,9.472,26.985,1271956,420394,851562,6.85,20.726,384126,6.259,41.452,27244,27629,259168,
1996,61,48842,54676,2106506,2093840,6812,12.695,4781,8.91,186401,42946,143455,2.051,8.902,161553,40473,121080,1.933,7.716,24848,1.187,15.431,3622,3701,30576,
1996,62,479943,583499,12404380,12305466,52166,8.993,45317,7.812,1485761,541227,944534,4.398,12.074,1285065,422044,863021,3.43,10.443,200696,1.631,20.886,33036,34191,257865,
1996,71,72208,78126,1381722,1353719,10554,13.701,8364,10.858,266115,100488,165627,7.423,19.658,210199,62230,147969,4.597,15.528,55916,4.131,31.055,6279,6339,47274,
1996,72,354812,472748,9016644,8916099,65273,13.952,55486,11.86,1723829,942295,781534,10.568,19.334,1522019,626100,895919,7.022,17.07,201810,2.263,34.141,41089,42325,406176,
1996,81,604933,662803,4977945,4917545,63124,9.591,53800,8.175,776948,252575,524373,5.136,15.8,653633,203896,449737,4.146,13.292,123315,2.508,26.584,39700,40535,148348,
1997,11,22074,22692,195788,193127,2968,13.066,3015,13.273,43741,15605,28136,8.08,22.649,38322,14299,24023,7.404,19.843,5419,2.806,39.686,2248,2259,9916,
1997,21,17653,22334,483024,475237,2444,10.904,2602,11.609,102710,36287,66423,7.636,21.612,86335,36132,50203,7.603,18.167,16375,3.446,36.333,1606,1629,13752,
1997,22,6150,14885,686788,694482,915,6.151,897,6.03,54408,18067,36341,2.602,7.834,69337,11890,57447,1.712,9.984,-14929,-2.15,15.669,307,311,2300,
1997,23,569862,575922,5510657,5359976,84181,14.799,69981,12.303,1309962,349026,960936,6.512,24.44,1009234,336587,672647,6.28,18.829,300728,5.611,37.658,52587,52657,247158,
1997,31-33,292360,337659,16328120,16256556,27966,8.265,29342,8.672,1784526,412265,1372261,2.536,10.977,1637604,554487,1083117,3.411,10.073,146922,0.904,20.147,21910,22122,250300,
1997,42,312448,395398,5366478,5308912,41603,10.503,43008,10.858,929386,268400,660986,5.056,17.506,814948,329301,485647,6.203,15.351,114438,2.156,30.701,27596,28544,169829,
1997,44-45,673153,1040121,13958897,13795748,109396,10.492,114541,10.985,2355685,904318,1451367,6.555,17.075,2033374,741944,1291430,5.378,14.739,322311,2.336,29.478,68166,73244,348867,
1997,48-49,130213,164346,3746289,3690044,24834,15.237,22118,13.57,643326,218945,424381,5.933,17.434,531463,191456,340007,5.188,14.403,111863,3.031,28.805,15589,15864,99064,
1997,51,61822,102108,3015945,2961142,15160,15.02,12813,12.694,598055,222783,375272,7.524,20.197,486852,178872,307980,6.041,16.441,111203,3.755,32.883,6753,6984,62856,
1997,52,190975,369821,5631967,5559639,49103,13.438,40258,11.018,1125802,456534,669268,8.212,20.25,973899,434262,539637,7.811,17.517,151903,2.732,35.035,13875,14802,81845,
1997,53,206729,254118,1740755,1709759,34213,13.579,29905,11.869,397348,162923,234425,9.529,23.24,336141,154236,181905,9.021,19.66,61207,3.58,39.32,20981,21747,99838,
1997,54,518126,561662,5636410,5498293,80067,14.514,60071,10.889,1181150,403322,777828,7.335,21.482,904769,344216,560553,6.26,16.455,276381,5.027,32.911,43040,43654,200612,
1997,55,27930,50791,3238532,3239488,5045,9.814,6276,12.209,608447,172250,436197,5.317,18.782,607090,219161,387929,6.765,18.74,1357,0.042,37.481,1286,1388,23044,
1997,56,252620,295214,7006645,6734027,50255,17.321,40108,13.824,1992882,727097,1265785,10.797,29.594,1444992,515319,929673,7.652,21.458,547890,8.136,42.916,28964,29385,298697,
1997,61,50221,56379,2198560,2157490,6788,12.231,5024,9.053,226385,43509,182876,2.017,10.493,143717,32986,110731,1.529,6.661,82668,3.832,13.323,3725,3782,24452,
1997,62,481621,595883,12806861,12670375,59971,10.147,50224,8.498,1895358,679104,1216254,5.36,14.959,1620910,571489,1049421,4.51,12.793,274448,2.166,25.586,34494,35695,323239,
1997,71,74850,80943,1511020,1481855,10451,13.017,9143,11.388,285684,101486,184198,6.849,19.279,228254,84194,144060,5.682,15.403,57430,3.876,30.807,6666,6724,59250,
1997,72,357504,481700,9242600,9150839,69071,14.455,61361,12.841,1875666,994933,880733,10.873,20.497,1687392,685414,1001978,7.49,18.44,188274,2.057,36.88,44111,45647,437762,
1997,81,599271,656389,4919127,4865334,61961,9.463,58742,8.971,799644,245800,553844,5.052,16.436,692913,243175,449738,4.998,14.242,106731,2.194,28.484,41691,42583,156003,
1998,11,22157,22792,192424,194312,3111,13.675,3027,13.305,40741,15343,25398,7.896,20.967,44707,15285,29422,7.866,23.008,-3966,-2.041,41.934,2263,2263,9700,
1998,21,17464,22162,489261,487533,2169,9.731,2426,10.884,92478,26555,65923,5.447,18.969,89055,31513,57542,6.464,18.266,3423,0.702,36.533,1505,1560,15205,
1998,22,6181,15422,685652,686683,1388,9.161,848,5.597,67201,31725,35476,4.62,9.786,69543,10604,58939,1.544,10.127,-2342,-0.341,19.573,279,286,2041,
1998,23,578997,585673,5767364,5658483,80316,13.826,70760,12.181,1288389,355199,933190,6.277,22.769,1069853,320920,748933,5.671,18.907,218536,3.862,37.814,51873,51914,230980,
1998,31-33,294326,340625,16676039,16564276,27535,8.098,26325,7.742,1790600,437563,1353037,2.642,10.81,1565178,461699,1103479,2.787,9.449,225422,1.361,18.898,19315,19512,211398,
1998,42,313456,397430,5566657,5500888,39697,9.992,39438,9.926,917016,279388,637628,5.079,16.67,781457,289074,492383,5.255,14.206,135559,2.464,28.412,26046,26963,151917,
1998,44-45,676473,1044776,14344856,14195473,98440,9.42,98980,9.471,2164272,805451,1358821,5.674,15.246,1858701,637747,1220954,4.493,13.094,305571,2.153,26.187,60122,63760,298785,
1998,48-49,133874,169810,3904568,3835932,25284,15.11,20336,12.153,643052,234488,408564,6.113,16.764,507828,167193,340635,4.359,13.239,135224,3.525,26.477,14306,14652,83787,
1998,51,63087,107799,3193408,3111583,17765,16.912,12258,11.669,666244,262185,404059,8.426,21.412,498490,199597,298893,6.415,16.02,167754,5.391,32.041,6439,6723,57556,
1998,52,197070,384242,5862701,5779009,47834,12.662,34887,9.235,1096277,400490,695787,6.93,18.97,935865,310772,625093,5.378,16.194,160412,2.776,32.388,13273,14032,75489,
1998,53,209401,257915,1818512,1793271,31709,12.363,28861,11.252,389120,150319,238801,8.382,21.699,337707,143146,194561,7.982,18.832,51413,2.867,37.664,18858,20141,89046,
1998,54,542547,589041,6210976,5961700,84561,14.667,59526,10.325,1353960,499054,854906,8.371,22.711,851394,293460,557934,4.922,14.281,502566,8.43,28.562,41188,41599,167472,
1998,55,28100,51066,3295193,3273909,5398,10.557,5530,10.815,616063,171787,444276,5.247,18.817,572987,197262,375725,6.025,17.502,43076,1.316,35.003,1119,1190,17973,
1998,56,257966,305088,7708176,7407700,47522,15.819,38174,12.707,2021856,681681,1340175,9.202,27.294,1415810,507244,908566,6.848,19.113,606046,8.181,38.225,27490,27986,247919,
1998,61,51762,57999,2334839,2291033,6554,11.447,5063,8.843,244330,50261,194069,2.194,10.665,156168,35936,120232,1.569,6.816,88162,3.848,13.633,3587,3630,21747,
1998,62,486969,605436,13603498,13450542,53056,8.81,46689,7.752,1716607,551575,1165032,4.101,12.762,1409712,454556,955156,3.379,10.481,306895,2.282,20.961,31588,32671,247091,
1998,71,76554,82817,1569902,1542265,10404,12.683,8833,10.768,285524,97896,187628,6.348,18.513,229057,77321,151736,5.013,14.852,56467,3.661,29.704,6102,6207,49515,
1998,72,360678,484258,9456676,9378225,58055,12.005,56707,11.726,1783530,822062,961468,8.766,19.018,1620528,665118,955410,7.092,17.28,163002,1.738,34.559,37746,38865,360009,
1998,81,605456,664348,5042026,4997687,61192,9.254,54930,8.307,789113,254041,535072,5.083,15.79,697133,216461,480672,4.331,13.949,91980,1.84,27.898,38397,39344,140257,
1999,11,22031,22652,190580,189395,2904,12.832,2862,12.646,39283,11976,27307,6.323,20.741,36998,13142,23856,6.939,19.535,2285,1.206,39.07,2109,2111,9276,
1999,21,16509,21299,447790,468833,1876,8.633,2740,12.609,59410,20342,39068,4.339,12.672,100842,30662,70180,6.54,21.509,-41432,-8.837,25.344,1718,1757,14433,
1999,22,6164,15948,661810,668048,1546,9.854,1027,6.546,67238,29136,38102,4.361,10.065,79150,19660,59490,2.943,11.848,-11912,-1.783,20.13,281,303,2284,
1999,23,592002,598913,6159183,5957210,81475,13.764,67508,11.405,1415445,358500,1056945,6.018,23.76,1010940,327437,683503,5.496,16.97,404505,6.79,33.94,49705,49756,241143,
1999,31-33,290090,337033,16420162,16555328,24347,7.186,27917,8.24,1561849,367511,1194338,2.22,9.434,1827544,520686,1306858,3.145,11.039,-265695,-1.605,18.868,20463,20669,242321,
1999,42,310182,395810,5643651,5610442,36113,9.098,38374,9.667,842219,249636,592583,4.449,15.012,775121,286489,488632,5.106,13.816,67098,1.196,27.631,26161,27323,161576,
1999,44-45,669786,1044362,14658481,14502745,96208,9.211,96517,9.24,2186668,852545,1334123,5.879,15.078,1871648,617344,1254304,4.257,12.905,315020,2.172,25.811,61000,64774,318303,
1999,48-49,137212,173634,4054220,3968582,25040,14.592,20983,12.227,674610,242516,432094,6.111,16.999,501594,188133,313461,4.741,12.639,173016,4.36,25.278,14754,15112,92619,
1999,51,64115,111699,3272450,3229393,18407,16.758,14686,13.371,675628,282746,392882,8.755,20.921,595566,249385,346181,7.722,18.442,80062,2.479,36.884,6860,7177,67526,
1999,52,200812,392440,5993523,5946392,49975,12.862,42164,10.852,1111033,427834,683199,7.195,18.684,1034532,456479,578053,7.677,17.398,76501,1.287,34.795,14819,16355,101939,
1999,53,211740,265521,1884220,1857754,35304,13.46,28832,10.993,392015,177759,214256,9.568,21.102,339179,143421,195758,7.72,18.257,52836,2.844,36.515,19760,20808,89755,
1999,54,560003,611100,6618383,6432367,84423,14.057,63408,10.558,1351966,469450,882516,7.298,21.018,977322,337388,639934,5.245,15.194,374644,5.824,30.388,44398,44957,194669,
1999,55,28083,51945,3277854,3295044,6655,12.923,5761,11.187,567412,203827,363585,6.186,17.22,599304,202523,396781,6.146,18.188,-31892,-0.968,34.44,1262,1333,24972,
1999,56,258547,308260,8230708,7980611,43586,14.224,39932,13.031,2121307,666979,1454328,8.357,26.581,1610637,526498,1084139,6.597,20.182,510670,6.399,40.364,28498,28970,295309,
1999,61,52939,59479,2426281,2382403,6626,11.3,4943,8.43,241072,54244,186828,2.277,10.119,154648,32817,121831,1.377,6.491,86424,3.628,12.983,3565,3638,20774,
1999,62,486429,608739,13753027,13696783,53003,8.732,49565,8.165,1642922,529920,1113002,3.869,11.995,1531716,547760,983956,3.999,11.183,111206,0.812,22.366,33003,34481,288021,
1999,71,77724,84279,1618048,1590732,10095,12.073,8763,10.48,276292,83328,192964,5.238,17.369,219492,68876,150616,4.33,13.798,56800,3.571,27.596,6236,6308,47630,
1999,72,360662,484548,9616807,9542047,56428,11.648,56197,11.601,1714955,845266,869689,8.858,17.973,1570458,645980,924478,6.77,16.458,144497,1.514,32.917,36927,38875,369375,
1999,81,606305,665700,5141395,5096264,57015,8.577,55102,8.289,759258,232122,527136,4.555,14.898,669313,221454,447859,4.345,13.133,89945,1.765,26.267,38284,39144,144010,
2000,11,21408,21999,189755,188087,2623,11.85,2896,13.083,38718,12457,26261,6.623,20.585,35573,12729,22844,6.768,18.913,3145,1.672,37.826,2100,2102,8803,
2000,21,16298,21290,449421,451761,2138,10.028,2198,10.31,80974,25266,55708,5.593,17.924,86485,26933,59552,5.962,19.144,-5511,-1.22,35.848,1369,1400,9409,
2000,22,6397,16562,654579,657901,1576,9.701,944,5.811,71351,32296,39055,4.909,10.845,78645,13752,64893,2.09,11.954,-7294,-1.109,21.69,312,328,2148,
2000,23,600047,607911,6581110,6371712,78287,12.976,69099,11.453,1495905,373943,1121962,5.869,23.477,1076476,333497,742979,5.234,16.895,419429,6.583,33.789,50388,50455,243204,
2000,31-33,285590,332911,16360864,16388860,23763,7.1,27348,8.171,1687514,386082,1301432,2.356,10.297,1741557,518730,1222827,3.165,10.626,-54043,-0.33,20.593,19973,20186,216548,
2000,42,308885,396234,5827874,5756964,37565,9.476,37950,9.573,938505,297294,641211,5.164,16.302,798362,304475,493887,5.289,13.868,140143,2.434,27.736,25016,26108,152381,
2000,44-45,666532,1041272,14943200,14821488,96187,9.221,99911,9.578,2219580,830046,1389534,5.6,14.975,1975100,809184,1165916,5.46,13.326,244480,1.649,26.652,58929,62749,322334,
2000,48-49,138194,175958,4225401,4131632,24694,14.115,22669,12.958,727014,223987,503027,5.421,17.596,542414,214902,327512,5.201,13.128,184600,4.468,26.257,15683,16112,88634,
2000,51,66552,118785,3579016,3483029,20566,17.817,13855,12.003,760603,332313,428290,9.541,21.837,566214,180326,385888,5.177,16.256,194389,5.581,32.513,7172,7849,74293,
2000,52,202289,399225,6022045,6006498,50862,12.848,44156,11.154,1095726,437954,657772,7.291,18.242,1067594,416701,650893,6.938,17.774,28132,0.468,35.548,15872,17098,94872,
2000,53,212046,268187,1946970,1919419,31150,11.664,28880,10.814,377285,148346,228939,7.729,19.656,320130,134017,186113,6.982,16.678,57155,2.978,33.357,19402,20378,78320,
2000,54,571469,625999,7014679,6812535,82416,13.323,67608,10.929,1453810,498504,955306,7.317,21.34,1048919,398425,650494,5.848,15.397,404891,5.943,30.794,47105,47678,207368,
2000,55,28283,53076,3349347,3321867,6450,12.279,5352,10.189,627824,214002,413822,6.442,18.9,578002,168418,409584,5.07,17.4,49822,1.5,34.8,1237,1397,20732,
2000,56,258349,310090,9050795,8683288,42460,13.724,41067,13.273,2329533,649749,1679784,7.483,26.828,1602145,603053,999092,6.945,18.451,727388,8.377,36.902,28047,28518,265196,
2000,61,54401,61420,2545883,2491985,6765,11.164,5114,8.44,263696,59127,204569,2.373,10.582,155676,30685,124991,1.231,6.247,108020,4.335,12.494,3609,3683,20694,
2000,62,489812,614473,14021121,13903222,54075,8.837,48986,8.005,1705174,546679,1158495,3.932,12.265,1470432,571526,898906,4.111,10.576,234742,1.688,21.152,30241,31744,255718,
2000,71,78701,85321,1727676,1670716,9895,11.65,9118,10.736,319335,88365,230970,5.289,19.114,204740,68624,136116,4.107,12.255,114595,6.859,24.509,6279,6502,47355,
2000,72,359488,485599,9894920,9763943,53608,11.053,52420,10.808,1719501,780258,939243,7.991,17.611,1456220,561841,894379,5.754,14.914,263281,2.696,29.829,36009,37870,343416,
2000,81,606032,665821,5283237,5219335,55348,8.313,55339,8.311,791453,234448,557005,4.492,15.164,664790,226916,437874,4.348,12.737,126663,2.427,25.474,37348,38377,138302,
2001,11,21850,22466,182814,187123,2648,11.729,2868,12.704,33676,10482,23194,5.602,17.997,42030,16108,25922,8.608,22.461,-8354,-4.464,35.994,1999,2000,10030,
2001,21,16713,21818,482512,467187,2342,10.82,1998,9.23,90310,24956,65354,5.342,19.331,59575,20253,39322,4.335,12.752,30735,6.579,25.504,1222,1259,10121,
2001,22,6521,16744,653971,656442,1477,8.841,1400,8.38,82048,35750,46298,5.446,12.499,87565,23163,64402,3.529,13.339,-5517,-0.84,24.998,299,341,3257,
2001,23,597498,605712,6507214,6479847,75224,12.461,71122,11.782,1304564,348685,955879,5.381,20.133,1249187,378994,870193,5.849,19.278,55377,0.855,38.556,50114,50161,254105,
2001,31-33,284879,332182,15854928,16138527,23936,7.163,27870,8.341,1468466,387455,1081011,2.401,9.099,2031222,603524,1427698,3.74,12.586,-562756,-3.487,18.198,19969,20224,250932,
2001,42,305792,395215,5902116,5892227,38802,9.797,40501,10.226,943153,334802,608351,5.682,16.007,919890,356744,563146,6.054,15.612,23263,0.395,31.224,25238,26805,172177,
2001,44-45,662249,1039266,14914346,14950077,93281,8.951,98959,9.496,2034476,790468,1244008,5.287,13.608,2116239,743325,1372914,4.972,14.155,-81763,-0.547,27.217,60969,66207,342183,
2001,48-49,139194,178188,4217308,4229734,24848,13.99,23694,13.34,619104,218477,400627,5.165,14.637,643658,217419,426239,5.14,15.217,-24554,-0.581,29.274,16025,16573,102371,
2001,51,66044,125158,3764598,3686659,23831,19.545,17368,14.245,803882,374494,429388,10.158,21.805,652154,298554,353600,8.098,17.69,151728,4.116,35.379,8044,8689,100486,
2001,52,206578,406663,6206661,6128331,51893,12.854,46018,11.398,1274458,541532,732926,8.837,20.796,1101735,496921,604814,8.109,17.978,172723,2.818,35.955,16365,17748,101996,
2001,53,213225,271842,1981232,1971659,33349,12.329,30646,11.33,375796,161937,213859,8.213,19.06,357124,150055,207069,7.611,18.113,18672,0.947,36.226,19056,19804,77417,
2001,54,584241,641264,7290095,7146825,86223,13.586,72951,11.495,1497576,517245,980331,7.237,20.954,1210263,443317,766946,6.203,16.934,287313,4.02,33.869,49835,50382,236576,
2001,55,28173,52637,3298248,3327537,5608,10.609,6059,11.462,585190,192910,392280,5.797,17.586,643860,230670,413190,6.932,19.349,-58670,-1.763,35.173,1301,1363,25105,
2001,56,263534,317649,9044830,9107224,43991,13.944,39675,12.576,2039330,676124,1363206,7.424,22.392,2166222,637907,1528315,7.004,23.786,-126892,-1.393,44.785,26640,27155,283552,
2001,61,54343,61463,2466923,2431154,6956,11.469,5331,8.79,240768,51776,188992,2.13,9.903,168219,41138,127081,1.692,6.919,72549,2.984,13.839,3659,3718,25739,
2001,62,494408,624651,14303987,14150578,58121,9.398,45751,7.397,1716450,551034,1165416,3.894,12.13,1408732,506463,902269,3.579,9.955,307718,2.175,19.911,28618,29940,254382,
2001,71,78692,85512,1745389,1730557,10048,11.807,9226,10.841,266961,87278,179683,5.043,15.426,238049,77942,160107,4.504,13.756,28912,1.671,27.511,6394,6468,49675,
2001,72,362300,491570,9986754,9953940,57244,11.697,52912,10.812,1649976,790087,859889,7.937,16.576,1587860,616228,971632,6.191,15.952,62116,0.624,31.904,35563,37362,363334,
2001,81,594920,655625,5246722,5216092,54132,8.252,54892,8.368,736339,218758,517581,4.194,14.117,674978,222309,452669,4.262,12.94,61361,1.176,25.881,37694,38424,141360,
2002,11,21395,22076,181192,184760,2549,11.357,3287,14.645,34665,13492,21173,7.302,18.762,41883,15096,26787,8.171,22.669,-7218,-3.907,37.524,2232,2233,10382,
2002,21,16630,22054,474740,483967,2579,11.738,2414,10.987,83208,33967,49241,7.018,17.193,103141,35362,67779,7.307,21.312,-19933,-4.119,34.386,1256,1270,10937,
2002,22,6494,17394,667611,668544,1289,7.496,894,5.199,74763,36203,38560,5.415,11.183,77289,19245,58044,2.879,11.561,-2526,-0.378,22.366,335,335,2818,
2002,23,590361,599371,6384756,6465545,80270,13.4,79580,13.285,1295792,411624,884168,6.366,20.041,1459271,417396,1041875,6.456,22.57,-163479,-2.528,40.083,51785,51904,273237,
2002,31-33,283573,330740,14577922,15338923,24426,7.294,32670,9.756,1309411,456602,852809,2.977,8.537,2832784,785549,2047235,5.121,18.468,-1523373,-9.931,17.073,22377,22763,363401,
2002,42,306760,399170,5807272,5953705,38734,9.609,46623,11.566,921606,334540,587066,5.619,15.48,1212825,456333,756492,7.665,20.371,-291219,-4.891,30.959,26372,27513,218707,
2002,44-45,646391,1022984,14595969,14650478,108965,10.637,111761,10.91,2260070,998718,1261352,6.817,15.427,2379248,822783,1556465,5.616,16.24,-119178,-0.813,30.853,64174,70242,442292,
2002,48-49,138704,177353,4038221,4117221,24198,13.568,26184,14.682,592854,231152,361702,5.614,14.399,749183,237253,511930,5.762,18.196,-156329,-3.797,28.799,16589,17043,114777,
2002,51,63683,125201,3723583,3835040,21814,17.359,22735,18.092,781712,439723,341989,11.466,20.383,1002118,352082,650036,9.181,26.131,-220406,-5.747,40.767,8429,8662,111959,
2002,52,209644,414774,6440419,6370299,54249,13.189,47315,11.504,1268488,530830,737658,8.333,19.913,1119267,423003,696264,6.64,17.57,149221,2.342,35.14,16138,16929,110249,
2002,53,219834,282423,1978945,1986033,36260,12.981,30085,10.77,382218,173558,208660,8.739,19.245,397086,150543,246543,7.58,19.994,-14868,-0.749,38.491,18478,19058,83708,
2002,54,590648,653509,7056118,7192291,91072,14.003,84823,13.042,1423331,612352,810979,8.514,19.79,1699309,710446,988863,9.878,23.627,-275978,-3.837,39.579,54202,54728,304939,
2002,55,26621,47239,2833655,2913080,5404,11.201,7414,15.368,519989,184621,335368,6.338,17.85,677890,240227,437663,8.246,23.271,-157901,-5.42,35.7,1501,1592,31550,
2002,56,251623,303724,8388733,8718367,44229,14.431,49766,16.237,2054976,721167,1333809,8.272,23.571,2730111,983214,1746897,11.278,31.314,-675135,-7.744,47.141,29418,29963,405590,
2002,61,58536,66038,2718160,2673681,7856,12.102,5613,8.646,317419,81222,236197,3.038,11.872,228258,56566,171692,2.116,8.537,89161,3.335,17.074,3559,3636,37287,
2002,62,512376,651573,14852662,14661872,71523,11.151,51225,7.986,2171351,798226,1373125,5.444,14.81,1794962,660114,1134848,4.502,12.242,376389,2.567,24.485,28878,29868,318089,
2002,71,80621,87870,1777792,1766660,11761,13.442,11013,12.587,315913,112138,203775,6.347,17.882,294345,96491,197854,5.462,16.661,21568,1.221,33.322,6893,7005,62684,
2002,72,367972,501208,10078000,10080665,68705,13.84,59166,11.918,1889024,990604,898420,9.827,18.739,1884947,687154,1197793,6.817,18.699,4077,0.04,37.397,36621,37944,373049,
2002,81,607902,670028,5272236,5262594,63236,9.496,55075,8.27,833121,288976,544145,5.491,15.831,813859,245221,568638,4.66,15.465,19262,0.366,30.93,35639,36161,147079,
2003,11,21001,21719,183426,181351,2675,12.323,2651,12.213,38922,11681,27241,6.441,21.462,34552,11902,22650,6.563,19.053,4370,2.41,38.105,1933,1933,7755,
2003,21,16348,21603,457166,465120,1926,8.856,2218,10.198,72723,20317,52406,4.368,15.635,87702,30067,57635,6.464,18.856,-14979,-3.22,31.271,1236,1269,10299,
2003,22,6482,17745,668042,665551,1490,8.517,989,5.653,77313,27173,50140,4.083,11.616,71659,17473,54186,2.625,10.767,5654,0.85,21.534,243,254,2066,
2003,23,609878,619367,6405741,6390553,88714,14.547,69626,11.417,1332560,394736,937824,6.177,20.852,1301431,337378,964053,5.279,20.365,31129,0.487,40.73,51681,51733,245002,
2003,31-33,277808,323892,14121833,14342049,22588,6.912,28350,8.676,1376715,344473,1032242,2.402,9.599,1821422,555954,1265468,3.876,12.7,-444707,-3.101,19.198,20671,20926,225919,
2003,42,306727,396600,5837177,5808802,37472,9.433,38726,9.749,900306,290600,609706,5.003,15.499,843375,294618,548757,5.072,14.519,56931,0.98,29.038,24378,25168,138089,
2003,44-45,655423,1034309,14931658,14788133,104294,10.132,94430,9.174,2122979,793576,1329403,5.366,14.356,1834662,611680,1222982,4.136,12.406,288317,1.95,24.813,59023,62027,293118,
2003,48-49,140046,180455,3988101,4019497,26316,14.707,23286,13.013,739800,371878,367922,9.252,18.405,800569,223206,577363,5.553,19.917,-60769,-1.512,36.811,15876,16130,89179,
2003,51,64030,126212,3622249,3662768,17824,14.199,16464,13.115,569163,229171,339992,6.257,15.539,654617,291501,363116,7.958,17.872,-85454,-2.333,31.078,7178,7397,64925,
2003,52,215655,427728,6416977,6417288,54833,13.029,41085,9.762,1092190,416310,675880,6.487,17.019,1102528,382457,720071,5.96,17.181,-10338,-0.161,34.039,15549,16299,75188,
2003,53,228233,291603,2067222,2025259,37609,13.112,28080,9.789,406612,156509,250103,7.728,20.077,323139,124685,198454,6.156,15.955,83473,4.122,31.911,18341,18886,71411,
2003,54,604314,668545,7176901,7133441,88510,13.386,73865,11.171,1327463,462598,864865,6.485,18.609,1246872,436671,810201,6.121,17.479,80591,1.13,34.959,52287,52812,231557,
2003,55,26550,46841,2819717,2839327,4823,10.241,5331,11.32,485134,146284,338850,5.152,17.086,521026,166487,354539,5.864,18.35,-35892,-1.264,34.172,1141,1210,16800,
2003,56,257968,307242,8304075,8340670,44527,14.573,41117,13.457,1891010,525404,1365606,6.299,22.672,1953835,672475,1281360,8.063,23.425,-62825,-0.753,45.344,25964,26406,315388,
2003,61,60830,68208,2784738,2747304,8012,11.952,5666,8.452,298121,53726,244395,1.956,10.851,224515,46794,177721,1.703,8.172,73606,2.679,16.344,3949,4053,28411,
2003,62,526707,667123,15368587,15111001,60753,9.217,44836,6.802,1943243,551385,1391858,3.649,12.86,1426019,455839,970180,3.017,9.437,517224,3.423,18.874,28734,30193,229525,
2003,71,84464,91827,1841123,1811133,13143,14.616,9331,10.377,336365,103533,232832,5.716,18.572,276030,78931,197099,4.358,15.241,60335,3.331,30.481,6690,6747,53369,
2003,72,378510,513625,10456442,10265230,66816,13.164,54666,10.771,1938745,897548,1041197,8.744,18.887,1558440,606373,952067,5.907,15.182,380305,3.705,30.363,38024,39031,350489,
2003,81,615967,677960,5373979,5323231,61695,9.157,53225,7.9,820326,238868,581458,4.487,15.41,719015,216136,502879,4.06,13.507,101311,1.903,27.014,37789,38583,140894,
2004,11,20546,21192,182338,181956,2571,12.059,2827,13.26,33344,10557,22787,5.802,18.325,32705,12863,19842,7.069,17.974,639,0.351,35.948,1981,1982,8144,
2004,21,16575,21767,468762,462555,2105,9.694,1998,9.202,74210,23337,50873,5.045,16.043,61417,22839,38578,4.938,13.278,12793,2.766,26.556,1114,1145,9676,
2004,22,6327,17280,634788,650970,1229,7.058,1497,8.597,57333,20485,36848,3.147,8.807,89718,26179,63539,4.022,13.782,-32385,-4.975,17.615,295,298,1445,
2004,23,621921,631391,6633312,6514425,92823,14.848,80329,12.85,1454542,382380,1072162,5.87,22.328,1218147,397916,820231,6.108,18.699,236395,3.629,37.398,55176,55256,273794,
2004,31-33,274134,319456,13783733,13940443,22175,6.886,27345,8.491,1327296,340154,987142,2.44,9.521,1640145,522554,1117591,3.748,11.765,-312849,-2.244,19.042,19694,19906,211171,
2004,42,304007,396068,5916208,5884005,35769,9.033,35601,8.991,860410,287471,572939,4.886,14.623,797994,303626,494368,5.16,13.562,62416,1.061,27.124,23342,24061,133184,
2004,44-45,658432,1036307,15410611,15173155,99821,9.643,97613,9.429,2241142,750114,1491028,4.944,14.77,1768960,643503,1125457,4.241,11.658,472182,3.112,23.317,62765,66949,327987,
2004,48-49,140834,182601,4135399,4078899,25231,13.882,23526,12.944,671031,253033,417998,6.203,16.451,561821,212154,349667,5.201,13.774,109210,2.677,27.548,15971,16238,88642,
2004,51,63516,126593,3483767,3556769,18434,14.598,17804,14.099,567741,194033,373708,5.455,15.962,708571,260068,448503,7.312,19.922,-140830,-3.959,31.925,6826,7142,53590,
2004,52,221944,434546,6440234,6437515,52792,12.238,46477,10.774,1112073,442438,669635,6.873,17.275,1111413,458783,652630,7.127,17.265,660,0.01,34.529,15860,16443,78891,
2004,53,234527,300513,2104604,2082550,39370,13.319,29548,9.996,376848,160837,216011,7.723,18.096,330836,135418,195418,6.503,15.886,46012,2.209,31.772,19302,20357,83058,
2004,54,611444,679014,7246760,7207743,87146,12.927,77443,11.487,1254490,448824,805666,6.227,17.405,1180272,459062,721210,6.369,16.375,74218,1.03,32.75,52210,52786,243122,
2004,55,26182,46779,2786480,2821977,4197,8.96,4321,9.225,436035,150743,285292,5.342,15.451,504507,172077,332430,6.098,17.878,-68472,-2.426,30.903,1153,1215,21726,
2004,56,262444,312002,8521753,8447870,44811,14.43,41883,13.487,1861510,545499,1316011,6.457,22.035,1727421,592212,1135209,7.01,20.448,134089,1.587,40.896,26614,27172,294385,
2004,61,62784,70313,2879283,2825607,7889,11.377,5948,8.578,291175,61592,229583,2.18,10.305,183353,48157,135196,1.704,6.489,107822,3.816,12.978,4192,4249,35607,
2004,62,537193,680843,15691635,15524153,59153,8.777,45440,6.742,1689456,505526,1183930,3.256,10.883,1356319,433890,922429,2.795,8.737,333137,2.146,17.474,30773,31763,232012,
2004,71,86822,94390,1886445,1865588,13176,14.135,10829,11.617,295829,98562,197267,5.283,15.857,255193,82000,173193,4.395,13.679,40636,2.178,27.358,7443,7482,51619,
2004,72,387309,522577,10740113,10601114,66147,12.761,57696,11.131,1865598,880504,985094,8.306,17.598,1595443,619116,976327,5.84,15.05,270155,2.548,30.1,41159,42284,385391,
2004,81,616307,679397,5419726,5397694,57856,8.535,54829,8.088,773078,246118,526960,4.56,14.322,728336,238781,489555,4.424,13.493,44742,0.829,26.987,40197,40732,147524,
2005,11,19157,19810,167322,168548,2549,12.884,2497,12.621,29616,10119,19497,6.004,17.571,32088,10100,21988,5.992,19.038,-2472,-1.467,35.143,1780,1783,7177,
2005,21,16884,22058,493243,480355,2242,10.261,1826,8.357,87191,24849,62342,5.173,18.151,61238,20315,40923,4.229,12.749,25953,5.403,25.497,1054,1086,7891,
2005,22,6154,16765,634813,633343,1038,6.139,1322,7.819,62552,19818,42734,3.129,9.876,60182,24970,35212,3.943,9.502,2370,0.374,19.005,221,234,1018,
2005,23,645736,656066,6792761,6720080,101459,15.722,79976,12.393,1460172,449661,1010511,6.691,21.728,1314362,383382,930980,5.705,19.559,145810,2.17,39.117,55866,55915,263581,
2005,31-33,269491,314322,13704427,13716364,21715,6.864,25772,8.147,1395962,308707,1087255,2.251,10.177,1416730,434143,982587,3.165,10.329,-20768,-0.151,20.355,18838,19022,198828,
2005,42,304686,398452,5986980,5974291,35359,8.882,34611,8.695,807894,253455,554439,4.242,13.523,782041,249942,532099,4.184,13.09,25853,0.433,26.18,23630,24374,128488,
2005,44-45,654290,1035950,15325740,15346940,100937,9.762,97074,9.388,1958883,766492,1192391,4.994,12.764,2004262,599017,1405245,3.903,13.06,-45379,-0.296,25.528,64281,67297,321271,
2005,48-49,143964,186722,4172641,4163080,25856,13.981,22274,12.044,579046,208445,370601,5.007,13.909,556639,168715,387924,4.053,13.371,22407,0.538,26.742,15365,15654,82169,
2005,51,63265,127333,3414398,3447078,15765,12.426,14846,11.701,475091,182916,292175,5.306,13.782,540352,184428,355924,5.35,15.676,-65261,-1.893,27.565,6491,6900,57572,
2005,52,227021,443153,6426267,6439564,57875,13.195,48818,11.13,1035945,471717,564228,7.325,16.087,1062472,458232,604240,7.116,16.499,-26527,-0.412,32.174,16950,17684,90156,
2005,53,243576,314212,2140051,2120790,46757,15.233,32204,10.492,402794,199501,203293,9.407,18.993,363934,128261,235673,6.048,17.16,38860,1.832,34.321,21031,22047,76673,
2005,54,627593,695892,7402158,7329614,90642,13.173,75079,10.911,1279663,440604,839059,6.011,17.459,1128963,388897,740066,5.306,15.403,150700,2.056,30.806,50648,51262,212743,
2005,55,25969,47970,2843426,2844730,4654,9.816,3540,7.466,423765,141424,282341,4.971,14.896,426586,116886,309700,4.109,14.996,-2821,-0.099,29.793,1057,1101,16769,
2005,56,267801,318405,9001897,8777279,45778,14.514,39789,12.615,2069858,638979,1430879,7.28,23.582,1624023,606657,1017366,6.912,18.503,445835,5.079,37.005,26062,26451,319406,
2005,61,63645,71824,2882096,2851399,8738,12.378,6271,8.884,295207,96560,198647,3.386,10.353,234060,43772,190288,1.535,8.209,61147,2.144,16.417,4408,4453,26524,
2005,62,548333,697191,15926320,15817917,61792,8.961,46527,6.747,1665641,544194,1121447,3.44,10.53,1451564,426293,1025271,2.695,9.177,214077,1.353,18.353,31724,32602,228068,
2005,71,89227,96974,1939248,1917607,13461,14.066,10916,11.406,307189,111928,195261,5.837,16.019,264629,75540,189089,3.939,13.8,42560,2.219,27.6,7751,7802,52092,
2005,72,397922,537662,11042861,10902312,71371,13.435,58499,11.012,1967843,1021235,946608,9.367,18.05,1693237,620031,1073206,5.687,15.531,274606,2.519,31.062,44150,45304,426258,
2005,81,618921,682069,5356128,5387558,59946,8.808,56996,8.374,716472,238749,477723,4.431,13.299,779693,221786,557907,4.117,14.472,-63221,-1.173,26.597,40559,41236,149481,
2006,11,18980,19641,164271,165204,2625,13.38,2582,13.16,30618,10852,19766,6.569,18.534,32372,12548,19824,7.595,19.595,-1754,-1.062,37.067,1901,1901,7860,
2006,21,17805,23285,551835,522984,2985,13.142,1841,8.105,115796,42104,73692,8.051,22.141,57371,22858,34513,4.371,10.97,58425,11.171,21.94,1120,1146,8370,
2006,22,6041,16714,620492,627934,1120,6.706,1094,6.551,51913,18815,33098,2.996,8.267,66320,14494,51826,2.308,10.562,-14407,-2.294,16.535,263,268,2729,
2006,23,675881,687301,7364259,7075714,112050,16.687,80412,11.975,1725219,503426,1221793,7.115,24.382,1151239,352832,798407,4.987,16.27,573980,8.112,32.541,59629,59761,251310,
2006,31-33,268832,314066,13662324,13661444,23749,7.548,24869,7.904,1375119,331871,1043248,2.429,10.066,1372448,422945,949503,3.096,10.046,2671,0.02,20.092,18486,18652,182143,
2006,42,305369,402832,6056090,6022607,39111,9.757,35174,8.775,847557,282559,564998,4.692,14.073,781161,266900,514261,4.432,12.97,66396,1.102,25.941,23770,24497,134553,
2006,44-45,648926,1041516,15764629,15552601,106001,10.217,97990,9.445,2219008,927437,1291571,5.963,14.268,1803396,560821,1242575,3.606,11.595,415612,2.672,23.191,67830,70923,315971,
2006,48-49,147872,191740,4336055,4266272,29000,15.312,24305,12.833,669622,252695,416927,5.923,15.696,532917,186815,346102,4.379,12.491,136705,3.204,24.983,16466,16810,87217,
2006,51,63396,130458,3455576,3442391,18497,14.359,15217,11.813,536495,208347,328148,6.052,15.585,515417,161172,354245,4.682,14.973,21078,0.612,29.945,6421,6746,52333,
2006,52,231988,462127,6613134,6516100,63890,14.127,44167,9.766,1176613,526649,649964,8.082,18.057,976967,404063,572904,6.201,14.993,199646,3.064,29.986,18501,18986,77350,
2006,53,251823,328342,2202940,2169582,51588,16.067,37061,11.543,422933,193748,229185,8.93,19.494,356022,144419,211603,6.657,16.41,66911,3.084,32.819,25464,25929,86214,
2006,54,647579,723357,7811975,7610104,104312,14.696,77227,10.88,1483760,516013,967747,6.781,19.497,1080551,388645,691906,5.107,14.199,403209,5.298,28.398,53769,54239,216475,
2006,55,26294,49394,2930623,2929236,5427,11.108,4348,8.9,484436,149225,335211,5.094,16.538,483751,128855,354896,4.399,16.515,685,0.023,33.029,1099,1142,14627,
2006,56,276550,332571,9698913,9364532,53240,16.339,39791,12.212,2268361,706170,1562191,7.541,24.223,1604907,532549,1072358,5.687,17.138,663454,7.085,34.276,27223,27550,275905,
2006,61,65730,74929,2980839,2932855,9637,13.115,6736,9.167,313398,84359,229039,2.876,10.686,217050,44649,172401,1.522,7.401,96348,3.285,14.801,4972,5053,31924,
2006,62,557459,718074,16443534,16197201,69973,9.886,49456,6.987,1870993,669281,1201712,4.132,11.551,1373467,435397,938070,2.688,8.48,497526,3.072,16.959,33643,34620,240581,
2006,71,91415,99655,1984435,1960906,14632,14.885,11922,12.128,302966,107727,195239,5.494,15.45,255978,79852,176126,4.072,13.054,46988,2.396,26.108,8770,8822,58386,
2006,72,407598,553316,11429095,11245464,75133,13.763,60336,11.052,2050536,1051575,998961,9.351,18.234,1684161,627752,1056409,5.582,14.976,366375,3.258,29.953,46599,47616,426805,
2006,81,614973,678831,5419867,5386557,61927,9.104,64672,9.508,768151,253928,514223,4.714,14.261,701684,232564,469120,4.317,13.027,66467,1.234,26.053,46049,46911,157114,
2007,11,18973,19651,168274,169130,2383,12.086,2514,12.751,29531,11168,18363,6.603,17.461,30979,10877,20102,6.431,18.317,-1448,-0.856,34.921,1825,1828,7799,
2007,21,18548,24185,707576,626199,3387,14.392,2085,8.86,235635,58702,176933,9.374,37.629,72311,30094,42217,4.806,11.548,163324,26.082,23.095,1162,1180,10995,
2007,22,5458,16203,645275,636648,1032,6.356,1100,6.775,70040,16730,53310,2.628,11.001,53083,15152,37931,2.38,8.338,16957,2.663,16.676,241,253,1611,
2007,23,685695,697424,7317468,7365897,98327,14.163,92008,13.253,1424941,398996,1025945,5.417,19.345,1525418,408712,1116706,5.549,20.709,-100477,-1.364,38.69,68870,68930,287482,
2007,31-33,269754,314702,13372424,13531055,22016,6.96,25214,7.972,1255584,296611,958973,2.192,9.279,1576737,494261,1082476,3.653,11.653,-321153,-2.373,18.559,17968,18166,201682,
2007,42,302034,401365,6112739,6137705,36189,9,37640,9.361,884738,272252,612486,4.436,14.415,936023,335724,600299,5.47,15.25,-51285,-0.836,28.83,23318,23938,131542,
2007,44-45,643067,1044538,15612687,15654836,110170,10.576,104470,10.029,2191158,866017,1325141,5.532,13.997,2272254,699048,1573206,4.465,14.515,-81096,-0.518,27.993,65476,68227,336290,
2007,48-49,150065,195235,4438851,4405670,28208,14.566,25053,12.937,692603,231297,461306,5.25,15.721,626268,222115,404153,5.042,14.215,66335,1.506,28.43,16632,16826,82209,
2007,51,62550,128453,3478977,3486498,17320,13.413,18679,14.465,585564,220767,364797,6.332,16.795,600483,251509,348974,7.214,17.223,-14919,-0.428,33.59,6365,6620,54096,
2007,52,234322,471241,6600132,6642356,60794,13.006,53162,11.373,1111483,446303,665180,6.719,16.733,1197105,482898,714207,7.27,18.022,-85622,-1.289,33.467,19920,20946,105696,
2007,53,251742,330938,2189514,2192964,46807,14.203,44061,13.369,423265,177403,245862,8.09,19.301,432098,175235,256863,7.991,19.704,-8833,-0.403,38.602,28464,28908,93963,
2007,54,656131,731605,7740188,7710180,95987,13.247,82010,11.318,1368130,448960,919170,5.823,17.744,1314388,486782,827606,6.313,17.047,53742,0.697,34.095,54954,55369,228450,
2007,55,26444,50110,2864926,2843623,5865,11.73,5643,11.286,572446,178715,393731,6.285,20.131,525580,193249,332331,6.796,18.483,46866,1.648,36.966,882,916,11839,
2007,56,280783,337317,9761087,9745743,48673,14.553,42959,12.844,1975129,613177,1361952,6.292,20.267,1949286,609248,1340038,6.251,20.001,25843,0.265,40.003,27479,27789,312897,
2007,61,68288,77861,3041124,3010207,9025,11.762,6761,8.812,286644,71213,215431,2.366,9.522,226039,50057,175982,1.663,7.509,60605,2.013,15.018,4740,4788,28119,
2007,62,564363,730308,16762206,16594555,67751,9.358,55158,7.618,2004601,624404,1380197,3.763,12.08,1672073,542214,1129859,3.267,10.076,332528,2.004,20.152,33517,34533,259505,
2007,71,92423,101227,2030337,2019203,13923,13.857,12419,12.36,309149,101222,207927,5.013,15.31,287748,91424,196324,4.528,14.251,21401,1.06,28.501,9017,9070,59171,
2007,72,415077,568614,11614147,11551542,78302,13.946,64006,11.4,2086224,1054597,1031627,9.129,18.06,1952248,714337,1237911,6.184,16.9,133976,1.16,33.801,46745,47730,442005,
2007,81,615090,678472,5369711,5362473,61874,9.137,59281,8.754,781717,255682,526035,4.768,14.578,765685,235763,529922,4.397,14.279,16032,0.299,28.557,40980,41583,147320,
2008,11,18266,18988,163023,164691,1997,10.326,2699,13.956,26687,7696,18991,4.673,16.204,30210,10652,19558,6.468,18.343,-3523,-2.139,32.409,1885,1888,8129,
2008,21,18559,24559,625593,665280,2758,11.365,2174,8.959,104611,30036,74575,4.515,15.724,184110,28233,155877,4.244,27.674,-79499,-11.95,31.449,1409,1417,13875,
2008,22,5510,16411,633328,635679,1319,8.091,1103,6.766,64526,23399,41127,3.681,10.151,68976,18654,50322,2.934,10.851,-4450,-0.7,20.301,221,224,1436,
2008,23,660070,672145,6992755,7144113,81136,11.844,106904,15.606,1273171,332232,940939,4.65,17.821,1576234,413044,1163190,5.782,22.063,-303063,-4.242,35.643,79829,79871,299354,
2008,31-33,260660,304535,12968804,13114973,19333,6.291,24886,8.098,1155185,267228,887957,2.038,8.808,1446672,418001,1028671,3.187,11.031,-291487,-2.223,17.616,18526,18702,196791,
2008,42,298459,398732,6127075,6134607,34714,8.676,37441,9.358,846977,259619,587358,4.232,13.807,865491,292696,572795,4.771,14.108,-18514,-0.302,27.613,23781,24596,134389,
2008,44-45,629428,1032463,15569332,15585489,87910,8.474,97751,9.423,1922357,676474,1245883,4.34,12.334,1962752,581476,1381276,3.731,12.593,-40395,-0.259,24.669,65192,68129,315184,
2008,48-49,148206,194159,4430853,4435782,25282,12.977,26595,13.651,580994,169758,411236,3.827,13.098,587489,191606,395883,4.32,13.244,-6495,-0.146,26.196,17980,18124,89432,
2008,51,62248,128560,3406698,3403970,16073,12.505,16024,12.467,529175,198500,330675,5.831,15.546,527684,168663,359021,4.955,15.502,1491,0.044,31.004,6219,6318,53064,
2008,52,227546,468177,6433225,6500428,48950,10.417,52399,11.151,968088,385983,582105,5.938,14.893,1098014,417930,680084,6.429,16.891,-129926,-1.999,29.785,24432,25931,132205,
2008,53,240141,320957,2171475,2186698,39129,11.999,49430,15.158,387153,154899,232254,7.084,17.705,417489,178177,239312,8.148,19.092,-30336,-1.387,35.41,31899,32295,100275,
2008,54,660487,736138,7916610,7848664,88979,12.105,86839,11.814,1345717,449429,896288,5.726,17.146,1203727,449221,754506,5.724,15.337,141990,1.809,30.673,58848,59295,228793,
2008,55,26405,50095,2922359,2974048,4461,8.878,4771,9.495,472770,143699,329071,4.832,15.897,576847,148736,428111,5.001,19.396,-104077,-3.5,31.793,1021,1065,16157,
2008,56,279074,338075,9664191,9666487,46391,13.769,44077,13.082,1906477,622180,1284297,6.436,19.723,1925329,599349,1325980,6.2,19.918,-18852,-0.195,39.445,28916,29306,304799,
2008,61,69529,79398,3126099,3085262,8643,10.986,7186,9.134,285900,58301,227599,1.89,9.267,204243,54842,149401,1.778,6.62,81657,2.647,13.24,5173,5261,37320,
2008,62,570221,739166,17141553,16947598,62693,8.536,53293,7.256,1907570,537564,1370006,3.172,11.256,1525820,487852,1037968,2.879,9.003,381750,2.253,18.006,33477,34298,253396,
2008,71,92222,101023,2065580,2046506,12689,12.536,13083,12.925,302104,94285,207819,4.607,14.762,262853,93397,169456,4.564,12.844,39251,1.918,25.688,9429,9489,60406,
2008,72,418655,576393,11890408,11762578,72064,12.581,64856,11.323,2073577,972515,1101062,8.268,17.629,1827534,686263,1141271,5.834,15.537,246043,2.092,31.074,48312,49277,460598,
2008,81,614867,678758,5444243,5415355,57161,8.418,57757,8.505,787600,232449,555151,4.292,14.544,727828,229927,497901,4.246,13.44,59772,1.104,26.88,40408,41214,152104,
2009,11,17459,18159,149397,155868,1790,9.636,2624,14.126,20014,6402,13612,4.107,12.84,32776,10485,22291,6.727,21.028,-12762,-8.188,25.681,1794,1794,7299,
2009,21,18688,24800,603079,616251,2594,10.497,2418,9.785,88639,28363,60276,4.603,14.384,115248,31282,83966,5.076,18.701,-26609,-4.318,28.767,1440,1471,13876,
2009,22,5353,16846,644569,639561,1298,7.804,872,5.243,66390,23280,43110,3.64,10.381,56879,15487,41392,2.422,8.893,9511,1.487,17.787,235,322,5237,
2009,23,598446,610640,5946992,6484615,63745,9.917,128049,19.921,856537,262283,594254,4.045,13.209,1931447,482663,1448784,7.443,29.785,-1074910,-16.576,26.418,88343,88414,337290,
2009,31-33,250437,293145,11602987,12283989,16635,5.563,28357,9.484,813474,237132,576342,1.93,6.622,2178968,464459,1714509,3.781,17.738,-1365494,-11.116,13.244,20081,20275,198869,
2009,42,290741,392369,5846457,6010123,30014,7.559,39358,9.913,655212,200972,454240,3.344,10.902,980562,283751,696811,4.721,16.315,-325350,-5.413,21.804,25506,26224,141723,
2009,44-45,609473,1010423,14742317,15167638,77996,7.627,102444,10.018,1432485,597404,835081,3.939,9.444,2289339,671591,1617748,4.428,15.094,-856854,-5.649,18.889,66958,70988,378246,
2009,48-49,143155,189147,4162229,4308445,22232,11.578,27967,14.565,450958,178571,272387,4.145,10.467,747778,214502,533276,4.979,17.356,-296820,-6.889,20.934,18439,18821,110964,
2009,51,61266,125419,3297395,3373477,16604,13.019,20833,16.335,428193,186635,241558,5.532,12.693,581302,195197,386105,5.786,17.232,-153109,-4.539,25.386,6632,6875,56130,
2009,52,217703,455179,6172134,6291060,41171,8.912,54746,11.851,781188,319505,461683,5.079,12.417,1018547,323517,695030,5.142,16.19,-237359,-3.773,24.835,24125,25710,107320,
2009,53,226718,307229,2020169,2094377,32323,10.279,46748,14.867,297114,129660,167454,6.191,14.186,446003,174012,271991,8.309,21.295,-148889,-7.109,28.373,29096,29524,95728,
2009,54,648284,729517,7821233,7897666,84286,11.491,92262,12.578,1204035,470682,733353,5.96,15.245,1356865,436450,920415,5.526,17.181,-152830,-1.935,30.491,62439,62961,254592,
2009,55,26711,50488,2828675,2865818,4370,8.639,4559,9.013,409868,141013,268855,4.921,14.302,484223,129388,354835,4.515,16.897,-74355,-2.595,28.604,995,1126,18520,
2009,56,274056,333152,8623023,9163815,40934,12.156,48085,14.28,1359137,477791,881346,5.214,14.832,2448426,610894,1837532,6.666,26.718,-1089289,-11.887,29.663,29605,29992,321980,
2009,61,70392,80419,3188287,3151452,8239,10.3,7376,9.221,280767,55611,225156,1.765,8.909,207990,53552,154438,1.699,6.6,72777,2.309,13.2,5278,5339,37381,
2009,62,577878,752256,17486864,17338022,60616,8.113,50316,6.735,1795499,527538,1267961,3.043,10.356,1492908,485318,1007590,2.799,8.611,302591,1.745,17.221,33352,34271,296288,
2009,71,90983,100138,2011304,2041779,11456,11.358,12897,12.787,244454,82352,162102,4.033,11.973,306485,82683,223802,4.05,15.011,-62031,-3.038,23.945,9386,9444,62531,
2009,72,419389,579905,11443547,11685089,65868,11.372,64483,11.133,1612542,848436,764106,7.261,13.8,2095572,680967,1414605,5.828,17.934,-483030,-4.134,27.6,48685,49921,463768,
2009,81,611957,674838,5256646,5349749,51203,7.552,57591,8.494,616024,192469,423555,3.598,11.515,802682,222756,579926,4.164,15.004,-186658,-3.489,23.03,40477,41420,152116,
2010,11,17235,17926,151400,149620,1950,10.817,2152,11.938,26882,7790,19092,5.207,17.967,23393,7931,15462,5.301,15.635,3489,2.332,31.27,1408,1412,5726,
2010,21,18412,24634,587267,597227,2326,9.387,2615,10.554,87620,32253,55367,5.4,14.671,107730,26834,80896,4.493,18.038,-20110,-3.367,29.342,1575,1587,12160,
2010,22,5423,17223,640413,640905,1115,6.562,650,3.826,41461,14845,26616,2.316,6.469,42268,9893,32375,1.544,6.595,-807,-0.126,12.938,180,182,1269,
2010,23,559293,571794,5351265,5646466,69690,11.796,107697,18.229,903005,289436,613569,5.126,15.992,1495984,388060,1107924,6.873,26.494,-592979,-10.502,31.985,69522,69642,257259,
2010,31-33,241608,283018,10863056,11220247,16440,5.705,26696,9.265,832852,202586,630266,1.806,7.423,1546648,399345,1147303,3.559,13.784,-713796,-6.362,14.846,18375,18512,155522,
2010,42,284143,386642,5615998,5720280,31037,7.972,36373,9.343,630159,214095,416064,3.743,11.016,837228,244600,592628,4.276,14.636,-207069,-3.62,22.032,23336,24121,124025,
2010,44-45,598846,996812,14459150,14596332,75814,7.556,88854,8.856,1433807,501876,931931,3.438,9.823,1701031,519719,1181312,3.561,11.654,-267224,-1.831,19.646,56760,61534,315571,
2010,48-49,139664,185566,4020726,4094952,21086,11.247,24908,13.286,464915,153711,311204,3.754,11.353,611076,196839,414237,4.807,14.923,-146161,-3.569,22.707,15824,16108,78021,
2010,51,60158,125148,3177823,3232068,13268,10.591,13526,10.797,369238,152360,216878,4.714,11.424,477758,127340,350418,3.94,14.782,-108520,-3.358,22.848,6008,6138,39364,
2010,52,213621,447674,5967403,6073691,39730,8.804,46974,10.409,775898,292679,483219,4.819,12.775,985182,303734,681448,5.001,16.22,-209284,-3.446,25.549,18619,19812,80239,
2010,53,223914,303375,1935828,1973268,34426,11.28,38090,12.48,291997,136566,155431,6.921,14.798,366970,158966,208004,8.056,18.597,-74973,-3.799,29.595,21818,22262,68454,
2010,54,644437,729072,7746896,7792064,87163,11.947,88149,12.082,1179776,454828,724948,5.837,15.141,1270333,419844,850489,5.388,16.303,-90557,-1.162,30.281,57210,57802,214224,
2010,55,26894,50329,2852467,2855853,4129,8.164,4621,9.137,397045,126732,270313,4.438,13.903,402898,110894,292004,3.883,14.108,-5853,-0.205,27.806,912,985,15507,
2010,56,270880,329013,8642613,8643620,40349,12.181,44793,13.523,1633220,459693,1173527,5.318,18.895,1635638,511576,1124062,5.919,18.923,-2418,-0.028,37.79,26944,27502,252191,
2010,61,70976,81653,3266261,3227623,8789,10.852,7456,9.206,293858,72855,221003,2.257,9.104,216577,49520,167057,1.534,6.71,77281,2.394,13.42,5163,5219,32644,
2010,62,583979,767954,17745832,17618448,63071,8.296,47768,6.283,1706142,584382,1121760,3.317,9.684,1449393,374043,1075350,2.123,8.227,256749,1.457,16.453,31743,32642,216712,
2010,71,89987,99446,1996484,2005284,11218,11.248,11785,11.817,243961,91894,152067,4.583,12.166,262637,74813,187824,3.731,13.097,-18676,-0.931,24.332,8379,8459,54664,
2010,72,425044,587621,11304835,11379290,63877,10.939,56525,9.68,1507502,774384,733118,6.805,13.248,1647588,539755,1107833,4.743,14.479,-140086,-1.231,26.496,42133,43215,366219,
2010,81,612304,675598,5194403,5222512,52231,7.731,52216,7.729,624134,205908,418226,3.943,11.951,680094,192133,487961,3.679,13.022,-55960,-1.072,23.902,35971,36387,122934,
2011,11,17126,17829,153574,152773,2027,11.329,2152,12.028,24279,7464,16815,4.886,15.892,22633,7362,15271,4.819,14.815,1646,1.077,29.63,1475,1475,5158,
2011,21,18801,25250,649010,618671,2807,11.255,2189,8.777,133982,33526,100456,5.419,21.656,72528,20915,51613,3.381,11.723,61454,9.933,23.446,1399,1422,10291,
2011,22,5438,17181,642482,642948,992,5.762,1065,6.186,48095,17619,30476,2.74,7.48,49246,16664,32582,2.592,7.659,-1151,-0.179,14.961,196,204,1025,
2011,23,541536,554157,5173536,5266282,74045,13.148,92031,16.342,972701,260380,712321,4.944,18.47,1156596,329475,827121,6.256,21.962,-183895,-3.492,36.941,59049,59202,219349,
2011,31-33,238643,279488,10947053,10884643,18105,6.433,22015,7.822,1064882,193808,871074,1.781,9.783,940499,283617,656882,2.606,8.641,124383,1.143,17.281,15610,15781,130365,
2011,42,281691,386907,5651006,5634209,32324,8.351,32670,8.44,690002,208729,481273,3.705,12.247,655531,228039,427492,4.047,11.635,34471,0.612,23.27,21479,22117,107074,
2011,44-45,591979,996613,14651246,14553584,82727,8.303,82241,8.254,1629545,535130,1094415,3.677,11.197,1432624,435254,997370,2.991,9.844,196921,1.353,19.688,54470,57061,234535,
2011,48-49,142491,188028,4118794,4067157,25470,13.649,22623,12.124,531935,163202,368733,4.013,13.079,424502,145035,279467,3.566,10.437,107433,2.641,20.875,14652,14844,65476,
2011,51,59864,125287,3155404,3170613,16707,13.343,16549,13.217,468079,196912,271167,6.211,14.763,497123,202697,294426,6.393,15.679,-29044,-0.916,29.526,5636,5888,39656,
2011,52,210366,440998,5897872,5930365,37699,8.482,44617,10.039,743748,247445,496303,4.173,12.541,811681,297707,513974,5.02,13.687,-67933,-1.146,25.083,17471,18375,70299,
2011,53,220778,299263,1906292,1920963,34820,11.567,38366,12.745,290055,126370,163685,6.578,15.099,320973,154507,166466,8.043,16.709,-30918,-1.61,30.199,21160,24527,82546,
2011,54,645832,733167,7877430,7822111,89688,12.268,85519,11.698,1267521,404588,862933,5.172,16.204,1161026,409200,751826,5.231,14.843,106495,1.361,29.686,56579,57161,208230,
2011,55,26596,50738,2964172,2916847,4305,8.521,3871,7.662,474271,146351,327920,5.017,16.26,378298,95882,282416,3.287,12.969,95973,3.29,25.939,851,885,12882,
2011,56,270494,329450,9092420,8869111,41895,12.727,41338,12.558,1875768,410846,1464922,4.632,21.149,1418194,467655,950539,5.273,15.99,457574,5.159,31.981,25522,25877,224764,
2011,61,72385,83472,3387332,3327257,9072,10.982,7337,8.882,342125,81548,260577,2.451,10.282,221090,47787,173303,1.436,6.645,121035,3.638,13.29,5033,5090,28441,
2011,62,587320,776740,18010911,17867659,59798,7.745,50569,6.549,1699428,497557,1201871,2.785,9.511,1413459,417325,996134,2.336,7.911,285969,1.6,15.821,33679,34774,242559,
2011,71,89853,99498,1996762,1997583,11629,11.699,11442,11.511,251911,84220,167691,4.216,12.611,254373,72771,181602,3.643,12.734,-2462,-0.123,25.222,8141,8213,50248,
2011,72,430093,594887,11556444,11442439,63024,10.658,55932,9.459,1615456,764151,851305,6.678,14.118,1384065,505164,878901,4.415,12.096,231391,2.022,24.192,42905,44029,364817,
2011,81,611935,675373,5183975,5190918,53064,7.856,53295,7.89,637494,196285,441209,3.781,12.281,653002,184347,468655,3.551,12.58,-15508,-0.299,24.562,36997,37541,124061,
2012,11,17372,18058,156505,155649,2013,11.207,1821,10.138,25084,7309,17775,4.696,16.116,23462,7071,16391,4.543,15.074,1622,1.042,30.147,1254,1257,4707,
2012,21,19600,26299,728949,689920,3003,11.607,2149,8.306,155795,40193,115602,5.826,22.582,78719,26073,52646,3.779,11.41,77076,11.172,22.82,1294,1322,11865,
2012,22,5486,17343,643059,643160,932,5.396,787,4.557,45910,14972,30938,2.328,7.138,46399,9434,36965,1.467,7.214,-489,-0.076,14.276,198,205,1752,
2012,23,545556,557594,5304694,5234994,76623,13.783,73292,13.184,1061092,261739,799353,5,20.269,921156,294148,627008,5.619,17.596,139936,2.673,35.192,46874,47049,192123,
2012,31-33,239661,280346,11190179,11090245,18317,6.518,19649,6.992,1103313,199947,903366,1.803,9.948,902211,267082,635129,2.408,8.135,201102,1.813,16.27,13740,13881,132511,
2012,42,283693,388012,5776002,5726630,31293,8.043,33400,8.585,793847,201844,592003,3.525,13.862,693000,224767,468233,3.925,12.101,100847,1.761,24.203,19395,20051,102915,
2012,44-45,589983,990633,14765536,14660451,82134,8.293,81716,8.251,1725841,541138,1184703,3.691,11.772,1514394,475269,1039125,3.242,10.33,211447,1.442,20.66,49814,52694,234557,
2012,48-49,145720,191229,4227898,4180454,24568,12.959,21269,11.219,527751,155681,372070,3.724,12.624,431397,141081,290316,3.375,10.319,96354,2.305,20.639,13898,14102,69139,
2012,51,61208,126065,3256483,3237503,14695,11.61,15699,12.404,504025,164448,339577,5.079,15.568,470988,177712,293276,5.489,14.548,33037,1.02,29.096,5291,5518,36146,
2012,52,210049,443801,6039875,5981670,42434,9.593,39523,8.935,845049,282085,562964,4.716,14.127,730118,244577,485541,4.089,12.206,114931,1.921,24.412,14887,15608,58750,
2012,53,224009,302552,1902856,1898705,36352,12.059,34150,11.329,348617,154162,194455,8.119,18.361,338507,130276,208231,6.861,17.828,10110,0.532,35.657,18311,19115,59960,
2012,54,652989,737843,7947964,7906813,88636,12.066,82162,11.184,1312237,435078,877159,5.503,16.596,1228739,476552,752187,6.027,15.54,83498,1.056,31.081,52508,53109,213795,
2012,55,26065,51553,3079184,3048884,4819,9.373,4539,8.829,488043,123156,364887,4.039,16.007,426527,119516,307011,3.92,13.99,61516,2.018,27.979,818,863,11297,
2012,56,276013,333921,9467333,9257888,41543,12.53,36815,11.104,1764608,402799,1361809,4.351,19.061,1344609,456949,887660,4.936,14.524,419999,4.537,29.048,23033,23555,239638,
2012,61,74709,85952,3460940,3420343,9292,10.957,6993,8.246,314719,65512,249207,1.915,9.201,232311,52755,179556,1.542,6.792,82408,2.409,13.584,4706,4757,28252,
2012,62,590809,781998,18293464,18126474,60359,7.746,54796,7.032,1939984,529776,1410208,2.923,10.702,1608779,467266,1141513,2.578,8.875,331205,1.827,17.751,33911,36431,274645,
2012,71,91035,100863,2066244,2024267,12289,12.282,10677,10.671,298451,95151,203300,4.701,14.744,214439,67285,147154,3.324,10.593,84012,4.15,21.187,7337,7407,45482,
2012,72,438500,602295,11990626,11801518,65830,10.992,58974,9.848,1855820,814841,1040979,6.905,15.725,1473925,575350,898575,4.875,12.489,381895,3.236,24.979,41335,42552,373512,
2012,81,617374,679771,5228330,5192954,55017,8.129,49055,7.248,683393,209146,474247,4.027,13.16,611566,186081,425485,3.583,11.777,71827,1.383,23.554,33069,33730,117363,
2013,11,17361,18058,153926,154403,1964,10.869,1988,11.002,22970,7301,15669,4.729,14.877,24003,9879,14124,6.398,15.546,-1033,-0.669,29.753,1377,1377,7503,
2013,21,19418,26093,728363,725145,2676,10.276,2573,9.88,115322,34143,81179,4.708,15.903,109030,38828,70202,5.355,15.036,6292,0.868,30.071,1556,1590,13098,
2013,22,5521,17440,636082,638729,993,5.711,891,5.124,46312,17082,29230,2.674,7.251,51597,12479,39118,1.954,8.078,-5285,-0.827,14.501,208,217,2063,
2013,23,545292,557409,5463152,5383206,70923,12.721,71141,12.76,1053399,256406,796993,4.763,19.568,893482,269368,624114,5.004,16.598,159917,2.971,33.195,45163,45273,182175,
2013,31-33,235063,275300,11247298,11200369,16848,6.092,19399,7.014,992975,187987,804988,1.678,8.866,901128,265661,635467,2.372,8.046,91847,0.82,16.091,13885,14007,128073,
2013,42,282381,387965,5894975,5840630,31115,8.014,31674,8.158,785976,240624,545352,4.12,13.457,676255,226276,449979,3.874,11.578,109721,1.879,23.157,20127,20631,107872,
2013,44-45,589380,994886,15015088,14898826,79439,7.997,76371,7.688,1646468,524225,1122243,3.519,11.051,1408571,432282,976289,2.901,9.454,237897,1.597,18.908,50015,52122,221246,
2013,48-49,147343,193063,4292750,4259986,23632,12.29,22066,11.476,562974,158159,404815,3.713,13.215,499186,196652,302534,4.616,11.718,63788,1.497,23.436,14031,14201,70510,
2013,51,61176,124258,3276772,3250440,14598,11.726,15071,12.106,519367,197995,321372,6.091,15.978,469595,194938,274657,5.997,14.447,49772,1.531,28.894,5767,5982,50056,
2013,52,210395,438641,6056870,6040671,35492,8.048,40193,9.114,764892,222371,542521,3.681,12.662,733586,271003,462583,4.486,12.144,31306,0.518,24.288,14388,14910,71529,
2013,53,229359,309280,1956728,1931988,37834,12.38,30494,9.978,337257,142549,194708,7.378,17.456,287744,117773,169971,6.096,14.894,49513,2.563,29.787,17599,17992,59445,
2013,54,660457,748061,8188265,8043381,91828,12.352,82610,11.112,1422242,546776,875466,6.798,17.682,1133679,416543,717136,5.179,14.095,288563,3.588,28.189,53124,53460,215298,
2013,55,26001,51830,3161257,3147636,3957,7.651,3741,7.233,492380,154231,338149,4.9,15.643,468834,131675,337159,4.183,14.895,23546,0.748,29.79,647,668,7803,
2013,56,275527,338880,9978488,9802109,44379,13.198,39153,11.643,1784612,451148,1333464,4.603,18.206,1428292,440428,987864,4.493,14.571,356320,3.635,29.143,23862,24107,223085,
2013,61,76906,88397,3511328,3491134,9215,10.54,7271,8.317,288079,64065,224014,1.835,8.252,246596,54434,192162,1.559,7.063,41483,1.188,14.127,4999,5129,36675,
2013,62,594125,789507,18450457,18350706,62505,7.956,54688,6.961,1849531,527244,1322287,2.873,10.079,1651752,483119,1168633,2.633,9.001,197779,1.078,18.002,35802,36601,280436,
2013,71,92343,102199,2112731,2089266,12082,11.898,10783,10.618,280765,99265,181500,4.751,13.438,233152,69614,163538,3.332,11.16,47613,2.279,22.319,7455,7483,46022,
2013,72,445508,613251,12386457,12190475,68251,11.227,57638,9.481,1932880,875622,1057258,7.183,15.856,1535753,610618,925135,5.009,12.598,397127,3.258,25.196,42215,43256,376419,
2013,81,621117,683058,5273495,5261103,53524,7.852,50644,7.43,651384,206100,445284,3.917,12.381,624756,199530,425226,3.793,11.875,26628,0.506,23.75,34422,34811,119782,
2014,11,17454,18134,155336,153684,1976,10.925,1881,10.4,24065,7567,16498,4.924,15.659,20699,7524,13175,4.896,13.469,3366,2.19,26.937,1311,1312,5820,
2014,21,19931,26841,754896,742712,2846,10.702,2348,8.83,128693,41300,87393,5.561,17.327,103828,36233,67595,4.878,13.98,24865,3.348,27.959,1479,1510,14189,
2014,22,5551,17538,634898,635629,861,4.924,758,4.335,44732,10276,34456,1.617,7.037,45885,11184,34701,1.76,7.219,-1153,-0.181,14.075,187,198,1288,
2014,23,552782,565506,5701036,5578057,73043,13.013,64657,11.519,1100857,290208,810649,5.203,19.735,854422,250438,603984,4.49,15.318,246435,4.418,30.635,41688,41760,157783,
2014,31-33,235238,275956,11376445,11318424,17556,6.353,18329,6.633,1039090,219345,819745,1.938,9.181,920361,261609,658752,2.311,8.132,118729,1.049,16.263,13253,13342,117956,
2014,42,280838,387147,5962258,5918358,29669,7.656,30451,7.858,708276,179894,528382,3.04,11.967,619555,219838,399717,3.715,10.468,88721,1.499,20.937,19368,19882,101134,
2014,44-45,588543,996224,15398014,15201119,78782,7.918,76162,7.655,1634509,560449,1074060,3.687,10.753,1248391,389382,859009,2.562,8.212,386118,2.54,16.425,49723,51813,211462,
2014,48-49,149426,196496,4413786,4355021,24283,12.461,21026,10.79,554380,167551,386829,3.847,12.73,437560,148911,288649,3.419,10.047,116820,2.682,20.095,14067,14262,68236,
2014,51,62470,128461,3347897,3318878,18101,14.306,14228,11.245,529627,186353,343274,5.615,15.958,470139,152766,317373,4.603,14.166,59488,1.792,28.331,5381,5505,35116,
2014,52,211267,443203,6076719,6087045,38307,8.687,33846,7.675,752227,272451,479776,4.476,12.358,776530,238937,537593,3.925,12.757,-24303,-0.399,24.716,14164,14638,54577,
2014,53,234119,317145,2010588,1980911,38090,12.159,30322,9.679,343935,142746,201189,7.206,17.362,282996,124507,158489,6.285,14.286,60939,3.076,28.572,17823,18233,59395,
2014,54,667536,759852,8442976,8334528,93877,12.445,82786,10.975,1363736,472272,891464,5.666,16.362,1145214,401349,743865,4.815,13.741,218522,2.622,27.481,53797,54406,198693,
2014,55,26231,52420,3255502,3253500,4219,8.058,4094,7.819,447916,134108,313808,4.122,13.767,438582,149159,289423,4.585,13.48,9334,0.287,26.961,693,722,11133,
2014,56,276833,342917,10261731,10045875,42700,12.546,37534,11.029,1961950,504966,1456984,5.027,19.53,1538434,517473,1020961,5.151,15.314,423516,4.216,30.628,23032,23333,215587,
2014,61,78125,89663,3560046,3532268,9014,10.131,7631,8.577,315698,86350,229348,2.445,8.938,258273,60865,197408,1.723,7.312,57425,1.626,14.624,5166,5238,36967,
2014,62,597415,802167,18693150,18548816,67302,8.454,55236,6.938,1825410,596523,1228887,3.216,9.841,1532915,465116,1067799,2.508,8.264,292495,1.577,16.528,37024,38262,273637,
2014,71,93719,104217,2167942,2133976,12639,12.241,10703,10.366,291670,103023,188647,4.828,13.668,222410,73414,148996,3.44,10.422,69260,3.246,20.845,7606,7690,52466,
2014,72,450661,620524,12784522,12595831,65343,10.593,58040,9.409,1890441,864891,1025550,6.866,15.008,1511500,575459,936041,4.569,12,378941,3.008,24,43820,44944,397854,
2014,81,623983,689038,5335568,5303063,54226,7.904,48210,7.027,651671,226147,425524,4.264,12.289,585979,175663,410316,3.312,11.05,65692,1.239,22.1,34958,35339,121927,
2015,11,17746,18418,159179,156738,2169,11.924,1714,9.423,26128,8266,17862,5.274,16.67,21304,6704,14600,4.277,13.592,4824,3.078,27.184,1181,1183,5245,
2015,21,19781,26874,743417,751121,2791,10.388,2779,10.343,108691,40255,68436,5.359,14.471,124947,35819,89128,4.769,16.635,-16256,-2.164,28.941,1810,1826,15025,
2015,22,5540,17528,641202,638769,920,5.246,940,5.36,48689,11669,37020,1.827,7.622,43898,9473,34425,1.483,6.872,4791,0.75,13.745,223,225,1019,
2015,23,566526,579822,6009371,5856638,75356,13.156,61245,10.693,1152059,302542,849517,5.166,19.671,847658,244031,603627,4.167,14.473,304401,5.198,28.947,40378,40436,157239,
2015,31-33,234733,276154,11565104,11464810,18159,6.576,18174,6.581,1083388,231829,851559,2.022,9.45,881895,246184,635711,2.147,7.692,201493,1.757,15.384,13419,13512,121890,
2015,42,278527,385413,6056155,6006647,29272,7.577,31072,8.043,715945,201616,514329,3.357,11.919,614010,221615,392395,3.689,10.222,101935,1.697,20.444,19853,20349,103046,
2015,44-45,587439,1000563,15725443,15541552,79406,7.956,74385,7.453,1721841,652107,1069734,4.196,11.079,1356460,434369,922091,2.795,8.728,365381,2.351,17.456,49993,52903,232182,
2015,48-49,153875,203034,4602153,4509887,27776,13.9,21368,10.693,652799,208920,443879,4.632,14.475,467934,176347,291587,3.91,10.376,184865,4.099,20.751,13965,14148,66645,
2015,51,63249,129279,3399175,3375040,13964,10.826,13380,10.373,475632,136458,339174,4.043,14.093,425247,135620,289627,4.018,12.6,50385,1.493,25.2,5768,6059,47273,
2015,52,212464,442038,6106196,6081658,38750,8.755,39852,9.004,805186,245924,559262,4.044,13.24,753538,231738,521800,3.81,12.39,51648,0.849,24.781,14267,14909,59093,
2015,53,239640,324893,2058538,2036226,38317,11.937,30502,9.503,323734,131669,192065,6.466,15.899,279308,121590,157718,5.971,13.717,44426,2.182,27.434,18503,18988,64620,
2015,54,673647,770877,8656945,8533752,94073,12.293,82876,10.83,1439521,519601,919920,6.089,16.869,1189726,415042,774684,4.864,13.941,249795,2.927,27.883,55464,55967,214716,
2015,55,26666,53070,3355890,3313588,4532,8.594,3866,7.331,505061,158858,346203,4.794,15.242,419616,92519,327097,2.792,12.663,85445,2.579,25.327,688,724,11301,
2015,56,279692,346609,10670975,10496374,43561,12.639,39647,11.503,1807723,455791,1351932,4.342,17.222,1460534,516406,944128,4.92,13.915,347189,3.308,27.829,22884,23138,228515,
2015,61,80012,91911,3636599,3596491,9867,10.858,7792,8.575,303742,63225,240517,1.758,8.446,224151,55080,169071,1.531,6.232,79591,2.213,12.465,5278,5490,33102,
2015,62,599354,820231,19124126,18919831,75194,9.268,57472,7.083,2140740,747256,1393484,3.95,11.315,1728868,499306,1229562,2.639,9.138,411872,2.177,18.276,38576,39589,276629,
2015,71,95841,106779,2233171,2196773,13333,12.633,10853,10.283,292256,100413,191843,4.571,13.304,218848,75105,143743,3.419,9.962,73408,3.342,19.924,7611,7676,52916,
2015,72,456067,627117,13206452,12993616,66132,10.601,59598,9.553,2061167,959680,1101487,7.386,15.863,1637661,660043,977618,5.08,12.604,423506,3.259,25.207,42918,44197,438257,
2015,81,627892,692691,5409104,5377614,54960,7.956,51137,7.403,651043,210761,440282,3.919,12.107,588090,199248,388842,3.705,10.936,62953,1.171,21.872,35108,35626,122109,
2016,11,18142,18870,159723,159489,2265,12.13,1871,10.02,24556,9447,15109,5.923,15.397,24291,8115,16176,5.088,15.231,265,0.166,30.461,1339,1339,5764,
2016,21,18049,24976,585089,664274,1944,7.5,3832,14.784,53885,25923,27962,3.902,8.112,211704,42640,169064,6.419,31.87,-157819,-23.758,16.224,2427,2458,19012,
2016,22,5532,17799,644137,642080,1073,6.084,747,4.236,44339,13209,31130,2.057,6.906,40271,8481,31790,1.321,6.272,4068,0.634,12.544,251,257,1449,
2016,23,584191,598000,6318530,6162058,78417,13.325,59403,10.094,1168409,298294,870115,4.841,18.961,855046,243605,611441,3.953,13.876,313363,5.085,27.752,40567,40633,163840,
2016,31-33,233931,276150,11575830,11569645,18033,6.528,18195,6.587,981468,198733,782735,1.718,8.483,966951,236767,730184,2.046,8.358,14517,0.125,16.715,13669,13777,121893,
2016,42,275504,384685,6134261,6109708,28843,7.487,29925,7.768,693807,206640,487167,3.382,11.356,643655,214458,429197,3.51,10.535,50152,0.821,21.07,20100,20711,108658,
2016,44-45,588626,1007004,15980403,15851594,81203,8.095,73447,7.322,1724439,583676,1140763,3.682,10.879,1471407,460635,1010772,2.906,9.282,253032,1.596,18.565,48820,52133,233822,
2016,48-49,156820,207448,4731510,4667801,26989,13.146,22692,11.053,617787,194412,423375,4.165,13.235,491893,190447,301446,4.08,10.538,125894,2.697,21.076,15464,15719,106952,
2016,51,64899,135535,3415909,3388787,17461,13.17,11555,8.715,464563,180668,283895,5.331,13.709,409878,141824,268054,4.185,12.095,54685,1.614,24.19,5801,6039,40587,
2016,52,213227,452311,6342784,6220416,42918,9.598,32615,7.294,891677,297115,594562,4.776,14.335,649193,178109,471084,2.863,10.436,242484,3.898,20.873,14653,15307,62927,
2016,53,245916,335842,2102090,2074399,41973,12.707,30914,9.359,344862,155535,189327,7.498,16.625,290707,115722,174985,5.579,14.014,54155,2.611,28.028,19177,19522,66630,
2016,54,680022,782399,8810351,8694304,94146,12.121,82771,10.657,1319460,454819,864641,5.231,15.176,1088385,379492,708893,4.365,12.518,231075,2.658,25.037,57572,58158,228023,
2016,55,26881,54465,3394250,3378513,5060,9.418,3586,6.674,462147,132610,329537,3.925,13.679,432819,100141,332678,2.964,12.811,29328,0.868,25.622,704,741,12684,
2016,56,287236,358424,10988863,10890563,45895,13.005,34839,9.872,1876029,520695,1355334,4.781,17.226,1672327,491165,1181162,4.51,15.356,203702,1.87,30.711,23031,23247,238330,
2016,61,81693,93493,3662202,3639913,9695,10.471,7890,8.521,300498,66600,233898,1.83,8.256,254643,67503,187140,1.855,6.996,45855,1.26,13.992,5362,5554,45153,
2016,62,603949,837214,19629516,19379188,72727,8.774,56062,6.764,2076861,625784,1451077,3.229,10.717,1575743,480818,1094925,2.481,8.131,501118,2.586,16.262,39206,40348,290660,
2016,71,98940,110384,2313374,2270465,14443,13.297,10919,10.052,308995,101290,207705,4.461,13.609,221111,74886,146225,3.298,9.739,87884,3.871,19.477,7900,7963,54558,
2016,72,467011,645623,13711576,13467172,71369,11.213,53087,8.341,2082781,1023771,1059010,7.602,15.466,1599625,591114,1008511,4.389,11.878,483156,3.588,23.756,40968,42062,418933,
2016,81,635919,701735,5499758,5449764,57934,8.308,49118,7.044,684026,223118,460908,4.094,12.551,584443,192613,391830,3.534,10.724,99583,1.827,21.448,35855,36311,129524,
2017,11,18279,18995,161860,160275,2115,11.17,1993,10.526,27692,8832,18860,5.511,17.278,24438,8290,16148,5.172,15.248,3254,2.03,30.495,1405,1405,5626,
2017,21,16735,23650,582247,580556,2414,10.015,3320,13.774,105290,37397,67893,6.442,18.136,103128,40904,62224,7.046,17.764,2162,0.372,35.527,1964,2029,15806,
2017,22,5515,18009,646949,647170,1101,6.137,962,5.362,51245,18850,32395,2.913,7.918,51660,11563,40097,1.787,7.982,-415,-0.064,15.837,222,226,1404,
2017,23,597314,611362,6539460,6434246,76444,12.638,63461,10.492,1121593,279685,841908,4.347,17.432,911148,259118,652030,4.027,14.161,210445,3.271,28.322,43428,43494,172642,
2017,31-33,231565,274321,11713052,11659968,17545,6.373,19488,7.079,1117068,219171,897897,1.88,9.58,1013180,306591,706589,2.629,8.689,103888,0.891,17.379,13963,14111,145534,
2017,42,269294,379114,6114811,6097959,27366,7.181,31318,8.218,764004,201762,562242,3.309,12.529,729828,261607,468221,4.29,11.968,34176,0.56,23.937,19936,20576,115035,
2017,44-45,585997,995168,15706455,15727604,75530,7.561,83125,8.321,1705119,524881,1180238,3.337,10.842,1743052,573926,1169126,3.649,11.083,-37933,-0.241,21.683,49795,52370,238594,
2017,48-49,157805,208990,4866039,4795072,25139,12.059,24085,11.554,654200,204018,450182,4.255,13.643,507123,172460,334663,3.597,10.576,147077,3.067,21.152,16233,16494,76067,
2017,51,66847,139197,3467016,3503492,16392,11.734,17387,12.446,504398,160361,344037,4.577,14.397,578783,173160,405623,4.942,16.52,-74385,-2.123,28.794,6353,6667,53190,
2017,52,212596,446442,6404783,6383108,34779,7.743,40226,8.956,888815,312242,576573,4.892,13.924,845759,292356,553403,4.58,13.25,43056,0.675,26.5,14956,15601,66670,
2017,53,252067,347229,2148678,2125418,44465,13.022,32950,9.649,359717,143862,215855,6.769,16.925,310113,122888,187225,5.782,14.591,49604,2.334,29.181,20107,20733,69322,
2017,54,682892,784936,8873486,8773730,87786,11.211,83951,10.721,1296879,381652,915227,4.35,14.781,1096802,452223,644579,5.154,12.501,200077,2.28,25.002,57994,58635,251471,
2017,55,26623,55560,3529482,3447961,5506,9.997,4534,8.233,589163,175681,413482,5.095,17.087,428559,134294,294265,3.895,12.429,160604,4.658,24.859,795,823,15764,
2017,56,290170,362250,11269276,11139767,40515,11.22,38183,10.575,2063664,607231,1456433,5.451,18.525,1806026,601720,1204306,5.402,16.212,257638,2.313,32.425,24774,25143,257059,
2017,61,82828,94317,3702186,3686407,9690,10.345,8398,8.965,306838,65389,241449,1.774,8.323,274660,79262,195398,2.15,7.451,32178,0.873,14.901,5694,6157,53586,
2017,62,606506,843943,20135290,19881857,71641,8.52,65388,7.777,2387905,616466,1771439,3.101,12.01,1884261,644201,1240060,3.24,9.477,503644,2.533,18.955,40489,41961,330884,
2017,71,101224,113761,2377762,2348762,14960,13.348,11590,10.341,327225,110749,216476,4.715,13.932,268860,88052,180808,3.749,11.447,58365,2.485,22.894,8223,8266,57647,
2017,72,476017,661108,14102862,13912360,71318,10.908,56744,8.679,2219410,1021624,1197786,7.343,15.953,1843292,664158,1179134,4.774,13.249,376118,2.703,26.499,42026,43507,456538,
2017,81,639898,706229,5510206,5481263,57070,8.112,51694,7.348,696912,224105,472807,4.089,12.714,637318,201674,435644,3.679,11.627,59594,1.087,23.254,37782,38412,141916,
2018,11,18331,18993,162369,161989,2067,10.896,2022,10.659,24047,8577,15470,5.295,14.845,23222,7960,15262,4.914,14.336,825,0.509,28.671,1491,1491,5500,
2018,21,16764,23243,609086,597812,2142,9.126,2600,11.077,106820,21247,85573,3.554,17.869,82621,36120,46501,6.042,13.821,24199,4.048,27.641,1473,1537,11685,
2018,22,5565,18387,647708,648279,1931,10.606,1571,8.629,76810,39232,37578,6.052,11.848,77657,37147,40510,5.73,11.979,-847,-0.131,23.697,230,240,1109,
2018,23,611260,625412,6811601,6672425,78323,12.669,63985,10.349,1172300,303885,868415,4.554,17.569,893633,251404,642229,3.768,13.393,278667,4.176,26.786,45649,45738,177147,
2018,31-33,229180,273004,11876114,11787095,17819,6.519,18484,6.762,1103216,230563,872653,1.956,9.36,927701,236519,691182,2.007,7.87,175515,1.489,15.741,14057,14188,131663,
2018,42,265770,374139,6155123,6137197,24523,6.509,29740,7.894,668566,149000,519566,2.428,10.894,631519,205931,425588,3.355,10.29,37047,0.604,20.58,19605,20344,112460,
2018,44-45,580810,983728,15689303,15697902,67933,6.869,78337,7.921,1602036,461043,1140993,2.937,10.205,1625753,546429,1079324,3.481,10.356,-23717,-0.151,20.411,49879,53384,257294,
2018,48-49,162158,213261,5028124,4947177,26712,12.653,22415,10.618,640050,180691,459359,3.652,12.938,478144,153661,324483,3.106,9.665,161906,3.273,19.33,15513,15740,78638,
2018,51,67798,141903,3558673,3532212,15059,10.68,13256,9.401,500169,171536,328633,4.856,14.16,447223,139433,307790,3.947,12.661,52946,1.499,25.323,6514,7056,52330,
2018,52,212726,447063,6454980,6435484,36743,8.226,35945,8.047,861148,316981,544167,4.926,13.381,824603,262380,562223,4.077,12.813,36545,0.568,25.627,15531,16720,76793,
2018,53,259423,355224,2206203,2178453,41476,11.808,33549,9.551,355817,137965,217852,6.333,16.333,301226,124419,176807,5.711,13.828,54591,2.506,27.655,20598,21171,68318,
2018,54,687031,786261,9087108,8982362,86405,11.001,84718,10.786,1272777,367803,904974,4.095,14.17,1064152,407611,656541,4.538,11.847,208625,2.323,23.694,59264,60197,243270,
2018,55,25733,53897,3525854,3518153,2384,4.368,3739,6.851,452104,82546,369558,2.346,12.851,435366,133482,301884,3.794,12.375,16738,0.476,24.75,856,891,19112,
2018,56,293570,359550,11563558,11418688,39417,10.921,42160,11.681,1831351,446942,1384409,3.914,16.038,1530918,446421,1084497,3.91,13.407,300433,2.631,26.814,25043,25356,218959,
2018,61,84577,95883,3727871,3711579,9296,9.767,7878,8.277,291663,59144,232519,1.593,7.858,258004,67354,190650,1.815,6.951,33659,0.907,13.903,5710,5805,39898,
2018,62,601296,842869,20504153,20351970,66828,7.956,60975,7.259,2136869,639557,1497312,3.142,10.5,1830437,533006,1297431,2.619,8.994,306432,1.506,17.988,40893,42372,304506,
2018,71,104161,116883,2436405,2408047,14635,12.68,11713,10.148,317188,112363,204825,4.666,13.172,259552,79355,180197,3.295,10.779,57636,2.393,21.557,8584,8706,57137,
2018,72,483857,666312,14326035,14222522,65835,9.919,60693,9.144,2073655,886692,1186963,6.234,14.58,1873034,756427,1116607,5.319,13.169,200621,1.411,26.339,43948,46050,497462,
2018,81,643784,708493,5595128,5555999,55392,7.831,53038,7.498,700873,217992,482881,3.924,12.615,621360,201445,419915,3.626,11.184,79513,1.431,22.367,38588,39449,143706,
2019,11,18510,19188,164516,163779,2152,11.252,2028,10.603,24796,8295,16501,5.065,15.14,23331,6969,16362,4.255,14.245,1465,0.895,28.491,1608,1608,5645,
2019,21,16667,23061,627913,616543,2138,9.267,2159,9.358,93339,24292,69047,3.94,15.139,70617,23077,47540,3.743,11.454,22722,3.685,22.907,1442,1503,11151,
2019,22,5653,18486,641852,644565,928,5.033,835,4.528,38878,13664,25214,2.12,6.032,44712,13735,30977,2.131,6.937,-5834,-0.905,12.063,226,229,1522,
2019,23,626150,640590,7051032,6933887,81278,12.836,66462,10.497,1162950,303798,859152,4.381,16.772,930446,255954,674492,3.691,13.419,232504,3.353,26.838,50601,50706,193745,
2019,31-33,227736,271567,12084817,11983812,16758,6.148,18788,6.893,1085553,214623,870930,1.791,9.058,881691,248016,633675,2.07,7.357,203862,1.701,14.715,14473,14622,128111,
2019,42,261418,370703,6180511,6167483,24183,6.492,27814,7.466,631430,161025,470405,2.611,10.238,604951,200090,404861,3.244,9.809,26479,0.429,19.617,20218,20749,111281,
2019,44-45,577029,980720,15751131,15719096,67745,6.9,70065,7.136,1458495,458706,999789,2.918,9.278,1406124,477928,928196,3.04,8.945,52371,0.333,17.891,50490,52852,260969,
2019,48-49,168070,220104,5488917,5260947,28976,13.366,22341,10.306,881379,203684,677695,3.872,16.753,430561,136327,294234,2.591,8.184,450818,8.569,16.368,16911,17178,84262,
2019,51,69070,144279,3535895,3548146,16492,11.521,14222,9.935,480553,155261,325292,4.376,13.544,504756,140102,364654,3.949,14.226,-24203,-0.682,27.088,6943,7269,45955,
2019,52,212135,445988,6543541,6508489,35329,7.915,36105,8.088,801844,274489,527355,4.217,12.32,729666,241973,487693,3.718,11.211,72178,1.109,22.422,16336,16969,68742,
2019,53,265515,361754,2241573,2222583,41225,11.499,34728,9.687,331128,137436,193692,6.184,14.898,295352,121914,173438,5.485,13.289,35776,1.61,26.577,22427,22991,71158,
2019,54,693986,794358,9254196,9174996,90198,11.411,82427,10.428,1241102,372727,868375,4.062,13.527,1087545,400435,687110,4.364,11.853,153557,1.674,23.707,62339,62978,243728,
2019,55,25201,52524,3514586,3529398,2022,3.802,3336,6.273,381036,64965,316071,1.841,10.796,414780,112815,301965,3.196,11.752,-33744,-0.956,21.592,797,832,12278,
2019,56,297639,365864,11747781,11690632,43453,11.981,37108,10.231,1789720,475446,1314274,4.067,15.309,1693517,501804,1191713,4.292,14.486,96203,0.823,28.972,26368,26677,212590,
2019,61,86267,97286,3805582,3774984,9713,10.05,8427,8.72,294648,69935,224713,1.853,7.805,233882,64231,169651,1.701,6.196,60766,1.61,12.391,6177,6362,44901,
2019,62,605415,854598,20848219,20655581,71846,8.467,59707,7.037,2078609,643750,1434859,3.117,10.063,1698436,549792,1148644,2.662,8.223,380173,1.841,16.445,41534,43051,318882,
2019,71,107164,120245,2474837,2444775,15442,13.018,12190,10.277,315429,110937,204492,4.538,12.902,255547,79119,176428,3.236,10.453,59882,2.449,20.906,9314,9418,62074,
2019,72,490804,675952,14511015,14415818,67490,10.058,57608,8.585,1962746,902794,1059952,6.263,13.615,1765913,647480,1118433,4.491,12.25,196833,1.365,24.5,46043,47379,482851,
2019,81,647610,712546,5627005,5609598,56075,7.894,51694,7.277,641946,210885,431061,3.759,11.444,607821,194287,413534,3.463,10.835,34125,0.608,21.671,40973,41599,149671,
2020,11,18086,18758,166498,165083,1966,10.422,2177,11.541,26125,7987,18138,4.838,15.825,23126,7863,15263,4.763,14.009,2999,1.817,28.017,1753,1754,6232,
2020,21,16022,22242,578548,601568,1791,7.907,2610,11.522,71382,21889,49493,3.639,11.866,117809,38078,79731,6.33,19.584,-46427,-7.718,23.732,1796,1896,14913,
2020,22,5669,18640,638049,640020,895,4.821,741,3.992,38998,9697,29301,1.515,6.093,42702,8905,33797,1.391,6.672,-3704,-0.579,12.187,283,293,2556,
2020,23,630497,645370,7179882,7117166,78717,12.24,74177,11.534,1107708,293663,814045,4.126,15.564,982400,287701,694699,4.042,13.803,125308,1.761,27.606,59721,59861,224143,
2020,31-33,223091,266833,11958945,12020855,15951,5.926,20631,7.665,960320,207989,752331,1.73,7.989,1084544,268120,816424,2.23,9.022,-124224,-1.033,15.978,16145,16399,144850,
2020,42,254336,363298,6137862,6156482,22625,6.165,29984,8.171,606195,155311,450884,2.523,9.846,646041,228419,417622,3.71,10.494,-39846,-0.647,19.693,21829,22583,111396,
2020,44-45,565930,966112,15806667,15773538,68910,7.082,82843,8.513,1542511,539092,1003419,3.418,9.779,1468111,515819,952292,3.27,9.307,74400,0.472,18.615,55263,60038,284807,
2020,48-49,168526,220698,5698736,5604359,28984,13.147,28521,12.937,774536,304731,469805,5.437,13.82,583231,218193,365038,3.893,10.407,191305,3.414,20.813,20943,21283,101003,
2020,51,69747,144589,3512884,3511827,13961,9.66,13835,9.573,448525,143463,305062,4.085,12.772,443620,145099,298521,4.132,12.632,4905,0.14,25.264,7743,8240,60241,
2020,52,212190,443541,6655018,6600054,32266,7.256,34593,7.779,791491,221459,570032,3.355,11.992,678400,214860,463540,3.255,10.279,113091,1.713,20.557,16765,17843,71517,
2020,53,270144,366748,2288235,2266331,42481,11.664,37417,10.273,349537,146480,203057,6.463,15.423,305833,129084,176749,5.696,13.495,43704,1.928,26.989,25665,26313,75675,
2020,54,699433,801324,9528578,9401486,93162,11.676,86276,10.813,1366987,437790,929197,4.657,14.54,1113168,424198,688970,4.512,11.84,253819,2.7,23.681,67662,68349,261896,
2020,55,25031,51102,3592941,3553137,2807,5.416,4255,8.21,511749,162131,349618,4.563,14.403,428595,129962,298633,3.658,12.062,83154,2.34,24.125,828,886,17462,
2020,56,298092,370718,11708732,11733253,45224,12.282,40243,10.929,1846861,645433,1201428,5.501,15.74,1908535,530585,1377950,4.522,16.266,-61674,-0.526,31.481,30290,30533,245962,
2020,61,87233,98595,3752671,3748777,10151,10.363,8863,9.048,275886,73592,202294,1.963,7.359,268122,60967,207155,1.626,7.152,7764,0.207,14.305,6935,7101,44585,
2020,62,605698,858656,21183915,21019287,71032,8.298,65697,7.675,2151775,652035,1499740,3.102,10.237,1822049,610505,1211544,2.904,8.668,329726,1.569,17.337,45654,47265,341490,
2020,71,108841,122352,2472303,2473129,16001,13.186,14002,11.538,324431,122485,201946,4.953,13.118,325607,93167,232440,3.767,13.166,-1176,-0.048,26.236,11212,11396,72915,
2020,72,489040,675285,14364025,14432117,64585,9.56,65163,9.646,1897817,845986,1051831,5.862,13.15,2035581,709797,1325784,4.918,14.105,-137764,-0.955,26.3,51117,53305,518523,
2020,81,642452,707412,5609001,5622497,57696,8.125,63117,8.888,676547,231613,444934,4.119,12.033,701899,252089,449810,4.484,12.484,-25352,-0.451,24.066,48543,49254,181989,
