year,st,firms,estabs,emp,denom,estabs_entry,estabs_entry_rate,estabs_exit,estabs_exit_rate,job_creation,job_creation_births,job_creation_continuers,job_creation_rate_births,job_creation_rate,job_destruction,job_destruction_deaths,job_destruction_continuers,job_destruction_rate_deaths,job_destruction_rate,net_job_creation,net_job_creation_rate,reallocation_rate,firmdeath_firms,firmdeath_estabs,firmdeath_emp
1978,01,54617,65496,1024183,984996,10229,15.949,7509,11.708,212179,69948,142231,7.101,21.541,134427,51488,82939,5.227,13.647,77752,7.894,27.295,5238,5314,27806
1978,02,7122,8430,108318,108397,1909,23.543,1266,15.613,35656,14804,20852,13.657,32.894,35706,17146,18560,15.818,32.940,-50,-0.046,65.788,828,835,8897
1978,04,40584,48863,702510,658485,9631,20.442,6132,13.015,191367,71849,119518,10.911,29.062,103077,43633,59444,6.626,15.654,88290,13.408,31.307,4288,4377,25515
1978,05,36667,42030,574708,551143,6979,16.979,5126,12.471,116437,41664,74773,7.560,21.126,69213,26154,43059,4.745,12.558,47224,8.568,25.116,3858,3881,17071
1978,06,388224,467291,7328369,6980685,81928,18.063,54489,12.013,1726472,600218,1126254,8.598,24.732,1032276,415396,616880,5.951,14.788,694196,9.945,29.575,37522,38052,218491
1978,08,55950,65225,918817,863928,12544,19.919,8043,12.772,233277,80441,152836,9.311,27.002,123203,50776,72427,5.877,14.261,110074,12.741,28.522,5707,5782,28803
1978,09,56247,64185,1171735,1143093,7834,12.414,5676,8.994,195280,51320,143960,4.490,17.083,138367,42928,95439,3.755,12.105,56913,4.979,24.209,3957,3987,20218
1978,10,9951,11536,221621,217235,1493,13.119,1182,10.386,38307,11066,27241,5.094,17.634,28875,8528,20347,3.926,13.292,9432,4.342,26.584,815,827,4781
1978,11,12728,14609,305258,293535,1907,13.165,1659,11.453,64696,16163,48533,5.506,22.040,42392,16399,25993,5.587,14.442,22304,7.598,28.884,1018,1041,5557
1978,12,165173,197214,2653269,2532081,35717,18.629,24738,12.903,647663,240396,407267,9.494,25.578,404444,172710,231734,6.821,15.973,243219,9.605,31.946,17723,18010,99867
1978,13,82121,100196,1632006,1561122,15644,15.922,11754,11.963,346633,118497,228136,7.591,22.204,204133,79214,124919,5.074,13.076,142500,9.128,26.152,8039,8130,43041
1978,15,15717,18887,280937,271028,2999,16.283,2062,11.195,61140,24458,36682,9.024,22.559,41199,17355,23844,6.403,15.201,19941,7.358,30.402,1325,1345,7250
1978,16,17446,20209,239997,229809,3663,18.736,2346,12.000,58701,22401,36300,9.748,25.543,38563,14251,24312,6.201,16.780,20138,8.763,33.561,1665,1682,7893
1978,17,179096,209702,4049286,3949852,26892,12.981,21807,10.527,704205,213019,491186,5.393,17.829,503933,186010,317923,4.709,12.758,200272,5.070,25.517,14964,15215,86356
1978,18,81353,97919,1786885,1733868,12759,13.229,9820,10.181,302242,90244,211998,5.205,17.432,196675,66302,130373,3.824,11.343,105567,6.089,22.686,6669,6758,34065
1978,19,55848,65377,870988,842358,8496,13.192,6546,10.164,160470,52595,107875,6.244,19.050,102873,37513,65360,4.453,12.213,57597,6.838,24.425,4687,4737,22756
1978,20,46053,53740,710125,688761,7386,13.969,5657,10.699,139644,48313,91331,7.014,20.275,97017,37750,59267,5.481,14.086,42627,6.189,28.171,3997,4038,21634
1978,21,51314,60096,919006,887759,8627,14.580,6779,11.456,181565,59732,121833,6.728,20.452,119606,44319,75287,4.992,13.473,61959,6.979,26.946,4760,4823,21984
1978,22,61280,72748,1170598,1105565,11002,15.440,8022,11.258,280431,88207,192224,7.978,25.365,149806,55463,94343,5.017,13.550,130625,11.815,27.100,5709,5771,28381
1978,23,19760,22570,312809,300942,3313,15.004,2335,10.575,58349,19185,39164,6.375,19.389,34427,12510,21917,4.157,11.440,23922,7.949,22.880,1651,1669,6989
1978,24,60042,71574,1195772,1160830,9439,13.378,7400,10.488,227374,69653,157721,6.000,19.587,157384,60058,97326,5.174,13.558,69990,6.029,27.116,4862,4959,27669
1978,25,95973,111289,2068854,1990800,13042,11.852,10536,9.575,386206,109199,277007,5.485,19.400,229666,90142,139524,4.528,11.536,156540,7.863,23.073,6979,7102,39598
1978,26,127285,152187,2944358,2829685,20388,13.615,15506,10.355,545196,159891,385305,5.650,19.267,316225,136827,179398,4.835,11.175,228971,8.092,22.351,10384,10569,60688
1978,27,67852,79926,1362032,1291848,11028,14.095,7660,9.790,290737,81827,208910,6.334,22.506,150972,59474,91498,4.604,11.687,139765,10.819,23.373,5295,5369,27427
1978,28,35809,41945,603008,579350,6409,15.538,5011,12.149,123976,42599,81377,7.353,21.399,76408,30438,45970,5.254,13.189,47568,8.211,26.377,3509,3533,17159
1978,29,81191,96472,1580237,1519343,13675,14.384,10874,11.438,313711,95978,217733,6.317,20.648,191648,72469,119179,4.770,12.614,122063,8.034,25.228,7432,7572,37478
1978,30,17363,19788,197841,186360,3346,17.368,2300,11.939,51356,17142,34214,9.198,27.557,28252,13356,14896,7.167,15.160,23104,12.398,30.320,1645,1651,7442
1978,31,31303,36131,457297,445776,4597,12.887,3677,10.308,84273,27486,56787,6.166,18.905,61091,23788,37303,5.336,13.704,23182,5.200,27.409,2635,2684,13807
1978,32,14670,16638,287370,264211,3487,21.915,2034,12.783,81171,28230,52941,10.685,30.722,35015,16590,18425,6.279,13.253,46156,17.469,26.505,1416,1429,10529
1978,33,17588,19645,294048,277747,3076,16.122,1944,10.189,63128,24655,38473,8.877,22.729,30925,11622,19303,4.184,11.134,32203,11.594,22.269,1391,1421,6759
1978,34,129457,147273,2420041,2360989,19058,13.111,15237,10.482,453915,137314,316601,5.816,19.226,334920,141306,193614,5.985,14.186,118995,5.040,28.371,10239,10332,66161
1978,35,22369,25897,308750,292220,4810,19.098,3389,13.456,81408,29091,52317,9.955,27.859,48657,22893,25764,7.834,16.651,32751,11.208,33.302,2447,2466,15250
1978,36,313631,354589,5613707,5514706,43247,12.251,40104,11.360,998892,295918,702974,5.366,18.113,797185,315080,482105,5.713,14.456,201707,3.658,28.911,28686,29016,148782
1978,37,88763,107344,1872119,1805643,15553,14.786,11239,10.685,333056,103050,230006,5.707,18.445,199503,71779,127724,3.975,11.049,133553,7.396,22.098,7753,7821,34958
1978,38,13329,15132,157702,150608,2058,13.846,1522,10.240,33167,10550,22617,7.005,22.022,18981,7555,11426,5.016,12.603,14186,9.419,25.206,1091,1097,5062
1978,39,155694,193531,3629101,3529220,23807,12.465,18736,9.810,626462,169404,457058,4.800,17.751,426621,151202,275419,4.284,12.088,199841,5.662,24.177,12247,12444,61886
1978,40,51995,60460,798139,764371,9912,16.707,7650,12.894,181997,69307,112690,9.067,23.810,114836,45902,68934,6.005,15.024,67161,8.786,30.047,5677,5728,28132
1978,41,50120,57978,790193,735791,10520,18.816,6383,11.417,199490,66473,133017,9.034,27.112,91090,38285,52805,5.203,12.380,108400,14.732,24.760,4669,4703,23763
1978,42,177709,212427,3862146,3789539,24888,11.836,20566,9.781,672527,199576,472951,5.266,17.747,530273,213650,316623,5.638,13.993,142254,3.754,27.986,13474,13713,108271
1978,44,18062,20047,323183,312822,2414,12.189,1928,9.735,60226,17993,42233,5.752,19.252,39627,17167,22460,5.488,12.668,20599,6.585,25.335,1375,1382,8114
1978,45,44561,52926,923959,889154,8097,15.662,5641,10.911,168162,56399,111763,6.343,18.913,98992,36619,62373,4.118,11.133,69170,7.779,22.267,3938,3985,16652
1978,46,14249,16001,170161,160446,2288,14.580,1671,10.648,38219,12929,25290,8.058,23.820,18782,7603,11179,4.739,11.706,19437,12.114,23.412,1178,1184,4614
1978,47,67843,80797,1379870,1328056,11983,15.081,9303,11.708,276281,89006,187275,6.702,20.803,171987,71653,100334,5.395,12.950,104294,7.853,25.901,6437,6493,33187
1978,48,226894,278496,4411748,4194914,48418,17.867,33408,12.328,1073118,389323,683795,9.281,25.581,641187,261863,379324,6.242,15.285,431931,10.297,30.570,23326,23673,145449
1978,49,23303,26886,398271,372716,4961,19.128,3061,11.802,105960,40409,65551,10.842,28.429,55453,21385,34068,5.738,14.878,50507,13.551,29.756,2175,2207,12039
1978,50,10901,12090,158409,151942,1873,15.979,1137,9.700,33701,10778,22923,7.094,22.180,21232,10773,10459,7.090,13.974,12469,8.206,27.948,846,854,7974
1978,51,76493,92848,1499219,1444455,13563,14.932,9528,10.490,303738,97469,206269,6.748,21.028,195010,75014,119996,5.193,13.501,108728,7.527,27.001,6308,6403,34618
1978,53,71717,84068,1142839,1077546,14993,18.503,8916,11.003,274633,85541,189092,7.939,25.487,143344,57649,85695,5.350,13.303,131289,12.184,26.606,6251,6325,32915
1978,54,26605,31012,455691,453935,4091,13.314,3523,11.465,74489,23586,50903,5.196,16.410,70595,20912,49683,4.607,15.552,3894,0.858,31.104,2339,2363,10495
1978,55,79030,91350,1550157,1490206,11941,13.351,8113,9.071,272208,77695,194513,5.214,18.266,152804,55895,96909,3.751,10.254,119404,8.013,20.508,5638,5686,30458
1978,56,10488,11710,130719,119626,2308,20.508,1396,12.404,41503,14731,26772,12.314,34.694,19141,8171,10970,6.830,16.001,22362,18.693,32.001,978,990,4525
1979,01,56151,67397,1084069,1055800,9447,14.203,7677,11.542,214628,67701,146927,6.412,20.328,157984,54399,103585,5.152,14.963,56644,5.365,29.927,5562,5623,31515
1979,02,7326,8631,109359,108959,1647,19.287,1464,17.144,26797,9690,17107,8.893,24.594,26196,9441,16755,8.665,24.042,601,0.552,48.084,946,956,5463
1979,04,42610,51467,793483,749468,9007,17.932,6533,13.006,193986,67367,126619,8.989,25.883,106254,40348,65906,5.384,14.177,87732,11.706,28.355,4723,4801,25812
1979,05,37449,42895,598252,586334,6193,14.586,5322,12.534,105606,35836,69770,6.112,18.011,81446,27229,54217,4.644,13.891,24160,4.121,27.781,3987,4024,18585
1979,06,411705,494150,8025377,7689368,81179,16.862,55726,11.575,1762693,583122,1179571,7.583,22.924,1091537,402020,689517,5.228,14.195,671156,8.728,28.391,38557,39038,215946
1979,08,58689,68223,1016630,970348,11664,17.458,8844,13.237,230676,81071,149605,8.355,23.773,137948,54119,83829,5.577,14.216,92728,9.556,28.433,6335,6409,32880
1979,09,58341,66461,1251470,1212321,7629,11.666,5496,8.404,199887,58120,141767,4.794,16.488,121390,42798,78592,3.530,10.013,78497,6.475,20.026,3747,3766,20714
1979,10,10340,11956,230587,226321,1521,12.934,1129,9.600,32946,10638,22308,4.700,14.557,24373,7723,16650,3.412,10.769,8573,3.788,21.538,751,768,3554
1979,11,13078,14994,328939,317453,1856,12.522,1513,10.207,55584,13110,42474,4.130,17.509,32805,12023,20782,3.787,10.334,22779,7.176,20.668,1018,1033,6086
1979,12,175189,208892,2882521,2771925,35570,17.499,24316,11.963,646855,241609,405246,8.716,23.336,424417,171687,252730,6.194,15.311,222438,8.025,30.623,17474,17681,107040
1979,13,84868,103952,1709687,1674180,15151,14.827,11615,11.367,308119,109304,198815,6.529,18.404,237713,79863,157850,4.770,14.199,70406,4.205,28.398,8179,8265,44172
1979,15,16717,20158,303099,293291,3140,16.049,1953,9.982,57427,20606,36821,7.026,19.580,37790,12933,24857,4.410,12.885,19637,6.695,25.770,1342,1362,8052
1979,16,17779,20638,246828,244155,3140,15.361,2748,13.443,48247,18062,30185,7.398,19.761,43103,15755,27348,6.453,17.654,5144,2.107,35.308,2054,2066,9684
1979,17,182457,213783,4230523,4148786,25215,11.894,21643,10.209,705809,212466,493343,5.121,17.012,538294,175456,362838,4.229,12.975,167515,4.038,25.949,14820,15072,81746
1979,18,83654,100798,1893631,1847003,11902,11.961,9314,9.360,290523,82761,207762,4.481,15.729,197614,64621,132993,3.499,10.699,92909,5.030,21.398,6693,6778,35436
1979,19,56769,66541,909920,891783,7711,11.675,6726,10.183,146075,47633,98442,5.341,16.380,109756,38565,71191,4.324,12.307,36319,4.073,24.615,4931,4983,24180
1979,20,47398,55298,760104,736290,7029,12.876,5612,10.280,138811,44363,94448,6.025,18.853,90448,32943,57505,4.474,12.284,48363,6.568,24.569,4017,4066,19806
1979,21,53007,62259,978720,952530,8387,13.691,6386,10.425,175383,59880,115503,6.286,18.412,123416,40739,82677,4.277,12.957,51967,5.456,25.913,4612,4644,22184
1979,22,64295,76345,1243283,1202058,11528,15.460,7974,10.694,260519,88528,171991,7.365,21.673,178153,62816,115337,5.226,14.821,82366,6.852,29.641,5811,5872,36655
1979,23,20363,23307,320217,312887,3026,13.177,2340,10.190,52153,17319,34834,5.535,16.668,37691,11950,25741,3.819,12.046,14462,4.622,24.092,1707,1715,6727
1979,24,62137,74177,1267588,1234157,9473,12.980,7081,9.703,223219,67240,155979,5.448,18.087,156144,54624,101520,4.426,12.652,67075,5.435,25.304,4873,4938,25781
1979,25,98314,114023,2214170,2145003,12643,11.209,10182,9.027,375578,105365,270213,4.912,17.509,238514,76389,162125,3.561,11.120,137064,6.390,22.239,6861,6948,38983
1979,26,131025,156565,3101633,3017852,18721,12.111,14747,9.540,500917,136733,364184,4.531,16.598,331976,100947,231029,3.345,11.000,168941,5.598,22.001,10314,10476,56481
1979,27,70604,83083,1466847,1419331,10440,12.786,7582,9.286,265326,79174,186152,5.578,18.694,170348,52909,117439,3.728,12.002,94978,6.692,24.004,5380,5429,29122
1979,28,37018,43407,622999,613763,6150,14.395,4783,11.195,108602,37583,71019,6.123,17.694,89169,30619,58550,4.989,14.528,19433,3.166,29.057,3426,3454,17483
1979,29,83826,99440,1659649,1623179,13022,13.274,10340,10.540,275878,84645,191233,5.215,16.996,202845,68294,134551,4.207,12.497,73033,4.499,24.994,7335,7422,37806
1979,30,17947,20437,212573,205821,3172,15.752,2571,12.768,44999,17326,27673,8.418,21.863,31675,12203,19472,5.929,15.390,13324,6.474,30.779,1889,1900,8660
1979,31,32375,37273,486787,473188,4448,12.101,3415,9.291,82805,23119,59686,4.886,17.499,55425,19059,36366,4.028,11.713,27380,5.786,23.426,2452,2471,12342
1979,32,15705,17933,333975,313053,3591,20.749,2339,13.515,89409,34402,55007,10.989,28.560,48125,20720,27405,6.619,15.373,41284,13.188,30.746,1680,1689,12334
1979,33,18372,20570,321029,308118,2860,14.205,1988,9.874,60439,17507,42932,5.682,19.616,34732,12667,22065,4.111,11.272,25707,8.343,22.545,1443,1453,6953
1979,34,134142,152402,2556770,2489210,18912,12.606,14152,9.433,450552,132913,317639,5.340,18.100,315518,102856,212662,4.132,12.675,135034,5.425,25.351,9635,9682,47544
1979,35,23036,26699,333756,322489,4296,16.314,3565,13.538,74973,27511,47462,8.531,23.248,52538,21324,31214,6.612,16.291,22435,6.957,32.583,2505,2534,13004
1979,36,318523,360012,5913320,5783485,41593,11.628,36990,10.341,982252,273604,708648,4.731,16.984,721450,247711,473739,4.283,12.474,260802,4.509,24.949,26793,27074,127673
1979,37,92307,111758,1994871,1941212,14767,13.463,10621,9.683,318047,102703,215344,5.291,16.384,210618,69173,141445,3.563,10.850,107429,5.534,21.700,7698,7786,40689
1979,38,13985,15831,171661,165298,2211,14.265,1549,9.994,34734,13644,21090,8.254,21.013,22012,8347,13665,5.050,13.317,12722,7.696,26.633,1110,1114,5624
1979,39,159835,198663,3801199,3721349,22707,11.565,18064,9.200,586293,174351,411942,4.685,15.755,427564,137842,289722,3.704,11.489,158729,4.265,22.979,12053,12279,64500
1979,40,53953,62884,856824,826593,9907,16.066,7471,12.115,181384,66238,115146,8.013,21.944,120266,46792,73474,5.661,14.550,61118,7.394,29.099,5581,5625,29874
1979,41,52449,60663,834348,813924,9741,16.400,7210,12.139,164553,57963,106590,7.121,20.217,123782,46370,77412,5.697,15.208,40771,5.009,30.416,5148,5206,26754
1979,42,182519,218304,4035087,3953529,23972,11.115,18695,8.669,624859,175016,449843,4.427,15.805,462291,145112,317179,3.670,11.693,162568,4.112,23.386,13084,13261,67171
1979,44,18671,20722,341299,332902,2378,11.653,1749,8.570,57044,17604,39440,5.288,17.135,40042,12773,27269,3.837,12.028,17002,5.107,24.056,1244,1258,6832
1979,45,45789,54573,969710,950396,7309,13.582,5789,10.758,149845,45148,104697,4.750,15.767,111400,34181,77219,3.597,11.721,38445,4.045,23.443,4152,4216,19977
1979,46,14827,16690,180689,175867,2224,13.585,1587,9.694,33466,13010,20456,7.398,19.029,23853,8366,15487,4.757,13.563,9613,5.466,27.126,1168,1170,5332
1979,47,69926,83475,1450619,1419880,11691,14.215,9230,11.223,245922,79877,166045,5.626,17.320,184451,64263,120188,4.526,12.991,61471,4.329,25.981,6600,6646,35817
1979,48,237627,292183,4701663,4550057,47451,16.623,33979,11.904,1026713,374519,652194,8.231,22.565,724327,265726,458601,5.840,15.919,302386,6.646,31.838,24847,25166,165620
1979,49,23927,27709,428379,414007,4433,16.218,3683,13.474,94795,34610,60185,8.360,22.897,66389,24801,41588,5.990,16.036,28406,6.861,32.071,2687,2748,14653
1979,50,11367,12617,165840,162106,1727,13.969,1220,9.868,27140,9112,18028,5.621,16.742,19872,6785,13087,4.186,12.259,7268,4.483,24.517,928,931,4550
1979,51,79656,96763,1598231,1550692,12972,13.663,9326,9.823,290737,91213,199524,5.882,18.749,194827,62233,132594,4.013,12.564,95910,6.185,25.128,6616,6683,32475
1979,53,75645,88386,1224894,1174172,13989,16.197,9949,11.520,272219,86159,186060,7.338,23.184,169821,61371,108450,5.227,14.463,102398,8.721,28.926,6934,7019,34898
1979,54,27664,32190,497562,476341,4482,14.168,3373,10.662,97508,24866,72642,5.220,20.470,55255,19002,36253,3.989,11.600,42253,8.870,23.200,2341,2363,10147
1979,55,81746,94541,1625068,1589261,10781,11.583,7855,8.439,243347,69974,173373,4.403,15.312,171620,53580,118040,3.371,10.799,71727,4.513,21.597,5532,5582,26293
1979,56,11072,12405,143147,137304,2159,17.875,1506,12.468,35337,13919,21418,10.137,25.736,23839,8271,15568,6.024,17.362,11498,8.374,34.725,1095,1101,5763
1980,01,55850,67294,1077160,1080339,8563,12.715,8665,12.867,168419,54268,114151,5.023,15.589,174641,54575,120066,5.052,16.165,-6222,-0.576,31.179,6304,6366,33512
1980,02,7320,8650,106436,107902,1454,16.831,1432,16.576,22769,8186,14583,7.587,21.102,25699,9801,15898,9.083,23.817,-2930,-2.715,42.203,967,978,4687
1980,04,44590,53981,819374,807114,9110,17.276,6610,12.535,163934,62958,100976,7.800,20.311,139537,46590,92947,5.772,17.288,24397,3.023,34.577,4777,4844,25990
1980,05,37464,42979,599984,600121,5546,12.915,5475,12.749,94659,31779,62880,5.295,15.773,94858,29277,65581,4.879,15.806,-199,-0.033,31.547,4125,4181,17447
1980,06,424791,510127,8248324,8138353,78225,15.579,62183,12.384,1574651,583207,991444,7.166,19.349,1354554,446405,908149,5.485,16.644,220097,2.704,33.288,44234,44827,251599
1980,08,60547,70425,1051514,1035187,11420,16.473,9217,13.296,204931,75355,129576,7.279,19.797,172409,65119,107290,6.291,16.655,32522,3.142,33.310,6736,6833,39903
1980,09,59189,67569,1284446,1269222,7314,10.911,6244,9.315,179180,54623,124557,4.304,14.117,148574,46487,102087,3.663,11.706,30606,2.411,23.412,4463,4516,20750
1980,10,10385,11995,235861,233228,1328,11.093,1280,10.693,32337,10005,22332,4.290,13.865,27323,7052,20271,3.024,11.715,5014,2.150,23.430,931,957,3857
1980,11,13166,15088,325350,328013,1808,12.045,1652,11.006,54384,16663,37721,5.080,16.580,58454,28381,30073,8.652,17.821,-4070,-1.241,33.160,1126,1142,7013
1980,12,183961,219081,3011215,2946867,36199,16.912,26114,12.201,602124,235260,366864,7.983,20.433,474149,169990,304159,5.769,16.090,127975,4.343,32.180,19417,19664,110116
1980,13,85965,105503,1731193,1722514,13953,13.321,12435,11.872,267843,98417,169426,5.714,15.550,250167,80076,170091,4.649,14.523,17676,1.026,29.047,8849,8952,46320
1980,15,17573,21160,313424,308539,3127,15.142,2109,10.213,54268,21843,32425,7.079,17.589,44732,14139,30593,4.583,14.498,9536,3.091,28.996,1492,1520,8477
1980,16,17840,20745,245916,246310,2955,14.278,2857,13.805,43427,17207,26220,6.986,17.631,43661,15143,28518,6.148,17.726,-234,-0.095,35.262,2108,2134,9946
1980,17,182819,214726,4155260,4191809,23959,11.180,23124,10.790,546523,190194,356329,4.537,13.038,622014,169150,452864,4.035,14.839,-75491,-1.801,26.076,16481,16686,88211
1980,18,83602,101166,1810577,1850919,10911,10.803,10586,10.481,214626,76668,137958,4.142,11.596,295672,67807,227865,3.663,15.974,-81046,-4.379,23.191,7624,7714,35262
1980,19,56702,66786,896872,901866,7165,10.744,6968,10.449,119539,41345,78194,4.584,13.255,129779,36664,93115,4.065,14.390,-10240,-1.135,26.509,5279,5312,23949
1980,20,47635,55637,768520,764485,6326,11.402,6016,10.843,117387,40144,77243,5.251,15.355,109615,30885,78730,4.040,14.338,7772,1.017,28.677,4457,4499,20405
1980,21,52753,62322,954713,965440,7201,11.561,7132,11.450,129930,47541,82389,4.924,13.458,151422,39278,112144,4.068,15.684,-21492,-2.226,26.916,5321,5365,25414
1980,22,65222,77698,1258446,1249766,10415,13.527,9009,11.701,220490,72282,148208,5.784,17.643,202316,59077,143239,4.727,16.188,18174,1.454,32.377,6680,6738,37386
1980,23,20285,23297,321944,320816,2664,11.428,2692,11.548,45602,13919,31683,4.339,14.214,43516,14684,28832,4.577,13.564,2086,0.650,27.128,1925,1943,8682
1980,24,63050,75410,1301810,1285446,8962,11.981,7741,10.349,215452,68052,147400,5.294,16.761,182907,50236,132671,3.908,14.229,32545,2.532,28.458,5398,5472,28785
1980,25,99471,115568,2271114,2242807,12101,10.538,10624,9.252,340150,96060,244090,4.283,15.166,283610,84773,198837,3.780,12.645,56540,2.521,25.291,7376,7476,39970
1980,26,130930,157436,2921880,3022400,17546,11.173,16764,10.675,354052,124492,229560,4.119,11.714,557904,120147,437757,3.975,18.459,-203852,-6.745,23.429,11919,12065,67203
1980,27,71543,84337,1479873,1473083,9416,11.243,8245,9.845,223101,71357,151744,4.844,15.145,209965,62028,147937,4.211,14.253,13136,0.892,28.507,5966,6054,34761
1980,28,37400,43967,613555,618439,5704,13.055,5157,11.803,93148,34412,58736,5.564,15.062,102613,30284,72329,4.897,16.592,-9465,-1.530,30.124,3800,3829,18120
1980,29,83817,99646,1642079,1651442,11546,11.598,11363,11.414,229047,78260,150787,4.739,13.870,247688,71973,175715,4.358,14.998,-18641,-1.129,27.739,8227,8323,38644
1980,30,17980,20484,207984,210315,2713,13.258,2670,13.048,36453,14815,21638,7.044,17.333,41085,13094,27991,6.226,19.535,-4632,-2.202,34.665,1920,1930,8893
1980,31,32391,37407,482381,484535,4108,11.000,3985,10.671,70111,25220,44891,5.205,14.470,74851,20393,54458,4.209,15.448,-4740,-0.978,28.939,2981,3013,12867
1980,32,16347,18768,343059,338318,3399,18.515,2580,14.053,67045,27934,39111,8.257,19.817,57194,19972,37222,5.903,16.905,9851,2.912,33.811,1901,1927,11740
1980,33,18478,20739,326919,324212,2479,11.998,2324,11.248,51677,17453,34224,5.383,15.939,46501,16326,30175,5.036,14.343,5176,1.596,28.686,1670,1683,9529
1980,34,136352,155052,2584688,2573868,17820,11.588,15279,9.936,389033,123815,265218,4.810,15.115,367162,105821,261341,4.111,14.265,21871,0.850,28.530,11034,11094,55097
1980,35,23239,26993,332266,332708,4034,15.024,3747,13.956,62981,25996,36985,7.813,18.930,64204,22746,41458,6.837,19.297,-1223,-0.368,37.860,2669,2690,14323
1980,36,319180,360941,5931980,5908571,39424,10.934,38672,10.725,866683,262480,604203,4.442,14.668,821558,258199,563359,4.370,13.905,45125,0.764,27.809,28693,28931,146357
1980,37,92872,112920,1998146,1992553,13503,12.018,12373,11.012,266574,89583,176991,4.496,13.379,253894,74911,178983,3.760,12.742,12680,0.636,25.484,8992,9104,43001
1980,38,14100,16060,174927,173286,1961,12.294,1744,10.933,30191,10928,19263,6.306,17.423,26977,8553,18424,4.936,15.568,3214,1.855,31.136,1308,1315,5639
1980,39,159885,199407,3733189,3769605,20234,10.164,19575,9.833,480269,151452,328817,4.018,12.741,552799,142300,410499,3.775,14.665,-72530,-1.924,25.481,13610,13798,68246
1980,40,54935,64139,885983,870744,9382,14.778,8075,12.719,173391,67938,105453,7.802,19.913,141853,49000,92853,5.627,16.291,31538,3.622,32.582,6016,6081,32202
1980,41,53436,61994,842449,839199,9564,15.593,8249,13.449,151849,60011,91838,7.151,18.095,145949,49834,96115,5.938,17.391,5900,0.703,34.783,6073,6190,31436
1980,42,181836,218387,4054303,4050029,21266,9.737,21294,9.750,534495,167829,366666,4.144,13.197,524093,153277,370816,3.785,12.940,10402,0.257,25.881,15274,15455,80203
1980,44,18729,20779,340159,340647,2120,10.218,2059,9.924,44965,13076,31889,3.839,13.200,46025,11803,34222,3.465,13.511,-1060,-0.311,26.400,1499,1509,6381
1980,45,46272,55321,956877,948872,7058,12.844,6320,11.501,136787,45656,91131,4.812,14.416,120802,35557,85245,3.747,12.731,15985,1.685,25.462,4569,4652,19734
1980,46,14885,16785,180586,180539,1901,11.352,1822,10.881,29441,11280,18161,6.248,16.307,29486,9429,20057,5.223,16.332,-45,-0.025,32.615,1350,1357,5666
1980,47,70194,84111,1432436,1441230,10570,12.614,9946,11.869,203321,70792,132529,4.912,14.107,220890,66159,154731,4.590,15.326,-17569,-1.219,28.215,7319,7400,38316
1980,48,244420,301716,4886242,4793526,46358,15.616,36639,12.342,972188,353381,618807,7.372,20.281,783846,252685,531161,5.271,16.352,188342,3.929,32.704,26342,26741,151854
1980,49,23897,27843,436057,432420,4129,14.866,3992,14.373,78911,30156,48755,6.974,18.249,71651,27022,44629,6.249,16.570,7260,1.679,33.140,2896,2932,16369
1980,50,11546,12831,166946,166467,1572,12.353,1362,10.702,24313,7378,16935,4.432,14.605,23166,6267,16899,3.765,13.916,1147,0.689,27.833,1051,1057,4069
1980,51,80536,98180,1630162,1614451,12020,12.333,10590,10.865,247926,80449,167477,4.983,15.357,216240,62639,153601,3.880,13.394,31686,1.963,26.788,7617,7700,34986
1980,53,76470,89775,1261064,1241990,13125,14.736,11709,13.146,242250,86127,156123,6.935,19.505,205178,69465,135713,5.593,16.520,37072,2.985,33.040,8442,8542,45822
1980,54,27516,32146,482667,490192,3727,11.587,3768,11.714,66619,23919,42700,4.880,13.590,81390,21966,59424,4.481,16.604,-14771,-3.013,27.181,2764,2773,11785
1980,55,81944,95046,1616016,1620891,9590,10.115,9123,9.622,200522,61333,139189,3.784,12.371,211207,55768,155439,3.441,13.030,-10685,-0.659,24.742,6662,6736,32162
1980,56,11446,12861,150896,147085,2057,16.276,1611,12.747,33303,12905,20398,8.774,22.642,25683,9229,16454,6.275,17.461,7620,5.181,34.923,1161,1179,6441
1981,01,55314,67132,1065436,1069480,8301,12.351,8456,12.582,167232,65932,101300,6.165,15.637,175620,51702,123918,4.834,16.421,-8388,-0.784,31.274,6253,6341,32055
1981,02,7659,9037,118724,112539,1630,18.438,1237,13.992,32294,11403,20891,10.132,28.696,19699,7204,12495,6.401,17.504,12595,11.192,35.008,811,816,4025
1981,04,46222,56238,839383,828844,9421,17.102,7119,12.923,159583,66092,93491,7.974,19.254,138253,43329,94924,5.228,16.680,21330,2.573,33.360,5212,5290,27963
1981,05,37100,42885,595814,597030,5444,12.689,5478,12.769,90148,36937,53211,6.187,15.099,93058,27861,65197,4.667,15.587,-2910,-0.487,30.199,4079,4118,18676
1981,06,433471,522245,8421355,8338236,78243,15.162,65855,12.761,1568731,593557,975174,7.118,18.814,1400041,460815,939226,5.527,16.791,168690,2.023,33.581,46777,47503,267118
1981,08,61942,72506,1086250,1069481,11789,16.504,9639,13.494,223194,88682,134512,8.292,20.869,189523,68558,120965,6.410,17.721,33671,3.148,35.442,7192,7274,44985
1981,09,59664,68278,1294942,1289030,7350,10.824,6606,9.728,176301,66133,110168,5.130,13.677,164652,53442,111210,4.146,12.773,11649,0.904,25.547,4660,4714,22511
1981,10,10389,12046,238621,235912,1320,10.984,1263,10.510,32077,11587,20490,4.912,13.597,26441,7661,18780,3.247,11.208,5636,2.389,22.416,891,906,3953
1981,11,13240,15175,332661,328994,1836,12.126,1769,11.683,52266,18963,33303,5.764,15.887,45107,15808,29299,4.805,13.711,7159,2.176,27.421,1213,1225,7439
1981,12,192043,229665,3173645,3092609,38251,17.054,27508,12.264,654342,266581,387761,8.620,21.158,491916,162794,329122,5.264,15.906,162426,5.252,31.812,20775,21012,107549
1981,13,86910,107349,1773418,1751703,14527,13.655,12600,11.844,303776,117526,186250,6.709,17.342,260183,81128,179055,4.631,14.853,43593,2.489,29.706,9056,9192,45865
1981,15,18044,21764,321642,317234,3085,14.380,2464,11.485,57102,23643,33459,7.453,18.000,48180,15241,32939,4.804,15.188,8922,2.812,30.375,1801,1844,9791
1981,16,17616,20607,244097,245066,2758,13.340,2893,13.993,40563,16495,24068,6.731,16.552,42629,15205,27424,6.204,17.395,-2066,-0.843,33.104,2135,2169,10129
1981,17,182452,215243,4081030,4119790,23786,11.067,23148,10.770,547482,203415,344067,4.938,13.289,625165,168526,456639,4.091,15.175,-77683,-1.886,26.578,16676,16928,96394
1981,18,82838,100747,1775887,1792947,10332,10.237,10703,10.604,218009,74491,143518,4.155,12.159,252538,68546,183992,3.823,14.085,-34529,-1.926,24.319,7703,7824,37545
1981,19,56392,66759,876216,886309,6873,10.297,6844,10.254,121889,59870,62019,6.755,13.752,141994,48415,93579,5.463,16.021,-20105,-2.268,27.505,5248,5332,23073
1981,20,47821,56127,782283,775406,6716,12.023,6180,11.064,128391,47519,80872,6.128,16.558,116086,35052,81034,4.520,14.971,12305,1.587,29.942,4542,4605,21307
1981,21,52481,62230,953697,957491,7100,11.404,7153,11.490,136108,50185,85923,5.241,14.215,143735,42453,101282,4.434,15.012,-7627,-0.797,28.430,5263,5310,25396
1981,22,66832,79803,1323183,1290216,11141,14.155,8946,11.366,254255,87636,166619,6.792,19.706,187422,63497,123925,4.921,14.526,66833,5.180,29.053,6552,6640,35731
1981,23,20185,23292,322071,322096,2641,11.343,2625,11.274,44960,14745,30215,4.578,13.959,44799,14885,29914,4.621,13.909,161,0.050,27.817,1933,1947,7942
1981,24,63550,76511,1314373,1308787,9071,11.946,7919,10.429,202998,73818,129180,5.640,15.510,192065,55863,136202,4.268,14.675,10933,0.835,29.350,5515,5612,30888
1981,25,100411,117196,2323063,2303609,12331,10.599,10626,9.133,360989,123381,237608,5.356,15.671,320756,108195,212561,4.697,13.924,40233,1.747,27.848,7320,7444,54695
1981,26,129724,156713,2844634,2883905,16948,10.793,17569,11.189,381920,136277,245643,4.725,13.243,459952,127483,332469,4.421,15.949,-78032,-2.706,26.486,12111,12345,63824
1981,27,71690,84858,1465604,1471758,9273,10.967,8662,10.245,212652,76104,136548,5.171,14.449,225337,67015,158322,4.553,15.311,-12685,-0.862,28.898,6047,6154,36408
1981,28,37022,43857,613108,614163,5234,11.921,5329,12.138,89779,32164,57615,5.237,14.618,91743,25765,65978,4.195,14.938,-1964,-0.320,29.236,4074,4123,18273
1981,29,83688,99923,1632790,1636400,11653,11.684,11283,11.313,237232,92427,144805,5.648,14.497,244708,76116,168592,4.651,14.954,-7476,-0.457,28.994,8190,8318,41273
1981,30,18117,20662,208325,208113,2758,13.407,2576,12.522,38058,14503,23555,6.969,18.287,37973,13379,24594,6.429,18.246,85,0.041,36.493,1872,1890,8347
1981,31,32430,37545,491623,486965,3999,10.672,3856,10.290,77239,25876,51363,5.314,15.861,68485,21271,47214,4.368,14.064,8754,1.798,28.127,2828,2863,13335
1981,32,16880,19494,351120,347029,3425,17.915,2674,13.986,71869,30348,41521,8.745,20.710,63154,22426,40728,6.462,18.199,8715,2.511,36.397,1980,2010,16472
1981,33,18727,21120,334117,330877,2655,12.689,2263,10.815,51629,18909,32720,5.715,15.604,45480,11857,33623,3.584,13.745,6149,1.858,27.491,1661,1698,7756
1981,34,137030,156241,2617270,2594781,17644,11.338,16385,10.529,410138,137365,272773,5.294,15.806,365957,113364,252593,4.369,14.104,44181,1.703,28.207,11708,11846,55792
1981,35,23484,27376,338967,334887,4102,15.096,3696,13.602,69713,27707,42006,8.274,20.817,61359,21730,39629,6.489,18.322,8354,2.495,36.645,2675,2698,13244
1981,36,319775,362634,5998567,5963925,40150,11.100,38303,10.589,929553,293666,635887,4.924,15.586,860917,268526,592391,4.503,14.435,68636,1.151,28.871,28544,28864,160746
1981,37,93131,113765,2009621,2004382,13606,12.007,12709,11.215,273320,102955,170365,5.136,13.636,260817,81962,178855,4.089,13.012,12503,0.624,26.025,9050,9156,42715
1981,38,14210,16266,175352,175014,1896,11.736,1674,10.362,28069,11437,16632,6.535,16.038,27371,7625,19746,4.357,15.639,698,0.399,31.279,1239,1252,5524
1981,39,159080,199322,3624492,3677357,20333,10.202,20283,10.177,438841,161794,277047,4.400,11.934,545872,140681,405191,3.826,14.844,-107031,-2.911,23.867,13982,14250,69071
1981,40,56397,66141,939893,911119,10178,15.632,8118,12.468,190229,75125,115104,8.245,20.879,133035,44476,88559,4.881,14.601,57194,6.277,29.203,6185,6272,30405
1981,41,53609,62267,821482,830837,8937,14.391,8609,13.862,134899,55875,79024,6.725,16.237,153857,48007,105850,5.778,18.518,-18958,-2.282,32.473,6246,6332,29628
1981,42,179301,217017,4003677,4025594,20644,9.485,21924,10.073,503110,181588,321522,4.511,12.498,548671,152805,395866,3.796,13.630,-45561,-1.132,24.996,15572,15817,81483
1981,44,18715,20857,339069,338961,2151,10.334,2067,9.930,48416,18382,30034,5.423,14.284,48021,12468,35553,3.678,14.167,395,0.117,28.334,1489,1497,7141
1981,45,46562,56117,962775,960077,7181,12.891,6360,11.417,140354,54789,85565,5.707,14.619,134952,36403,98549,3.792,14.056,5402,0.563,28.113,4660,4732,21551
1981,46,14666,16619,175199,177769,1774,10.629,1917,11.486,23951,9367,14584,5.269,13.473,29046,8934,20112,5.026,16.339,-5095,-2.866,26.946,1386,1396,5776
1981,47,69776,84210,1422010,1426718,10316,12.262,10159,12.075,208356,79482,128874,5.571,14.604,217191,65566,151625,4.596,15.223,-8835,-0.619,29.208,7548,7628,36557
1981,48,252357,313870,5167893,5023990,49952,16.239,37438,12.170,1059622,415484,644138,8.270,21.091,770600,258391,512209,5.143,15.338,289022,5.753,30.677,26923,27391,158514
1981,49,24175,28524,430105,434220,4578,16.247,3885,13.788,80291,34921,45370,8.042,18.491,89075,27155,61920,6.254,20.514,-8784,-2.023,36.982,2846,2885,15183
1981,50,11594,12917,169823,168087,1502,11.670,1410,10.955,24887,7186,17701,4.275,14.806,21323,6097,15226,3.627,12.686,3564,2.120,25.371,1029,1036,4194
1981,51,81001,99542,1663392,1646917,12268,12.413,10844,10.972,258176,108451,149725,6.585,15.676,224550,70172,154378,4.261,13.635,33626,2.042,27.269,7778,7928,37872
1981,53,77177,91207,1270524,1265441,12940,14.302,11483,12.691,226841,88239,138602,6.973,17.926,215363,65383,149980,5.167,17.019,11478,0.907,34.038,8270,8360,40996
1981,54,27223,32069,483573,483944,3802,11.846,3856,12.014,67501,26772,40729,5.532,13.948,68342,19689,48653,4.068,14.122,-841,-0.174,27.896,2857,2875,12982
1981,55,82186,95741,1586878,1601028,9479,9.941,8695,9.119,195104,73594,121510,4.597,12.186,222294,48917,173377,3.055,13.884,-27190,-1.698,24.372,6367,6463,30343
1981,56,11740,13292,159603,155206,2098,16.054,1651,12.633,36451,12410,24041,7.996,23.486,27417,8687,18730,5.597,17.665,9034,5.821,35.330,1235,1240,5838
1982,01,53618,65707,1038220,1054311,7645,11.505,9130,13.740,155532,55423,100109,5.257,14.752,188138,59084,129054,5.604,17.845,-32606,-3.093,29.504,6581,6652,38108
1982,02,8098,9567,130484,124909,1830,19.673,1300,13.975,37902,13493,24409,10.802,30.344,26881,8607,18274,6.891,21.521,11021,8.823,43.041,867,877,4929
1982,04,47194,57916,843074,841201,9530,16.693,7877,13.798,159735,65178,94557,7.748,18.989,156263,47435,108828,5.639,18.576,3472,0.413,37.152,5735,5765,31690
1982,05,36486,42463,576269,586177,5433,12.733,5842,13.692,84057,30345,53712,5.177,14.340,103804,30889,72915,5.270,17.709,-19747,-3.369,28.680,4252,4283,19793
1982,06,430808,523125,8305460,8354193,73726,14.103,73020,13.968,1482120,542512,939608,6.494,17.741,1579058,523441,1055617,6.266,18.901,-96938,-1.160,35.482,51455,52186,294356
1982,08,62946,74275,1114084,1100066,11969,16.306,10228,13.934,227747,87524,140223,7.956,20.703,200430,67531,132899,6.139,18.220,27317,2.483,36.440,7423,7492,41742
1982,09,59551,68449,1285005,1291106,7236,10.584,7068,10.339,172554,52276,120278,4.049,13.365,183203,49262,133941,3.815,14.190,-10649,-0.825,26.730,5014,5089,24917
1982,10,10408,12039,240039,239425,1350,11.206,1367,11.347,31568,9130,22438,3.813,13.185,30504,9421,21083,3.935,12.741,1064,0.444,25.481,934,944,5168
1982,11,13301,15291,317841,327849,1975,12.938,1923,12.597,47186,17395,29791,5.306,14.393,66779,17096,49683,5.215,20.369,-19593,-5.976,28.785,1314,1328,11392
1982,12,194549,234361,3187280,3184237,36684,15.809,32065,13.818,613722,242510,371212,7.616,19.274,607154,201610,405544,6.332,19.067,6568,0.206,38.135,23838,24093,132584
1982,13,86296,107455,1770006,1773794,13763,12.811,13722,12.772,286212,105571,180641,5.952,16.136,292898,90575,202323,5.106,16.513,-6686,-0.377,32.271,9608,9731,52155
1982,15,17912,21775,311934,316603,2766,12.701,2773,12.733,50005,20332,29673,6.422,15.794,59089,17489,41600,5.524,18.663,-9084,-2.869,31.589,1971,1991,12012
1982,16,17244,20325,236180,240287,2690,13.143,2975,14.535,40205,16819,23386,7.000,16.732,48313,15948,32365,6.637,20.106,-8108,-3.374,33.464,2104,2116,10071
1982,17,180192,213510,3893830,3976907,23008,10.733,24704,11.525,503545,185201,318344,4.657,12.662,669069,196623,472446,4.944,16.824,-165524,-4.162,25.323,17375,17663,100109
1982,18,81514,99718,1691708,1733831,10264,10.239,11315,11.288,202385,66743,135642,3.849,11.673,286332,72045,214287,4.155,16.514,-83947,-4.842,23.345,7941,8063,38980
1982,19,54661,65177,834138,855434,6243,9.462,7847,11.893,103411,38241,65170,4.470,12.089,145550,43234,102316,5.054,17.015,-42139,-4.926,24.177,5759,5814,26524
1982,20,47335,55838,766598,775549,6550,11.699,6852,12.238,111094,40638,70456,5.240,14.325,129235,40363,88872,5.204,16.664,-18141,-2.339,28.649,4994,5053,27419
1982,21,51872,61923,935981,945391,7367,11.867,7680,12.371,137603,53268,84335,5.634,14.555,155511,43748,111763,4.628,16.449,-17908,-1.894,29.110,5654,5692,26679
1982,22,68183,81746,1333891,1328320,11413,14.124,9527,11.790,253715,90090,163625,6.782,19.100,242771,77407,165364,5.827,18.277,10944,0.824,36.553,7026,7101,44309
1982,23,19861,23020,322562,322511,2480,10.710,2752,11.885,50488,17223,33265,5.340,15.655,49840,19001,30839,5.892,15.454,648,0.201,30.908,1941,1959,10255
1982,24,63463,76853,1310143,1312656,9035,11.782,8698,11.343,208219,76441,131778,5.823,15.862,212856,63395,149461,4.830,16.216,-4637,-0.353,31.725,5916,6026,34073
1982,25,100481,117853,2322396,2329923,12316,10.478,11704,9.957,317160,102667,214493,4.406,13.612,331328,92101,239227,3.953,14.221,-14168,-0.608,27.225,8164,8247,52240
1982,26,126916,154349,2700089,2750975,16451,10.577,18831,12.107,367386,114359,253027,4.157,13.355,470616,138512,332104,5.035,17.107,-103230,-3.752,26.710,12766,12983,65877
1982,27,71024,84605,1432166,1449625,9045,10.670,9368,11.052,199811,70005,129806,4.829,13.784,233356,63318,170038,4.368,16.098,-33545,-2.314,27.567,6581,6642,34430
1982,28,35976,42994,599618,607679,5003,11.519,5881,13.540,85077,31727,53350,5.221,14.000,100701,32788,67913,5.396,16.571,-15624,-2.571,28.001,4162,4191,20756
1982,29,81843,98439,1606180,1618405,11044,11.134,12551,12.653,233953,82670,151283,5.108,14.456,256715,79068,177647,4.886,15.862,-22762,-1.406,28.912,8785,8903,43640
1982,30,17883,20482,202452,205304,2641,12.837,2823,13.722,35582,13621,21961,6.635,17.331,41319,13423,27896,6.538,20.126,-5737,-2.794,34.663,1973,1987,9255
1982,31,31918,37090,473226,482207,3882,10.402,4345,11.642,64601,24164,40437,5.011,13.397,82195,23558,58637,4.885,17.046,-17594,-3.649,26.794,3079,3149,13917
1982,32,16997,19784,351671,351326,3251,16.551,2968,15.110,73448,30958,42490,8.812,20.906,72272,25541,46731,7.270,20.571,1176,0.335,41.142,2089,2103,14306
1982,33,18738,21197,342714,338496,2599,12.285,2517,11.897,61664,19915,41749,5.883,18.217,53087,19778,33309,5.843,15.683,8577,2.534,31.366,1733,1752,9750
1982,34,136828,156503,2610532,2611285,17305,11.067,17030,10.891,402371,123118,279253,4.715,15.409,403999,123593,280406,4.733,15.471,-1628,-0.062,30.818,12174,12276,63911
1982,35,23593,27718,348084,343786,4112,14.925,3778,13.713,70880,25934,44946,7.544,20.618,62437,21683,40754,6.307,18.162,8443,2.456,36.323,2651,2680,13372
1982,36,316977,360539,5928283,5938037,39089,10.810,41210,11.397,871628,275145,596483,4.634,14.679,891986,288492,603494,4.858,15.022,-20358,-0.343,29.357,30451,30720,165260
1982,37,92020,113424,1986597,2000284,13276,11.684,13679,12.039,261854,92881,168973,4.643,13.091,287776,82916,204860,4.145,14.387,-25922,-1.296,26.182,9683,9818,44057
1982,38,14126,16293,178312,176997,1918,11.774,1911,11.731,30665,10825,19840,6.116,17.325,27915,9063,18852,5.120,15.771,2750,1.554,31.543,1379,1393,6287
1982,39,156321,197028,3498944,3557633,19828,10.003,22197,11.199,447172,147729,299443,4.152,12.569,565121,150745,414376,4.237,15.885,-117949,-3.315,25.139,14962,15209,77676
1982,40,57884,68037,992551,966238,10708,15.959,8829,13.158,213649,77906,135743,8.063,22.111,160781,55671,105110,5.762,16.640,52868,5.472,33.280,6572,6643,36333
1982,41,51559,60703,766437,796196,8193,13.322,9788,15.915,116947,48535,68412,6.096,14.688,176425,49566,126859,6.225,22.159,-59478,-7.470,29.376,7104,7194,32577
1982,42,176896,215429,3950969,3972168,20952,9.690,22546,10.427,537896,180854,357042,4.553,13.542,579053,162784,416269,4.098,14.578,-41157,-1.036,27.083,15460,15725,81751
1982,44,18459,20620,331946,335646,2029,9.777,2293,11.050,45397,15536,29861,4.629,13.525,52555,14942,37613,4.452,15.658,-7158,-2.133,27.051,1637,1649,9190
1982,45,45724,55688,944453,953401,6768,12.105,7213,12.901,135658,50047,85611,5.249,14.229,154152,41416,112736,4.344,16.169,-18494,-1.940,28.458,5178,5231,26026
1982,46,14399,16371,172184,174278,1773,10.746,2029,12.298,25936,10738,15198,6.161,14.882,30156,9298,20858,5.335,17.303,-4220,-2.421,29.764,1466,1479,6221
1982,47,68695,83685,1398252,1411213,10538,12.550,11098,13.217,213811,79054,134757,5.602,15.151,238455,68530,169925,4.856,16.897,-24644,-1.746,30.302,7983,8089,41150
1982,48,258649,324124,5453807,5311175,50548,15.841,40492,12.690,1167942,402564,765378,7.580,21.990,885498,301483,584015,5.676,16.672,282444,5.318,33.345,29250,29780,180093
1982,49,23952,28613,433157,431680,4201,14.698,4140,14.484,80243,30156,50087,6.986,18.589,77296,26168,51128,6.062,17.906,2947,0.683,35.812,2963,2992,16694
1982,50,11702,13055,167620,168566,1619,12.468,1479,11.390,22136,7293,14843,4.326,13.132,24201,7827,16374,4.643,14.357,-2065,-1.225,26.264,1083,1088,4407
1982,51,80468,99859,1651923,1655626,11979,12.010,11748,11.778,248735,88873,159862,5.368,15.024,255731,76024,179707,4.592,15.446,-6996,-0.423,30.047,8247,8368,43497
1982,53,76414,91134,1228577,1243629,12608,13.825,12740,13.969,210091,78809,131282,6.337,16.893,240215,69369,170846,5.578,19.316,-30124,-2.422,33.787,8838,8918,44275
1982,54,26550,31536,471503,478166,3527,11.084,4096,12.872,64142,22248,41894,4.653,13.414,77389,21854,55535,4.570,16.185,-13247,-2.770,26.828,2902,2933,12828
1982,55,81249,95339,1553133,1569141,9438,9.877,9869,10.328,191878,62948,128930,4.012,12.228,224552,56279,168273,3.587,14.311,-32674,-2.082,24.456,6978,7056,31863
1982,56,11846,13556,157822,158820,2157,16.070,1890,14.081,32368,12371,19997,7.789,20.380,34295,10917,23378,6.874,21.594,-1927,-1.213,40.761,1413,1421,7050
1983,01,53723,65387,1002074,1021668,8379,12.781,8722,13.304,160371,55151,105220,5.398,15.697,199534,75760,123774,7.415,19.530,-39163,-3.833,31.394,5578,5710,31742
1983,02,9170,10814,136225,133109,2540,24.926,1292,12.679,38189,17227,20962,12.942,28.690,32116,11705,20411,8.794,24.128,6073,4.562,48.255,870,888,6463
1983,04,49203,60306,851921,847662,10070,17.033,7700,13.024,175190,67841,107349,8.003,20.667,166539,55352,111187,6.530,19.647,8651,1.021,39.294,5203,5272,30503
1983,05,37168,43214,574095,574557,5815,13.572,5081,11.858,91082,31351,59731,5.457,15.853,92133,31849,60284,5.543,16.035,-1051,-0.183,31.705,3610,3658,16450
1983,06,438966,531420,8225358,8249194,76013,14.416,67756,12.850,1543066,524743,1018323,6.361,18.706,1593132,552795,1040337,6.701,19.313,-50066,-0.607,37.411,44929,45723,270581
1983,08,64793,76408,1107249,1112024,12260,16.268,10165,13.488,219995,91513,128482,8.229,19.783,230137,69955,160182,6.291,20.695,-10142,-0.912,39.567,7153,7226,41194
1983,09,60780,69861,1289720,1286885,8030,11.618,6540,9.462,182637,58625,124012,4.556,14.192,177492,49076,128416,3.814,13.792,5145,0.400,27.585,4518,4562,21957
1983,10,10822,12496,248590,244610,1670,13.610,1219,9.934,38345,13490,24855,5.515,15.676,30008,8373,21635,3.423,12.268,8337,3.408,24.535,801,810,4252
1983,11,13847,15854,324063,321355,2241,14.383,1694,10.873,60484,22906,37578,7.128,18.822,56265,16633,39632,5.176,17.509,4219,1.313,35.017,1121,1135,7769
1983,12,203989,245234,3222097,3205830,40589,16.920,29887,12.459,629727,260220,369507,8.117,19.643,597420,210699,386721,6.572,18.635,32307,1.008,37.271,21401,21697,119587
1983,13,89306,110911,1815006,1790050,15815,14.485,12358,11.319,342308,141503,200805,7.905,19.123,295621,106483,189138,5.949,16.515,46687,2.608,33.029,8282,8406,47797
1983,15,18618,22510,309467,310532,3174,14.338,2428,10.968,51526,21983,29543,7.079,16.593,53588,18866,34722,6.075,17.257,-2062,-0.664,33.186,1649,1688,11593
1983,16,17555,20630,235007,235564,2871,14.019,2569,12.545,41417,17137,24280,7.275,17.582,42422,16430,25992,6.975,18.009,-1005,-0.427,35.164,1792,1821,8699
1983,17,183198,216843,3851099,3876346,25626,11.905,22433,10.422,592353,221468,370885,5.713,15.281,645919,181844,464075,4.691,16.663,-53566,-1.382,30.562,15546,15843,89674
1983,18,83161,101324,1677916,1685010,12373,12.307,10803,10.745,250634,106938,143696,6.346,14.874,263387,68501,194886,4.065,15.631,-12753,-0.757,29.749,7662,7795,38071
1983,19,54836,65369,837881,836998,6829,10.459,6673,10.220,147119,73294,73825,8.757,17.577,147012,47629,99383,5.690,17.564,107,0.013,35.128,4829,4877,22468
1983,20,48105,56598,727818,747327,6928,12.321,6190,11.009,108262,38276,69986,5.122,14.487,146876,49246,97630,6.590,19.654,-38614,-5.167,28.973,4390,4460,21640
1983,21,52060,61853,910248,923060,7686,12.423,7717,12.473,136991,54994,81997,5.958,14.841,162590,59236,103354,6.417,17.614,-25599,-2.773,29.682,5162,5212,27077
1983,22,69682,83140,1235146,1285756,11212,13.598,9833,11.926,210145,76349,133796,5.938,16.344,311591,87138,224453,6.777,24.234,-101446,-7.890,32.688,7061,7151,45941
1983,23,20148,23314,326775,324549,2871,12.411,2508,10.842,50699,16134,34565,4.971,15.621,46331,16060,30271,4.948,14.276,4368,1.346,28.551,1679,1699,8278
1983,24,65995,79631,1340512,1326985,10388,13.273,7657,9.783,226978,74950,152028,5.648,17.105,200643,65195,135448,4.913,15.120,26335,1.985,30.240,5140,5226,29651
1983,25,102838,120466,2355718,2341037,13741,11.530,11161,9.365,366934,120796,246138,5.160,15.674,337456,99060,238396,4.231,14.415,29478,1.259,28.830,7573,7692,50370
1983,26,130091,157730,2685736,2684935,19533,12.514,16256,10.414,430342,161869,268473,6.029,16.028,427423,131891,295532,4.912,15.919,2919,0.109,31.839,10802,11028,66724
1983,27,72520,86113,1408898,1421819,9875,11.564,8437,9.880,207955,79568,128387,5.596,14.626,234525,66128,168397,4.651,16.495,-26570,-1.869,29.252,5726,5808,31473
1983,28,36268,43006,580185,589246,5574,12.964,5556,12.922,89050,32022,57028,5.434,15.113,107132,42028,65104,7.133,18.181,-18082,-3.069,30.225,3621,3672,17090
1983,29,84005,100542,1594441,1601222,12936,12.997,10912,10.964,245669,81806,163863,5.109,15.343,259311,81171,178140,5.069,16.195,-13642,-0.852,30.685,7421,7552,39614
1983,30,18348,20954,204564,203576,2904,14.017,2431,11.734,42069,20542,21527,10.091,20.665,39866,13634,26232,6.697,19.583,2203,1.082,39.166,1680,1706,8803
1983,31,32368,37528,465611,469368,4229,11.335,3793,10.166,69141,24007,45134,5.115,14.731,77032,25671,51361,5.469,16.412,-7891,-1.681,29.461,2603,2634,12571
1983,32,17269,20064,336847,344951,3192,16.016,2924,14.671,59633,26395,33238,7.652,17.287,76371,26652,49719,7.726,22.140,-16738,-4.852,34.575,1979,2001,16201
1983,33,19373,21929,339481,339029,2987,13.856,2245,10.414,54404,20433,33971,6.027,16.047,53308,16684,36624,4.921,15.724,1096,0.323,31.447,1527,1546,8704
1983,34,140285,160127,2637575,2624704,19443,12.278,15896,10.038,442094,143022,299072,5.449,16.844,418091,140663,277428,5.359,15.929,24003,0.915,31.858,11026,11118,58866
1983,35,24572,28732,341356,344870,4543,16.091,3545,12.556,67479,28318,39161,8.211,19.567,74340,24259,50081,7.034,21.556,-6861,-1.989,39.133,2421,2454,14072
1983,36,323992,367784,5922186,5931754,45249,12.426,37985,10.431,948783,321744,627039,5.424,15.995,967810,311508,656302,5.252,16.316,-19027,-0.321,31.990,27862,28198,177466
1983,37,94995,116751,1991069,1984150,15431,13.405,12156,10.560,288088,105151,182937,5.300,14.519,274591,84913,189678,4.280,13.839,13497,0.680,27.678,8673,8815,42394
1983,38,14310,16477,175020,176667,1959,11.956,1774,10.827,28044,11572,16472,6.550,15.874,31435,10176,21259,5.760,17.793,-3391,-1.919,31.748,1265,1287,6470
1983,39,158032,198503,3406134,3438373,21768,11.011,20158,10.196,490221,181894,308327,5.290,14.257,554175,152282,401893,4.429,16.117,-63954,-1.860,28.515,13086,13405,71631
1983,40,58990,69211,919192,955214,10207,14.877,9003,13.122,162269,66666,95603,6.979,16.988,234628,68593,166035,7.181,24.563,-72359,-7.575,33.975,6761,6843,42607
1983,41,51740,60855,753083,760142,8358,13.748,8237,13.549,127849,44498,83351,5.854,16.819,141660,47468,94192,6.245,18.636,-13811,-1.817,33.638,5634,5769,29104
1983,42,180138,218682,3897481,3927505,23865,10.994,20648,9.512,583786,214508,369278,5.462,14.864,643633,180664,462969,4.600,16.388,-59847,-1.524,29.728,13595,13911,79646
1983,44,18560,20662,329803,330570,2209,10.727,2070,10.052,44734,11462,33272,3.467,13.532,46201,14806,31395,4.479,13.976,-1467,-0.444,27.065,1448,1456,7440
1983,45,47082,57284,931931,938679,7913,14.007,6335,11.213,141109,51220,89889,5.457,15.033,155017,45839,109178,4.883,16.514,-13908,-1.482,30.065,4523,4577,23629
1983,46,14508,16449,169967,170939,1829,11.141,1764,10.745,25169,8896,16273,5.204,14.724,27028,8990,18038,5.259,15.812,-1859,-1.088,29.448,1214,1238,5427
1983,47,69413,83954,1381834,1391032,11260,13.434,10985,13.106,221481,82062,139419,5.899,15.922,239515,88975,150540,6.396,17.219,-18034,-1.296,31.844,7115,7245,40638
1983,48,267964,334983,5256185,5365515,53078,16.105,42264,12.824,1006423,420817,585606,7.843,18.757,1227108,346699,880409,6.462,22.870,-220685,-4.113,37.514,29645,30294,190257
1983,49,24469,29231,426475,429887,4375,15.124,3768,13.026,80439,33161,47278,7.714,18.712,87100,28326,58774,6.589,20.261,-6661,-1.549,37.423,2550,2594,15312
1983,50,11854,13218,166859,167389,1650,12.571,1465,11.161,22796,8060,14736,4.815,13.619,23907,6378,17529,3.810,14.282,-1111,-0.664,27.237,1038,1043,4127
1983,51,82838,102649,1653847,1649537,13178,13.015,10383,10.255,258786,85601,173185,5.189,15.688,249785,77323,172462,4.688,15.143,9001,0.546,30.285,7053,7233,39509
1983,53,79012,93801,1215862,1222654,13892,15.025,11209,12.123,214920,79119,135801,6.471,17.578,227465,69915,157550,5.718,18.604,-12545,-1.026,35.156,7528,7695,41277
1983,54,26390,31366,435443,451162,3636,11.562,3798,12.077,64710,31442,33268,6.969,14.343,95708,25217,70491,5.589,21.214,-30998,-6.871,28.686,2609,2663,13607
1983,55,82774,96885,1510263,1532032,10642,11.085,8872,9.242,198510,70219,128291,4.583,12.957,241778,59459,182319,3.881,15.782,-43268,-2.824,25.915,6102,6211,32620
1983,56,11811,13505,137574,147608,1930,14.270,1970,14.566,25143,11094,14049,7.516,17.034,45017,12409,32608,8.407,30.498,-19874,-13.464,34.067,1416,1435,7689
1984,01,57363,69567,1095073,1048950,10767,15.954,6610,9.794,215939,75400,140539,7.188,20.586,123329,41356,81973,3.943,11.757,92610,8.829,23.515,4898,4953,26588
1984,02,10246,11977,146329,142052,2628,23.056,1471,12.905,38108,15743,22365,11.083,26.827,29609,10122,19487,7.126,20.844,8499,5.983,41.688,1030,1050,6763
1984,04,53063,64437,962733,907929,11406,18.283,7302,11.705,236170,88588,147582,9.757,26.012,126839,48790,78049,5.374,13.970,109331,12.042,27.940,5014,5118,27723
1984,05,39276,45434,639069,607427,7090,15.988,4913,11.079,134235,55923,78312,9.207,22.099,72215,27649,44566,4.552,11.889,62020,10.210,23.777,3560,3637,16722
1984,06,462364,556592,8925349,8561988,86017,15.807,61161,11.239,1967558,694711,1272847,8.114,22.980,1242982,472820,770162,5.522,14.517,724576,8.463,29.035,41972,42725,251193
1984,08,68460,80491,1177040,1142848,13639,17.381,9594,12.227,264248,112759,151489,9.866,23.122,195642,72115,123527,6.310,17.119,68606,6.003,34.238,7034,7119,38802
1984,09,63521,72802,1362838,1324171,8909,12.489,5970,8.369,224862,73132,151730,5.523,16.981,147969,47573,100396,3.593,11.174,76893,5.807,22.349,4267,4323,24360
1984,10,11188,12901,240275,233932,1715,13.504,1312,10.331,41116,13939,27177,5.959,17.576,28557,9725,18832,4.157,12.207,12559,5.369,24.415,883,889,5318
1984,11,14012,16100,340243,331753,2185,13.676,1938,12.130,61628,21023,40605,6.337,18.576,44361,15878,28483,4.786,13.372,17267,5.205,26.743,1357,1389,9239
1984,12,216225,259147,3553667,3390992,43970,17.428,30258,11.993,808570,323717,484853,9.546,23.845,484505,190486,294019,5.617,14.288,324065,9.557,28.576,22291,22624,121326
1984,13,95302,117639,1982044,1898764,18436,16.128,11784,10.309,403819,145895,257924,7.684,21.267,236435,83787,152648,4.413,12.452,167384,8.815,24.904,8155,8262,46454
1984,15,18952,22877,317256,313565,2905,12.806,2521,11.113,52939,18589,34350,5.928,16.883,45478,16505,28973,5.264,14.504,7461,2.379,29.007,1720,1778,9752
1984,16,18423,21570,249070,242094,3247,15.392,2298,10.893,47361,16683,30678,6.891,19.563,33623,12715,20908,5.252,13.888,13738,5.675,27.777,1696,1708,8319
1984,17,186429,220752,3989807,3919422,27150,12.408,23284,10.641,661753,215608,446145,5.501,16.884,516807,203381,313426,5.189,13.186,144946,3.698,26.372,16822,17057,119975
1984,18,85794,104208,1793184,1736090,14163,13.776,11366,11.055,326034,116175,209859,6.692,18.780,211632,94621,117011,5.450,12.190,114402,6.590,24.380,8553,8680,50346
1984,19,55933,66634,870273,854141,7726,11.702,6505,9.853,134374,45323,89051,5.306,15.732,102473,35080,67393,4.107,11.997,31901,3.735,23.994,4808,4888,21851
1984,20,49910,58589,776387,752374,8037,13.954,6051,10.506,147028,51098,95930,6.792,19.542,97668,37374,60294,4.967,12.981,49360,6.561,25.963,4427,4474,23897
1984,21,54795,65056,968316,939528,9363,14.755,6162,9.711,173616,72598,101018,7.727,18.479,115689,38406,77283,4.088,12.314,57927,6.166,24.627,4676,4741,27118
1984,22,71682,85621,1267867,1249847,12493,14.804,10028,11.883,239188,93028,146160,7.443,19.137,204322,69560,134762,5.565,16.348,34866,2.790,32.696,7432,7557,39898
1984,23,21558,24831,348558,337202,3574,14.843,2071,8.601,58329,19827,38502,5.880,17.298,35438,12991,22447,3.853,10.509,22891,6.789,21.019,1463,1487,6631
1984,24,68774,82932,1451917,1394964,11343,13.949,8117,9.982,282409,101028,181381,7.242,20.245,167630,58713,108917,4.209,12.017,114779,8.228,24.034,5672,5759,31990
1984,25,107785,125893,2520996,2430570,15450,12.544,9993,8.114,448730,151129,297601,6.218,18.462,267365,82717,184648,3.403,11.000,181365,7.462,22.000,7023,7121,43869
1984,26,135362,163319,2881256,2747397,20915,13.028,15344,9.558,573975,213045,360930,7.754,20.892,307935,116197,191738,4.229,11.208,266040,9.683,22.416,10785,10971,55816
1984,27,75729,89610,1511053,1459205,11691,13.302,8254,9.391,272260,90025,182235,6.169,18.658,169298,62433,106865,4.279,11.602,102962,7.056,23.204,5811,5934,35309
1984,28,38363,45507,629344,605094,6912,15.614,4432,10.012,120203,45729,74474,7.557,19.865,71277,23314,47963,3.853,11.779,48926,8.086,23.559,3351,3381,15434
1984,29,86804,103732,1698028,1644235,14303,14.000,11171,10.934,314006,112072,201934,6.816,19.097,205964,72296,133668,4.397,12.526,108042,6.571,25.053,8115,8220,42124
1984,30,19290,21956,208835,206773,3341,15.571,2342,10.915,41243,18029,23214,8.719,19.946,37492,10903,26589,5.273,18.132,3751,1.814,36.264,1676,1696,7204
1984,31,33427,38688,491878,478667,4795,12.579,3655,9.589,88147,36954,51193,7.720,18.415,61284,20423,40861,4.267,12.803,26863,5.612,25.606,2666,2703,12935
1984,32,18392,21282,371843,354443,3685,17.819,2482,12.002,80110,29865,50245,8.426,22.602,45245,17019,28226,4.802,12.765,34865,9.837,25.530,1723,1738,9529
1984,33,20948,23632,383383,362153,3696,16.222,2000,8.778,80662,30591,50071,8.447,22.273,38407,13127,25280,3.625,10.605,42255,11.668,21.210,1431,1457,7874
1984,34,145073,165639,2799718,2714530,20722,12.720,15272,9.374,517257,161732,355525,5.958,19.055,347747,116402,231345,4.288,12.811,169510,6.245,25.621,10881,10988,57158
1984,35,25774,29980,374173,358118,4846,16.499,3630,12.359,89284,42664,46620,11.913,24.931,57568,20159,37409,5.629,16.075,31716,8.856,32.150,2580,2615,13174
1984,36,330830,375283,6173119,6051557,45787,12.322,38414,10.338,1018894,326315,692579,5.392,16.837,772770,255867,516903,4.228,12.770,246124,4.067,25.540,28511,28779,150868
1984,37,101647,124070,2165101,2079123,19970,16.581,12704,10.548,385671,128844,256827,6.197,18.550,213308,80940,132368,3.893,10.260,172363,8.290,20.519,9759,9831,50440
1984,38,14850,17082,181303,178206,2227,13.271,1625,9.684,31293,12855,18438,7.214,17.560,25095,9000,16095,5.050,14.082,6198,3.478,28.164,1179,1189,5483
1984,39,163249,203926,3588050,3488938,23622,11.737,18292,9.089,594376,186721,407655,5.352,17.036,395810,132516,263294,3.798,11.345,198566,5.691,22.689,12393,12645,65347
1984,40,60678,71157,932156,924581,11034,15.722,9081,12.939,178619,73609,105010,7.961,19.319,162748,59368,103380,6.421,17.602,15871,1.717,35.205,6973,7054,37891
1984,41,54414,63729,803619,777836,9802,15.735,6929,11.123,160930,55303,105627,7.110,20.689,108513,37854,70659,4.867,13.951,52417,6.739,27.901,5016,5083,22630
1984,42,184513,223479,3985509,3926147,25622,11.588,20885,9.446,630773,203122,427651,5.174,16.066,513473,177512,335961,4.521,13.078,117300,2.988,26.157,14138,14374,105566
1984,44,19302,21394,354749,342430,2569,12.205,1879,8.927,61882,19053,42829,5.564,18.071,37410,12423,24987,3.628,10.925,24472,7.147,21.850,1329,1356,6863
1984,45,50196,60757,1000132,967245,9977,16.898,6549,11.092,179841,62235,117606,6.434,18.593,113593,45321,68272,4.686,11.744,66248,6.849,23.488,4930,4981,26278
1984,46,15054,17052,180490,175121,2228,13.296,1637,9.769,32020,11387,20633,6.502,18.285,21557,8138,13419,4.647,12.310,10463,5.975,24.620,1173,1184,4455
1984,47,74041,89448,1522001,1452617,14091,16.250,8626,9.947,302072,119827,182245,8.249,20.795,163627,54863,108764,3.777,11.264,138445,9.531,22.529,6459,6565,37328
1984,48,280209,349133,5547850,5397506,57598,16.838,43458,12.705,1228465,495835,732630,9.186,22.760,929184,328024,601160,6.077,17.215,299281,5.545,34.430,31437,32152,192639
1984,49,25439,30301,457864,443073,4588,15.410,3531,11.860,91687,32525,59162,7.341,20.693,62411,26004,36407,5.869,14.086,29276,6.607,28.172,2477,2534,14647
1984,50,12767,14165,177555,172389,2131,15.559,1193,8.711,29351,10087,19264,5.851,17.026,19017,6373,12644,3.697,11.031,10334,5.995,22.063,869,875,3988
1984,51,88145,108673,1781185,1716162,16280,15.401,10348,9.789,326915,115313,211602,6.719,19.049,196488,75455,121033,4.397,11.449,130427,7.600,22.899,7537,7640,41611
1984,53,83909,98997,1319103,1281438,15431,16.003,10289,10.670,267331,103175,164156,8.052,20.862,193940,69681,124259,5.438,15.135,73391,5.727,30.269,7339,7414,35940
1984,54,27488,32522,440498,438124,4645,14.541,3491,10.928,70256,25288,44968,5.772,16.036,65529,22864,42665,5.219,14.957,4727,1.079,29.913,2567,2612,12748
1984,55,85558,100022,1601375,1555294,12133,12.319,9063,9.202,258931,76395,182536,4.912,16.648,166140,57592,108548,3.703,10.682,92791,5.966,21.364,6448,6541,32542
1984,56,11933,13655,138012,137870,1933,14.233,1785,13.143,28688,13648,15040,9.899,20.808,28439,10117,18322,7.338,20.627,249,0.181,41.255,1240,1252,5667
1985,01,58402,70891,1166694,1145422,9921,14.128,8585,12.225,210547,75838,134709,6.621,18.382,168332,67415,100917,5.886,14.696,42215,3.686,29.392,6147,6254,38584
1985,02,10576,12372,152651,149551,2415,19.838,2018,16.577,39312,14458,24854,9.668,26.287,33050,14812,18238,9.904,22.100,6262,4.187,44.199,1497,1511,9923
1985,04,56080,67718,1068467,1015629,11951,18.085,8678,13.132,272013,102355,169658,10.078,26.783,166154,69213,96941,6.815,16.360,105859,10.423,32.719,6136,6255,43976
1985,05,39600,45830,650681,644597,6235,13.663,5845,12.808,113893,37659,76234,5.842,17.669,101265,40420,60845,6.271,15.710,12628,1.959,31.420,4400,4466,25199
1985,06,476472,570480,9303807,9121046,86871,15.415,73007,12.955,1939384,687042,1252342,7.532,21.263,1572751,641684,931067,7.035,17.243,366633,4.020,34.486,50830,51757,366989
1985,08,69679,81884,1217701,1197673,13301,16.384,11901,14.659,251701,92982,158719,7.764,21.016,212718,89358,123360,7.461,17.761,38983,3.255,35.522,8710,8875,58076
1985,09,64944,74400,1430619,1397097,9055,12.303,7460,10.136,240028,64318,175710,4.604,17.180,174305,64685,109620,4.630,12.476,65723,4.704,24.952,5453,5514,36221
1985,10,11522,13269,276369,258585,1803,13.782,1429,10.923,68449,35939,32510,13.898,26.471,33657,12454,21203,4.816,13.016,34792,13.455,26.032,946,965,5960
1985,11,13927,16067,363240,352267,2095,13.028,2123,13.202,79218,22031,57187,6.254,22.488,56013,25324,30689,7.189,15.901,23205,6.587,31.801,1581,1603,15289
1985,12,224524,269185,3766974,3659614,45857,17.359,35832,13.564,835955,327895,508060,8.960,22.843,619535,252654,366881,6.904,16.929,216420,5.914,33.858,26607,27066,164839
1985,13,99152,121975,2128709,2055415,18494,15.438,14129,11.795,430139,146407,283732,7.123,20.927,281756,109491,172265,5.327,13.708,148383,7.219,27.416,9842,10022,63156
1985,15,19053,22993,324429,320754,2806,12.234,2692,11.737,54033,19009,35024,5.926,16.846,47014,18238,28776,5.686,14.657,7019,2.188,29.315,1862,1896,9959
1985,16,18548,21743,253647,251383,3095,14.288,2931,13.531,45426,16498,28928,6.563,18.070,40740,16660,24080,6.627,16.206,4686,1.864,32.413,2127,2160,11330
1985,17,187453,222084,4081568,4037887,26417,11.932,25058,11.318,682874,231547,451327,5.734,16.912,597516,241244,356272,5.975,14.798,85358,2.114,29.595,17916,18309,124289
1985,18,86499,105055,1829830,1810985,12640,12.082,11769,11.249,288746,101294,187452,5.593,15.944,250962,92420,158542,5.103,13.858,37784,2.086,27.716,8421,8610,55125
1985,19,54538,65154,843557,856671,6550,9.940,8028,12.183,119712,40046,79666,4.675,13.974,144476,75232,69244,8.782,16.865,-24764,-2.891,27.948,5896,5991,28762
1985,20,49793,58482,792005,783867,7085,12.105,7177,12.263,136290,49673,86617,6.337,17.387,119686,55003,64683,7.017,15.269,16604,2.118,30.537,5226,5313,31083
1985,21,55273,65520,1027241,996688,8285,12.691,7814,11.969,191387,83661,107726,8.394,19.202,131067,52767,78300,5.294,13.150,60320,6.052,26.301,5752,5847,31075
1985,22,71315,85320,1264161,1265453,11405,13.345,11694,13.683,229335,85983,143352,6.795,18.123,232083,88927,143156,7.027,18.340,-2748,-0.217,36.246,8678,8830,55373
1985,23,22341,25590,352477,350499,3489,13.839,2731,10.833,58954,21563,37391,6.152,16.820,55034,23164,31870,6.609,15.702,3920,1.118,31.403,1886,1921,10951
1985,24,71056,85497,1532678,1482666,12508,14.854,9924,11.786,309557,109803,199754,7.406,20.878,209756,87323,122433,5.890,14.147,99801,6.731,28.294,7076,7227,51131
1985,25,110971,129468,2627638,2574316,16063,12.582,12463,9.762,454870,129041,325829,5.013,17.670,346978,126316,220662,4.907,13.478,107892,4.191,26.957,8949,9165,72493
1985,26,138076,166453,3013911,2954414,20659,12.530,17508,10.619,527253,184997,342256,6.262,17.846,408001,170830,237171,5.782,13.810,119252,4.036,27.620,12604,12880,84008
1985,27,76360,90381,1578675,1544599,11201,12.447,10418,11.577,282007,93745,188262,6.069,18.258,213910,90853,123057,5.882,13.849,68097,4.409,27.698,7507,7670,53251
1985,28,38374,45693,646245,637913,5986,13.127,5804,12.728,113278,45175,68103,7.082,17.758,97169,37610,59559,5.896,15.232,16109,2.525,30.465,4178,4235,22738
1985,29,88187,105232,1738654,1717962,13861,13.268,12338,11.810,292113,100619,191494,5.857,17.003,250634,108122,142512,6.294,14.589,41479,2.414,29.178,8905,9045,57679
1985,30,19226,21829,206315,207581,2860,13.065,2982,13.623,35364,13009,22355,6.267,17.036,37762,15674,22088,7.551,18.191,-2398,-1.155,34.073,2146,2157,9677
1985,31,33063,38322,501038,497137,4368,11.344,4732,12.290,82537,32303,50234,6.498,16.602,74630,33769,40861,6.793,15.012,7907,1.591,30.024,3507,3548,21528
1985,32,18799,21706,387700,378898,3510,16.330,3086,14.357,77923,26979,50944,7.120,20.566,60255,28324,31931,7.475,15.903,17668,4.663,31.805,2166,2188,15377
1985,33,22265,25046,405110,393280,3974,16.329,2557,10.506,81170,26572,54598,6.757,20.639,57393,23819,33574,6.057,14.593,23777,6.046,29.187,1866,1896,14881
1985,34,149077,170268,2929136,2871070,22246,13.246,17602,10.481,539136,169447,369689,5.902,18.778,424754,155361,269393,5.411,14.794,114382,3.984,29.589,12746,12968,93188
1985,35,26061,30304,396962,385711,4579,15.190,4261,14.135,87963,33268,54695,8.625,22.805,65465,29605,35860,7.675,16.973,22498,5.833,33.945,2990,3024,17220
1985,36,336783,381908,6439402,6322099,48915,12.921,42226,11.154,1120228,373346,746882,5.905,17.719,884889,336338,548551,5.320,13.997,235339,3.722,27.994,31905,32386,198675
1985,37,105288,128191,2248292,2206167,17553,13.917,13432,10.649,367546,121084,246462,5.488,16.660,283689,98882,184807,4.482,12.859,83857,3.801,25.718,9635,9809,58459
1985,38,14589,16813,183302,182362,1824,10.762,2096,12.367,29242,10754,18488,5.897,16.035,27560,10662,16898,5.847,15.113,1682,0.922,30.226,1520,1549,7626
1985,39,164256,204647,3680539,3628829,22534,11.031,21802,10.673,568574,161692,406882,4.456,15.668,466253,184977,281276,5.097,12.849,102321,2.820,25.697,15032,15419,99693
1985,40,59850,70431,975049,951910,9980,14.098,10694,15.107,213527,108989,104538,11.450,22.431,167486,70776,96710,7.435,17.595,46041,4.837,35.189,8188,8260,47764
1985,41,54991,64210,832331,817796,9211,14.398,8736,13.656,161545,60844,100701,7.440,19.754,132958,54408,78550,6.653,16.258,28587,3.496,32.516,6289,6469,33921
1985,42,186133,225236,4053508,4020815,26136,11.649,24372,10.863,614050,196021,418029,4.875,15.272,548768,222209,326559,5.526,13.648,65282,1.624,27.296,16688,17093,123670
1985,44,19693,21829,359012,357297,2667,12.341,2232,10.328,54512,16241,38271,4.546,15.257,50652,17682,32970,4.949,14.176,3860,1.080,28.353,1654,1677,11808
1985,45,51736,62614,1058851,1041425,8831,14.316,6978,11.312,178530,60206,118324,5.781,17.143,143484,51289,92195,4.925,13.778,35046,3.365,27.555,5021,5095,30020
1985,46,15029,17033,187135,183952,1970,11.559,1991,11.682,31373,12528,18845,6.810,17.055,24937,9020,15917,4.903,13.556,6436,3.499,27.113,1440,1468,6449
1985,47,75130,90832,1592499,1556793,12414,13.773,11010,12.216,296319,118644,177675,7.621,19.034,225726,91623,134103,5.885,14.499,70593,4.535,28.999,7854,7945,46064
1985,48,283456,353366,5684371,5594124,54638,15.555,50407,14.351,1183354,459372,723982,8.212,21.154,1004344,405865,598479,7.255,17.954,179010,3.200,35.907,36805,37510,244452
1985,49,25694,30540,477011,467393,4586,15.076,4343,14.277,90013,32339,57674,6.919,19.259,70647,29190,41457,6.245,15.115,19366,4.143,30.230,3102,3169,19354
1985,50,13273,14678,182100,179702,2130,14.773,1610,11.167,29375,10311,19064,5.738,16.347,24573,10315,14258,5.740,13.674,4802,2.672,27.349,1184,1203,5561
1985,51,90914,111957,1882444,1831693,16605,15.051,13340,12.092,341999,120676,221323,6.588,18.671,240633,100066,140567,5.463,13.137,101366,5.534,26.274,9922,10073,61167
1985,53,85117,100346,1351670,1335934,14530,14.577,13197,13.239,248464,86237,162227,6.455,18.599,216602,82773,133829,6.196,16.214,31862,2.385,32.427,9243,9404,50591
1985,54,27132,32148,442776,441910,4192,12.963,4570,14.132,68089,28676,39413,6.489,15.408,66491,25627,40864,5.799,15.046,1598,0.362,30.093,3385,3443,17111
1985,55,85712,100205,1636367,1619235,11184,11.173,10976,10.965,240242,77414,162828,4.781,14.837,206572,78773,127799,4.865,12.757,33670,2.079,25.515,7939,8119,48611
1985,56,11882,13573,137977,137938,1885,13.848,1964,14.428,26641,10725,15916,7.775,19.314,26658,10397,16261,7.537,19.326,-17,-0.012,38.627,1371,1382,6238
1986,01,59600,72808,1216889,1191947,10414,14.495,8487,11.813,225441,86292,139149,7.240,18.914,175949,60601,115348,5.084,14.761,49492,4.152,29.523,6047,6165,35051
1986,02,10572,12397,145676,149271,2289,18.482,2265,18.288,34272,14549,19723,9.747,22.960,41417,15860,25557,10.625,27.746,-7145,-4.787,45.919,1620,1649,8941
1986,04,58469,71141,1131775,1100515,12616,18.171,9193,13.241,264788,111027,153761,10.089,24.060,202291,67639,134652,6.146,18.381,62497,5.679,36.763,6584,6660,44077
1986,05,39829,46212,661597,654196,6223,13.525,5824,12.657,115897,43426,72471,6.638,17.716,100678,35662,65016,5.451,15.390,15219,2.326,30.779,4308,4380,22667
1986,06,490734,590373,9618052,9441647,91767,15.813,71674,12.351,2013891,781841,1232050,8.281,21.330,1661447,573581,1087866,6.075,17.597,352444,3.733,35.194,49598,50468,327321
1986,08,70166,83087,1226364,1221273,13263,16.082,12029,14.586,239128,101028,138100,8.272,19.580,229410,88425,140985,7.240,18.785,9718,0.796,37.569,8667,8794,56876
1986,09,67044,76824,1435038,1432888,9782,12.940,7326,9.691,215579,75698,139881,5.283,15.045,209548,55663,153885,3.885,14.624,6031,0.421,29.248,5174,5243,30773
1986,10,12114,13968,284098,280367,2042,14.995,1342,9.855,46686,15427,31259,5.502,16.652,39175,11253,27922,4.014,13.973,7511,2.679,27.946,916,929,4737
1986,11,14212,16530,373377,368035,2206,13.537,1739,10.671,62113,25046,37067,6.805,16.877,51433,16209,35224,4.404,13.975,10680,2.902,27.950,1209,1223,9869
1986,12,233956,281358,3954711,3861046,48359,17.570,36127,13.126,864223,356092,508131,9.223,22.383,676154,255102,421052,6.607,17.512,188069,4.871,35.024,26554,26937,164819
1986,13,102864,127130,2237390,2184565,19772,15.876,14594,11.718,430200,162621,267579,7.444,19.693,323915,112863,211052,5.166,14.827,106285,4.865,29.655,10078,10209,64419
1986,15,19366,23550,342443,333829,3068,13.184,2508,10.778,66605,26451,40154,7.924,19.952,49140,17835,31305,5.343,14.720,17465,5.232,29.440,1658,1679,10556
1986,16,18649,21910,257497,255699,3028,13.873,2861,13.108,45515,16888,28627,6.605,17.800,42218,14852,27366,5.808,16.511,3297,1.289,33.022,2010,2035,10067
1986,17,190175,226194,4188341,4135330,27228,12.151,23010,10.268,670686,226645,444041,5.481,16.218,565501,182400,383101,4.411,13.675,105185,2.544,27.350,16305,16573,107205
1986,18,88087,107432,1879497,1855144,13277,12.499,10866,10.229,293397,108853,184544,5.868,15.815,244467,81058,163409,4.369,13.178,48930,2.638,26.356,7750,7921,48821
1986,19,53651,64424,855380,850651,6501,10.032,7261,11.205,134535,52865,81670,6.215,15.816,125356,47043,78313,5.530,14.736,9179,1.079,29.473,5180,5277,27435
1986,20,49547,58526,811901,802804,7131,12.188,7097,12.130,136197,51992,84205,6.476,16.965,118500,42404,76096,5.282,14.761,17697,2.204,29.522,5240,5344,26421
1986,21,56167,66859,1055737,1041325,8778,13.264,7419,11.210,169611,62452,107159,5.997,16.288,140410,47675,92735,4.578,13.484,29201,2.804,26.968,5433,5489,28381
1986,22,70245,84722,1236872,1252006,11159,13.124,11765,13.837,218150,87370,130780,6.978,17.424,248226,82128,166098,6.560,19.826,-30076,-2.402,34.848,8858,8980,51329
1986,23,23454,26891,366958,358799,4091,15.595,2775,10.578,64839,23636,41203,6.588,18.071,48310,17596,30714,4.904,13.464,16529,4.607,26.929,1958,2004,11055
1986,24,74624,89903,1606862,1568950,13101,14.941,8659,9.875,311094,114646,196448,7.307,19.828,235813,72119,163694,4.597,15.030,75281,4.798,30.060,5971,6074,41862
1986,25,114596,134047,2688045,2657218,17584,13.349,12935,9.820,446216,150464,295752,5.662,16.793,384601,114947,269654,4.326,14.474,61615,2.319,28.948,9134,9309,67197
1986,26,140973,170857,3169100,3088397,21672,12.852,17201,10.201,540401,182366,358035,5.905,17.498,378578,128039,250539,4.146,12.258,161823,5.240,24.516,12321,12512,74275
1986,27,77066,91658,1588715,1583923,11409,12.533,10150,11.150,257447,92934,164513,5.867,16.254,246765,85189,161576,5.378,15.579,10682,0.674,31.159,7142,7284,53813
1986,28,38892,46411,669674,658840,6026,13.085,5306,11.522,122817,42759,80058,6.490,18.641,100720,33602,67118,5.100,15.287,22097,3.354,30.575,3717,3769,19467
1986,29,89923,107918,1796425,1767358,14721,13.817,11970,11.235,315391,119740,195651,6.775,17.845,257221,92673,164548,5.244,14.554,58170,3.291,29.108,8557,8774,54223
1986,30,19056,21758,202276,204321,2876,13.196,2949,13.531,34059,14412,19647,7.054,16.669,38098,13895,24203,6.801,18.646,-4039,-1.977,33.339,2161,2180,9845
1986,31,32643,38049,517491,509773,4088,10.703,4379,11.465,93800,45198,48602,8.866,18.400,77211,24506,52705,4.807,15.146,16589,3.254,30.292,3177,3218,15938
1986,32,19292,22400,404722,397333,3780,17.144,3077,13.956,79678,30458,49220,7.666,20.053,64936,27700,37236,6.971,16.343,14742,3.710,32.686,2170,2199,14700
1986,33,24009,27066,423479,414705,4773,18.321,2744,10.533,84861,32746,52115,7.896,20.463,66336,26200,40136,6.318,15.996,18525,4.467,31.992,2026,2048,12375
1986,34,153550,175264,2981556,2951724,23231,13.449,18167,10.517,519533,173168,346365,5.867,17.601,458622,140688,317934,4.766,15.537,60911,2.064,31.075,12977,13128,75483
1986,35,26345,30878,395549,396324,4760,15.561,4181,13.669,74457,32754,41703,8.264,18.787,75717,25523,50194,6.440,19.105,-1260,-0.318,37.574,2970,3011,16433
1986,36,342626,389052,6575088,6494436,49718,12.899,42472,11.019,1101183,374431,726752,5.765,16.956,942534,328769,613765,5.062,14.513,158649,2.443,29.026,31459,31842,180375
1986,37,109044,133155,2319642,2284024,18725,14.334,13689,10.479,369413,132243,237170,5.790,16.174,299929,100425,199504,4.397,13.132,69484,3.042,26.263,9578,9752,54145
1986,38,14461,16759,180927,182265,1793,10.682,1847,11.003,26612,10471,16141,5.745,14.601,29026,9187,19839,5.040,15.925,-2414,-1.324,29.201,1330,1359,6291
1986,39,166964,208842,3780726,3729453,24228,11.721,19968,9.660,591959,200549,391410,5.377,15.873,488437,151586,336851,4.065,13.097,103522,2.776,26.193,13726,13986,85850
1986,40,58210,69196,951546,963424,9363,13.412,10592,15.173,161341,70827,90514,7.352,16.747,185281,66571,118710,6.910,19.232,-23940,-2.485,33.493,7932,8042,40855
1986,41,56406,66028,852774,842812,9819,15.080,7990,12.271,156881,60941,95940,7.231,18.614,136650,51719,84931,6.136,16.214,20231,2.400,32.427,5780,5842,32953
1986,42,191607,232102,4142680,4093936,28515,12.472,21576,9.437,660778,237319,423459,5.797,16.140,561936,177131,384805,4.327,13.726,98842,2.414,27.452,14915,15218,93128
1986,44,20431,22670,375907,366591,2996,13.470,2141,9.626,60758,20127,40631,5.490,16.574,42415,14820,27595,4.043,11.570,18343,5.004,23.140,1534,1547,9077
1986,45,53413,64851,1075499,1053731,9226,14.480,6951,10.910,198093,79841,118252,7.577,18.799,153755,52082,101673,4.943,14.591,44338,4.208,29.183,4829,4913,28196
1986,46,15015,17078,186042,186802,1852,10.853,1824,10.689,28480,11217,17263,6.005,15.246,30060,9629,20431,5.155,16.092,-1580,-0.846,30.492,1271,1278,6055
1986,47,76790,93219,1646569,1615698,12943,14.066,10535,11.449,291864,102992,188872,6.374,18.064,228714,79988,148726,4.951,14.156,63150,3.909,28.311,7453,7606,48753
1986,48,284993,357629,5638501,5660940,53753,15.122,49426,13.905,1072009,433722,638287,7.662,18.937,1116307,382951,733356,6.765,19.719,-44298,-0.783,37.874,35932,36647,232498
1986,49,25829,30911,484760,480908,4619,15.034,4245,13.817,95634,40187,55447,8.356,19.886,87904,31839,56065,6.621,18.279,7730,1.607,36.558,2995,3045,19950
1986,50,13728,15250,191746,186680,2308,15.428,1727,11.545,34728,13615,21113,7.293,18.603,24926,8976,15950,4.808,13.352,9802,5.251,26.705,1275,1283,6141
1986,51,94922,117432,1999672,1939078,16940,14.772,11429,9.966,369014,141952,227062,7.321,19.030,247188,81358,165830,4.196,12.748,121826,6.283,25.495,7936,8045,44752
1986,53,87162,103113,1413458,1382810,15531,15.268,12752,12.536,283550,101718,181832,7.356,20.505,221674,82570,139104,5.971,16.031,61876,4.475,32.061,8941,9088,49223
1986,54,27208,32285,438819,437235,3937,12.220,3800,11.795,72165,29279,42886,6.696,16.505,69041,24939,44102,5.704,15.790,3124,0.714,31.581,2657,2696,12569
1986,55,85854,100560,1647294,1640943,11316,11.273,10954,10.913,244033,85376,158657,5.203,14.872,231246,93405,137841,5.692,14.092,12787,0.779,28.185,7344,7463,48950
1986,56,11572,13289,134399,136675,1698,12.641,1984,14.771,24693,10840,13853,7.931,18.067,29254,10774,18480,7.883,21.404,-4561,-3.337,36.134,1427,1442,7051
1987,01,60931,74689,1203051,1195670,10773,14.607,8896,12.062,221022,85317,135705,7.135,18.485,205897,73126,132771,6.116,17.220,15125,1.265,34.440,6124,6250,38825
1987,02,9999,11819,139835,142837,1910,15.777,2485,20.526,32448,15592,16856,10.916,22.717,38781,16082,22699,11.259,27.151,-6333,-4.434,45.434,1720,1761,10094
1987,04,60425,74080,1168433,1154019,13119,18.067,10185,14.026,263717,123285,140432,10.683,22.852,234342,96577,137765,8.369,20.307,29375,2.545,40.613,7107,7186,51905
1987,05,39903,46562,685293,676725,6426,13.851,6087,13.121,121636,45042,76594,6.656,17.974,104424,39120,65304,5.781,15.431,17212,2.543,30.862,4369,4424,24401
1987,06,504507,609122,10027092,9899900,95805,15.974,77077,12.851,2180563,852319,1328244,8.609,22.026,1927252,685227,1242025,6.922,19.467,253311,2.559,38.935,52981,53992,365401
1987,08,70148,83506,1200684,1222809,13132,15.763,12736,15.288,238037,109671,128366,8.969,19.466,283998,103916,180082,8.498,23.225,-45961,-3.759,38.933,8872,9065,57546
1987,09,69418,79939,1525774,1486533,11246,14.348,8125,10.366,278857,116460,162397,7.834,18.759,202064,69534,132530,4.678,13.593,76793,5.166,27.186,5828,5870,39787
1987,10,12518,14554,280325,291220,2183,15.316,1582,11.099,55336,18724,36612,6.430,19.001,75370,14376,(S),4.936,25.881,-20034,-6.879,38.003,1075,1084,6751
1987,11,14334,16746,392348,382922,2155,12.955,1932,11.614,72483,27485,44998,7.178,18.929,52993,19609,33384,5.121,13.839,19490,5.090,27.678,1273,1293,9830
1987,12,242240,293308,4129152,4045020,51375,17.881,39394,13.711,927128,421377,505751,10.417,22.920,757719,304684,453035,7.532,18.732,169409,4.188,37.464,28652,29025,185817
1987,13,105632,131552,2329978,2301764,20307,15.699,15903,12.295,470794,203979,266815,8.862,20.454,414033,142611,271422,6.196,17.988,56761,2.466,35.975,10760,10937,75483
1987,15,19861,24223,366639,359925,3413,14.290,2733,11.443,79601,31398,48203,8.723,22.116,67087,22899,44188,6.362,18.639,12514,3.477,37.278,1757,1809,12515
1987,16,18710,21981,258614,263689,3008,13.703,2948,13.430,48695,20217,28478,7.667,18.467,59331,19069,40262,7.232,22.500,-10636,-4.034,36.934,1967,2001,12096
1987,17,192063,229689,4208757,4213563,28838,12.653,25302,11.101,695045,256683,438362,6.092,16.495,705214,237148,468066,5.628,16.737,-10169,-0.241,32.991,17363,17663,109564
1987,18,89603,109714,1934716,1913630,13894,12.800,11568,10.657,341150,129794,211356,6.783,17.827,301422,103392,198030,5.403,15.751,39728,2.076,31.503,7923,8159,55176
1987,19,53388,64347,882166,878757,7025,10.911,7096,11.022,147339,58369,88970,6.642,16.767,138839,49644,89195,5.649,15.799,8500,0.967,31.599,4788,4854,26025
1987,20,49230,58396,797919,794659,7124,12.186,7253,12.407,141829,63191,78638,7.952,17.848,135518,50671,84847,6.376,17.054,6311,0.794,34.107,4991,5078,26591
1987,21,57021,68124,1058422,1077310,8966,13.284,7704,11.415,183974,71439,112535,6.631,17.077,220702,63873,156829,5.929,20.486,-36728,-3.409,34.154,5407,5512,34705
1987,22,67104,81577,1179420,1214671,10162,12.222,13302,15.998,209042,92615,116427,7.625,17.210,278889,109433,169456,9.009,22.960,-69847,-5.750,34.420,9256,9397,59749
1987,23,24766,28451,391418,390898,4553,16.456,2985,10.789,75595,31575,44020,8.078,19.339,76983,22998,53985,5.883,19.694,-1388,-0.355,38.678,2157,2184,15220
1987,24,77224,93704,1694845,1654697,13649,14.869,9833,10.712,341285,133393,207892,8.061,20.625,260648,94248,166400,5.696,15.752,80637,4.873,31.504,6759,6864,49981
1987,25,118201,138705,2769199,2741283,19088,13.995,14453,10.597,484127,183805,300322,6.705,17.661,432361,136440,295921,4.977,15.772,51766,1.888,31.544,10141,10282,75911
1987,26,143526,174813,3162353,3173487,22516,13.027,18572,10.745,532707,193915,338792,6.110,16.786,553682,166020,387662,5.231,17.447,-20975,-0.661,33.572,12784,12967,83203
1987,27,78091,93408,1650722,1621970,11886,12.845,10134,10.952,294207,111616,182591,6.882,18.139,236209,85945,150264,5.299,14.563,57998,3.576,29.126,6890,7015,46752
1987,28,38953,46677,677678,677624,6161,13.234,5915,12.706,118117,47520,70597,7.013,17.431,118344,41721,76623,6.157,17.465,-227,-0.033,34.862,4046,4097,21904
1987,29,91551,110476,1849800,1830852,15276,13.987,12757,11.680,344804,135585,209219,7.406,18.833,306175,109376,196799,5.974,16.723,38629,2.110,33.446,8750,8906,57431
1987,30,19022,21786,205307,203885,2986,13.715,2957,13.582,41152,17366,23786,8.518,20.184,38502,15758,22744,7.729,18.884,2650,1.300,37.768,2090,2108,8999
1987,31,32561,38136,517245,527661,4199,11.022,4118,10.810,86649,31445,55204,5.959,16.421,110172,29544,80628,5.599,20.879,-23523,-4.458,32.843,2886,2926,16270
1987,32,20160,23441,439466,423500,4186,18.262,3149,13.738,101261,37753,63508,8.915,23.911,69201,26934,42267,6.360,16.340,32060,7.570,32.681,2113,2141,15743
1987,33,25685,29063,445494,439472,5134,18.293,3138,11.181,89590,35431,54159,8.062,20.386,77024,24601,52423,5.598,17.526,12566,2.859,35.053,2260,2293,15552
1987,34,158307,181177,3114732,3069841,25390,14.248,19427,10.902,627319,238631,388688,7.773,20.435,534445,177486,356959,5.782,17.410,92874,3.025,34.819,13819,13961,87648
1987,35,26387,31037,391502,399151,4553,14.706,4400,14.212,83898,36304,47594,9.095,21.019,99467,29492,69975,7.389,24.920,-15569,-3.901,42.038,2977,3032,16858
1987,36,347136,395472,6817121,6710808,52202,13.309,45716,11.655,1254220,473053,781167,7.049,18.690,1038463,354618,683845,5.284,15.474,215757,3.215,30.949,34017,34323,204323
1987,37,111799,137946,2421359,2373512,19478,14.368,14711,10.852,430604,162554,268050,6.849,18.142,335855,128294,207561,5.405,14.150,94749,3.992,28.300,10189,10308,59794
1987,38,14473,16806,180817,183809,1922,11.458,1860,11.088,28537,10889,17648,5.924,15.525,33994,10409,23585,5.663,18.494,-5457,-2.969,31.051,1264,1279,6282
1987,39,169786,213798,3913990,3879070,26237,12.416,21265,10.063,664896,243827,421069,6.286,17.141,597416,215955,381461,5.567,15.401,67480,1.740,30.802,14050,14314,95312
1987,40,56084,67215,872255,922314,8850,12.973,10855,15.912,157245,72164,85081,7.824,17.049,258827,76903,181924,8.338,28.063,-101582,-11.014,34.098,7557,7706,44622
1987,41,57407,67622,889261,885117,10212,15.279,8644,12.933,175476,67068,108408,7.577,19.825,165757,59401,106356,6.711,18.727,9719,1.098,37.454,6146,6203,35813
1987,42,196190,238626,4278141,4220609,29810,12.666,23282,9.892,723333,263404,459929,6.241,17.138,608444,212420,396024,5.033,14.416,114889,2.722,28.832,15802,16056,107326
1987,44,21212,23636,394234,397365,3371,14.555,2421,10.453,69315,26161,43154,6.584,17.444,77018,20226,56792,5.090,19.382,-7703,-1.939,34.887,1782,1810,12399
1987,45,54880,67109,1125054,1103356,9782,14.825,7532,11.415,212056,86129,125927,7.806,19.219,168778,62166,106612,5.634,15.297,43278,3.922,30.594,5172,5252,30475
1987,46,15129,17226,194416,190558,2018,11.765,1872,10.914,34041,14325,19716,7.517,17.864,26604,9085,17519,4.768,13.961,7437,3.903,27.922,1310,1315,5746
1987,47,78673,96341,1684063,1685135,14060,14.833,10952,11.554,321441,126492,194949,7.506,19.075,323590,104081,219509,6.176,19.203,-2149,-0.128,38.150,7621,7703,51105
1987,48,277825,352011,5426162,5537074,50844,14.331,56365,15.888,1044922,466544,578378,8.426,18.871,1262826,481181,781645,8.690,22.807,-217904,-3.935,37.743,39176,40140,257784
1987,49,26187,31376,498247,497600,4743,15.230,4275,13.727,100329,39227,61102,7.883,20.163,99613,34780,64833,6.990,20.019,716,0.144,40.037,2881,2962,19255
1987,50,14502,16151,206822,199520,2507,15.966,1610,10.253,40978,17223,23755,8.632,20.538,26190,10443,15747,5.234,13.127,14788,7.412,26.253,1161,1169,6143
1987,51,98246,122682,2117402,2065000,18197,15.157,12946,10.783,414377,164791,249586,7.980,20.067,309610,109851,199759,5.320,14.993,104767,5.073,29.986,8860,8994,56934
1987,53,89009,105751,1453195,1426258,15935,15.260,13285,12.722,303009,115564,187445,8.103,21.245,249140,89427,159713,6.270,17.468,53869,3.777,34.936,9198,9347,50595
1987,54,27342,32708,447212,445573,4260,13.111,3827,11.778,76973,31921,45052,7.164,17.275,73586,25001,48585,5.611,16.515,3387,0.760,33.030,2627,2646,13322
1987,55,87955,104122,1748945,1698704,13555,13.248,9951,9.725,310967,138959,172008,8.180,18.306,211715,70353,141362,4.142,12.463,99252,5.843,24.927,6947,7041,41645
1987,56,11090,12752,125998,134623,1577,12.104,2130,16.349,20030,8804,11226,6.540,14.879,37033,11396,25637,8.465,27.509,-17003,-12.630,29.757,1439,1460,6671
1988,01,62234,76628,1238250,1221972,10552,13.936,8727,11.526,220542,90729,129813,7.425,18.048,187379,67843,119536,5.552,15.334,33163,2.714,30.668,6004,6105,36484
1988,02,10008,11860,136796,138173,1955,16.504,1926,16.259,30347,12068,18279,8.734,21.963,33113,14128,18985,10.225,23.965,-2766,-2.002,43.926,1227,1257,7210
1988,04,61958,76409,1205648,1183140,12706,16.873,10493,13.934,269919,113799,156120,9.618,22.814,225989,86483,139506,7.310,19.101,43930,3.713,38.202,7354,7472,50162
1988,05,40117,47165,705667,696601,6264,13.362,5691,12.140,125406,43523,81883,6.248,18.003,106732,40360,66372,5.794,15.322,18674,2.681,30.644,4014,4062,23772
1988,06,517250,627311,10447165,10249575,94091,15.204,77145,12.466,2235571,801568,1434003,7.820,21.811,1839505,681949,1157556,6.653,17.947,396066,3.864,35.894,53265,54403,374510
1988,08,70287,84183,1206525,1202653,12818,15.279,12233,14.582,233326,91710,141616,7.626,19.401,225265,91912,133353,7.642,18.731,8061,0.670,37.461,8662,8782,50832
1988,09,71824,82973,1548004,1532826,11310,13.876,8375,10.275,268528,104470,164058,6.816,17.518,238685,90036,148649,5.874,15.572,29843,1.947,31.143,5924,5981,42862
1988,10,13026,15185,297076,288902,2223,14.944,1605,10.789,56445,20402,36043,7.062,19.538,39780,14173,25607,4.906,13.769,16665,5.768,27.539,1066,1087,7308
1988,11,14499,17163,386487,387240,2311,13.621,1917,11.299,67698,22068,45630,5.699,17.482,68692,19515,49177,5.040,17.739,-994,-0.257,34.964,1288,1297,12224
1988,12,251420,305867,4346497,4243613,52625,17.554,40453,13.494,953477,399200,554277,9.407,22.469,746790,299990,446800,7.069,17.598,206687,4.871,35.196,29740,30275,190882
1988,13,108948,136437,2440328,2389949,20806,15.518,16087,11.998,489261,194178,295083,8.125,20.472,388549,147603,240946,6.176,16.258,100712,4.214,32.515,11072,11245,81802
1988,15,20469,25079,385739,375995,3498,14.191,2639,10.706,73183,28652,44531,7.620,19.464,53925,19521,34404,5.192,14.342,19258,5.122,28.684,1804,1855,10391
1988,16,18969,22400,269666,262774,3040,13.692,2647,11.922,56764,23710,33054,9.023,21.602,42977,17662,25315,6.721,16.355,13787,5.247,32.710,1820,1863,11916
1988,17,195685,235173,4378374,4295609,28818,12.391,23602,10.149,758803,262848,495955,6.119,17.665,593530,208087,385443,4.844,13.817,165273,3.847,27.634,16190,16464,105681
1988,18,91469,112551,2008310,1968779,13778,12.392,11054,9.942,339648,119747,219901,6.082,17.252,261103,88666,172437,4.504,13.262,78545,3.990,26.524,7627,7780,51796
1988,19,53831,65139,932547,908524,6801,10.499,6084,9.392,156458,49794,106664,5.481,17.221,109038,42178,66860,4.642,12.002,47420,5.219,24.003,4236,4316,25109
1988,20,49984,59750,823157,812100,7490,12.670,6222,10.525,143426,57335,86091,7.060,17.661,121734,45414,76320,5.592,14.990,21692,2.671,29.980,4385,4471,27776
1988,21,57926,69694,1105682,1081199,9084,13.177,7574,10.987,201959,75128,126831,6.949,18.679,152681,56741,95940,5.248,14.121,49278,4.558,28.243,5406,5487,31198
1988,22,66070,81061,1195415,1184497,10343,12.714,10921,13.425,227796,86906,140890,7.337,19.231,206441,79229,127212,6.689,17.429,21355,1.803,34.857,7545,7708,46017
1988,23,25973,29925,417054,405221,4576,15.669,3135,10.735,77298,24755,52543,6.109,19.076,53716,18477,35239,4.560,13.256,23582,5.820,26.512,2275,2290,11059
1988,24,80039,97817,1767179,1731918,14201,14.819,10222,10.667,349155,134947,214208,7.792,20.160,276949,88582,188367,5.115,15.991,72206,4.169,31.982,7022,7163,50468
1988,25,121921,143382,2844567,2809367,19137,13.557,14683,10.402,496321,168376,327945,5.993,17.667,425055,140932,284123,5.017,15.130,71266,2.537,30.260,10115,10301,71600
1988,26,147054,179551,3215069,3195219,22707,12.805,18276,10.306,527360,195487,331873,6.118,16.505,490627,167383,323244,5.239,15.355,36733,1.150,30.710,12242,12542,85457
1988,27,79599,95799,1731107,1695431,11953,12.623,9732,10.278,315063,109065,205998,6.433,18.583,243679,87311,156368,5.150,14.373,71384,4.210,28.745,6735,6863,48222
1988,28,39121,47152,703795,692183,6122,13.040,5711,12.165,124980,52374,72606,7.567,18.056,101571,38978,62593,5.631,14.674,23409,3.382,29.348,3903,3956,22959
1988,29,93157,113106,1879580,1859610,14952,13.365,12493,11.167,324450,118179,206271,6.355,17.447,284051,101725,182326,5.470,15.275,40399,2.172,30.550,8699,8840,52082
1988,30,19090,21938,206350,206545,2811,12.848,2692,12.304,38420,14994,23426,7.259,18.601,38895,15552,23343,7.530,18.831,-475,-0.230,37.203,1863,1879,9010
1988,31,32985,38901,540279,529567,4374,11.346,3674,9.530,91834,31279,60555,5.907,17.341,70673,26581,44092,5.019,13.345,21161,3.996,26.691,2564,2600,13842
1988,32,21054,24652,468399,456232,4287,17.821,3096,12.870,112332,41014,71318,8.990,24.622,88603,37165,51438,8.146,19.421,23729,5.201,38.841,2151,2174,17224
1988,33,26822,30459,468142,457891,4909,16.484,3553,11.930,91661,34823,56838,7.605,20.018,71082,26187,44895,5.719,15.524,20579,4.494,31.048,2620,2642,15976
1988,34,162790,187172,3201842,3170442,25703,13.945,19997,10.849,581849,208482,373367,6.576,18.352,519658,168467,351191,5.314,16.391,62191,1.962,32.781,14391,14551,86182
1988,35,26547,31452,398369,395334,4609,14.743,4229,13.528,80875,31407,49468,7.944,20.457,74683,30297,44386,7.664,18.891,6192,1.566,37.782,2912,2965,18590
1988,36,352749,403409,6910881,6868644,52884,13.231,45434,11.367,1208701,382728,825973,5.572,17.597,1119969,359823,760146,5.239,16.306,88732,1.292,32.611,33709,34090,196854
1988,37,115378,143190,2550978,2491973,19976,14.201,14938,10.619,457015,178693,278322,7.171,18.339,337565,116320,221245,4.668,13.546,119450,4.793,27.092,10065,10259,59219
1988,38,14665,17017,187903,184737,1883,11.122,1710,10.100,31181,11745,19436,6.358,16.879,24801,9173,15628,4.965,13.425,6380,3.454,26.850,1119,1133,5001
1988,39,173353,219055,4023783,3960727,26099,12.050,21169,9.774,687346,257452,429894,6.500,17.354,562801,200595,362206,5.065,14.210,124545,3.144,28.419,13875,14351,107575
1988,40,55507,66958,890425,881767,8789,13.090,9160,13.642,172831,67124,105707,7.612,19.601,155794,65579,90215,7.437,17.668,17037,1.932,35.337,6460,6658,38260
1988,41,58553,69236,940432,915233,9808,14.321,8314,12.139,197871,70865,127006,7.743,21.620,146911,61952,84959,6.769,16.052,50960,5.568,32.104,5841,5971,36014
1988,42,201432,245817,4394839,4337376,29970,12.363,23168,9.557,737997,257596,480401,5.939,17.015,622971,223293,399678,5.148,14.363,115026,2.652,28.726,15935,16314,123477
1988,44,21956,24423,405845,401179,3353,13.944,2601,10.816,69652,24397,45255,6.081,17.362,59582,21567,38015,5.376,14.852,10070,2.510,29.703,1873,1891,11515
1988,45,56614,69515,1203911,1167028,9847,14.405,7537,11.025,242604,96105,146499,8.235,20.788,167732,66214,101518,5.674,14.373,74872,6.416,28.745,5258,5366,31083
1988,46,15305,17479,200977,198049,1959,11.284,1722,9.919,32721,12133,20588,6.126,16.522,26896,10482,16414,5.293,13.580,5825,2.941,27.161,1177,1202,6151
1988,47,80496,99426,1785830,1743642,14159,14.456,11194,11.429,359987,149836,210151,8.593,20.646,276234,108656,167578,6.232,15.842,83753,4.803,31.685,7591,7723,51607
1988,48,275374,351480,5518109,5483337,50475,14.341,51423,14.611,1134590,456147,678443,8.319,20.692,1065430,420473,644957,7.668,19.430,69160,1.261,38.861,35744,36807,227024
1988,49,26342,31833,514076,506560,4788,15.139,4376,13.836,108802,48846,59956,9.643,21.479,93654,41192,52462,8.132,18.488,15148,2.990,36.977,3002,3156,24555
1988,50,15199,16934,211143,208901,2516,15.202,1748,10.562,37534,15533,22001,7.436,17.967,33153,12016,21137,5.752,15.870,4381,2.097,31.740,1271,1284,7228
1988,51,102350,128277,2220910,2168263,18648,14.852,13218,10.527,426752,168643,258109,7.778,19.682,322583,114000,208583,5.258,14.877,104169,4.804,29.755,8988,9157,55317
1988,53,91486,109016,1526683,1490792,16108,14.990,12997,12.095,323676,110827,212849,7.434,21.712,251788,99238,152550,6.657,16.890,71888,4.822,33.779,8665,8876,51444
1988,54,28003,33522,465376,461633,4250,12.826,3476,10.490,78527,30397,48130,6.585,17.011,70770,24997,45773,5.415,15.330,7757,1.680,30.661,2389,2431,14189
1988,55,89475,106491,1834740,1792734,12063,11.449,9810,9.311,304853,106855,197998,5.960,17.005,220997,78785,142212,4.395,12.327,83856,4.678,24.655,6794,6911,42857
1988,56,11130,12799,123179,123497,1654,12.944,1612,12.615,23106,8821,14285,7.143,18.710,23759,10066,13693,8.151,19.239,-653,-0.529,37.420,1061,1074,5502
1989,01,63390,78416,1305364,1271078,10484,13.521,8734,11.264,240189,90496,149693,7.120,18.896,172176,60161,112015,4.733,13.546,68013,5.351,27.091,6191,6324,36551
1989,02,10317,12305,145150,141023,1947,16.103,1519,12.563,32434,12335,20099,8.747,22.999,24244,8636,15608,6.124,17.192,8190,5.808,34.383,1037,1059,4962
1989,04,62597,77416,1235157,1219144,12013,15.618,11021,14.328,257421,102979,154442,8.447,21.115,225712,88602,137110,7.268,18.514,31709,2.601,37.028,7671,7846,52577
1989,05,40490,47848,724765,714211,5975,12.575,5309,11.173,122474,45632,76842,6.389,17.148,101702,39998,61704,5.600,14.240,20772,2.908,28.480,3935,4014,25400
1989,06,528384,643682,10837625,10629045,94191,14.819,78036,12.277,2172060,779741,1392319,7.336,20.435,1760244,631702,1128542,5.943,16.561,411816,3.874,33.121,54422,55767,368037
1989,08,70801,84734,1233738,1219772,12050,14.266,11517,13.635,233505,88761,144744,7.277,19.143,205857,88452,117405,7.252,16.877,27648,2.267,33.753,8002,8236,51196
1989,09,72976,84495,1536994,1542888,10693,12.768,9201,10.986,240875,86693,154182,5.619,15.612,251737,104507,147230,6.773,16.316,-10862,-0.704,31.224,6673,6755,39618
1989,10,13589,15927,306535,302209,2312,14.859,1577,10.135,52808,19493,33315,6.450,17.474,44079,12543,31536,4.150,14.586,8729,2.888,29.171,1069,1095,7091
1989,11,14518,17452,393385,390074,2211,12.768,1941,11.209,66184,20377,45807,5.224,16.967,59990,22654,37336,5.808,15.379,6194,1.588,30.758,1291,1299,10470
1989,12,258471,314997,4552924,4456824,50629,16.306,41618,13.404,963794,380614,583180,8.540,21.625,776341,314132,462209,7.048,17.419,187453,4.206,34.838,30114,30832,200566
1989,13,111615,140261,2509154,2470270,20571,14.866,16807,12.146,496720,195980,300740,7.934,20.108,422359,148542,273817,6.013,17.098,74361,3.010,34.195,11558,11826,79914
1989,15,20930,25795,410297,397930,3308,13.001,2605,10.238,76459,29876,46583,7.508,19.214,51686,19023,32663,4.780,12.989,24773,6.225,25.977,1865,1895,12115
1989,16,19359,22869,292253,281059,2971,13.120,2522,11.137,61448,24083,37365,8.569,21.863,38984,14899,24085,5.301,13.870,22464,7.993,27.741,1717,1760,9774
1989,17,198913,239988,4519431,4451949,28826,12.131,24077,10.133,744818,273754,471064,6.149,16.730,611178,206079,405099,4.629,13.728,133640,3.002,27.457,16403,16855,107364
1989,18,93357,115283,2108968,2060376,13508,11.855,10837,9.511,347743,119805,227938,5.815,16.878,251186,88830,162356,4.311,12.191,96557,4.686,24.383,7716,7920,51681
1989,19,54343,65903,990100,962153,6644,10.139,5901,9.005,163548,61238,102310,6.365,16.998,108834,39908,68926,4.148,11.312,54714,5.687,22.623,4205,4295,25047
1989,20,50127,60097,867503,843137,6914,11.538,6567,10.959,167416,75373,92043,8.940,19.856,117993,43447,74546,5.153,13.995,49423,5.862,27.989,4767,4865,26749
1989,21,59016,71237,1151162,1128052,8929,12.669,7418,10.525,198064,68963,129101,6.113,17.558,152244,57288,94956,5.078,13.496,45820,4.062,26.992,5361,5457,32548
1989,22,65266,80324,1222137,1208001,9324,11.553,10087,12.499,224375,78610,145765,6.507,18.574,196962,77401,119561,6.407,16.305,27413,2.269,32.610,7010,7205,48056
1989,23,26838,30964,435299,426149,4434,14.560,3413,11.207,79970,29471,50499,6.916,18.766,61829,23736,38093,5.570,14.509,18141,4.257,29.018,2557,2610,14226
1989,24,82530,101160,1805361,1786515,13742,13.811,10429,10.481,320127,120217,199910,6.729,17.919,283161,97871,185290,5.478,15.850,36966,2.069,31.700,7178,7308,53342
1989,25,123448,145960,2893496,2869174,17909,12.377,15380,10.629,488269,172332,315937,6.006,17.018,442067,141620,300447,4.936,15.407,46202,1.610,30.815,11315,11487,78805
1989,26,151009,184921,3340371,3280197,22806,12.513,17491,9.597,547868,177071,370797,5.398,16.702,428096,141883,286213,4.325,13.051,119772,3.651,26.102,12342,12725,76735
1989,27,81102,97940,1782143,1753611,11657,12.031,9557,9.864,288989,98980,190009,5.644,16.480,233131,89544,143587,5.106,13.294,55858,3.185,26.589,6577,6749,45756
1989,28,39476,47842,719586,711850,6089,12.820,5399,11.367,117381,43244,74137,6.075,16.490,101989,36862,65127,5.178,14.327,15392,2.162,28.655,3800,3866,21984
1989,29,95156,115761,1944641,1911850,14731,12.869,12151,10.615,335641,110574,225067,5.784,17.556,272000,95520,176480,4.996,14.227,63641,3.329,28.454,8598,8830,57742
1989,30,19121,21983,212817,209632,2598,11.827,2566,11.681,37279,12295,24984,5.865,17.783,30860,11990,18870,5.720,14.721,6419,3.062,29.442,1791,1805,7846
1989,31,33308,39428,564895,552572,4325,11.041,3812,9.732,96478,35478,61000,6.421,17.460,71893,29407,42486,5.322,13.011,24585,4.449,26.021,2638,2710,16770
1989,32,22220,26025,507858,487920,4359,17.201,2993,11.810,117617,37458,80159,7.677,24.106,78288,31948,46340,6.548,16.045,39329,8.061,32.091,2074,2118,18333
1989,33,27118,30946,473467,471321,4334,14.112,3863,12.579,77843,29622,48221,6.285,16.516,73806,26184,47622,5.555,15.659,4037,0.857,31.319,2999,3033,16943
1989,34,164925,190163,3265280,3237624,24050,12.745,21126,11.195,573612,201285,372327,6.217,17.717,518346,165498,352848,5.112,16.010,55266,1.707,32.020,15341,15567,89947
1989,35,26870,31963,405053,401686,4504,14.200,4015,12.658,76138,29470,46668,7.337,18.955,69300,26406,42894,6.574,17.252,6838,1.702,34.505,2816,2880,16168
1989,36,357007,409500,6984051,6946662,52460,12.905,46485,11.435,1135325,391649,743676,5.638,16.343,1063207,369407,693800,5.318,15.305,72118,1.038,30.611,34574,35175,208243
1989,37,118581,147195,2627973,2590230,19196,13.217,15271,10.515,434132,161162,272970,6.222,16.760,361811,121748,240063,4.700,13.968,72321,2.792,27.937,10321,10566,60938
1989,38,14722,17145,190630,188861,1724,10.092,1600,9.366,28425,10761,17664,5.698,15.051,25149,8892,16257,4.708,13.316,3276,1.735,26.632,1165,1173,5025
1989,39,176400,223516,4187951,4113681,25453,11.499,21130,9.546,702765,254212,448553,6.180,17.084,553388,202571,350817,4.924,13.452,149377,3.631,26.905,14190,14730,99573
1989,40,55613,67227,918201,904604,8531,12.713,8285,12.347,165093,60537,104556,6.692,18.250,138279,54993,83286,6.079,15.286,26814,2.964,30.572,5913,6025,32954
1989,41,60065,71197,977200,958670,9804,13.960,7866,11.201,191019,67502,123517,7.041,19.925,153136,62652,90484,6.535,15.974,37883,3.952,31.948,5604,5745,32244
1989,42,205945,251588,4509230,4454993,28812,11.582,23165,9.312,707691,237246,470445,5.325,15.885,600170,216875,383295,4.868,13.472,107521,2.413,26.944,16095,16534,110742
1989,44,22387,24980,402577,404555,3245,13.128,2721,11.008,64033,24276,39757,6.001,15.828,68280,25900,42380,6.402,16.878,-4247,-1.050,31.656,2095,2112,16246
1989,45,57941,71339,1241355,1221046,9431,13.388,7641,10.847,210323,77484,132839,6.346,17.225,170860,62973,107887,5.157,13.993,39463,3.232,27.986,5321,5413,31492
1989,46,15519,17802,208999,204933,1942,11.008,1622,9.194,33763,9600,24163,4.684,16.475,25614,9389,16225,4.582,12.499,8149,3.976,24.997,1172,1184,5266
1989,47,82233,102209,1849306,1818489,13845,13.729,11111,11.018,336512,120780,215732,6.642,18.505,273301,107541,165760,5.914,15.029,63211,3.476,30.058,7745,7984,57639
1989,48,275205,352087,5681489,5594655,48185,13.695,47700,13.557,1150062,447577,702485,8.000,20.556,979543,408144,571399,7.295,17.509,170519,3.048,35.017,32776,34127,235074
1989,49,26555,32180,543590,528486,4528,14.144,4197,13.110,116940,45527,71413,8.615,22.127,87172,35526,51646,6.722,16.495,29768,5.633,32.989,2879,2951,20296
1989,50,15771,17606,220589,215829,2490,14.412,1833,10.609,35520,12695,22825,5.882,16.458,26134,9736,16398,4.511,12.109,9386,4.349,24.217,1417,1434,7219
1989,51,105446,133008,2308636,2268073,18632,14.259,13947,10.674,410103,158866,251237,7.004,18.082,330082,118696,211386,5.233,14.553,80021,3.528,29.107,9671,9934,57741
1989,53,94010,112387,1630596,1580114,16145,14.581,12821,11.579,334049,117083,216966,7.410,21.141,232311,83076,149235,5.258,14.702,101738,6.439,29.404,8837,8989,51876
1989,54,28330,34026,474510,470282,3932,11.639,3448,10.206,74906,29741,45165,6.324,15.928,66536,23547,42989,5.007,14.148,8370,1.780,28.296,2476,2520,14244
1989,55,90996,108747,1905477,1869452,12015,11.163,9791,9.096,293105,89501,203604,4.788,15.679,220983,74220,146763,3.970,11.821,72122,3.858,23.641,6844,7037,39157
1989,56,11159,12830,126619,125274,1570,12.250,1542,12.032,22905,7751,15154,6.187,18.284,20205,7625,12580,6.087,16.129,2700,2.155,32.257,1043,1055,4744
1990,01,64308,79785,1355195,1331770,10005,12.648,8639,10.921,224969,74008,150961,5.557,16.892,177586,59522,118064,4.469,13.335,47383,3.558,26.669,6328,6467,39902
1990,02,10605,12651,157795,151643,1854,14.860,1505,12.063,35617,10784,24833,7.111,23.487,23366,9723,13643,6.412,15.409,12251,8.079,30.817,1050,1085,6804
1990,04,63498,78603,1259335,1246950,11743,15.052,10569,13.547,247568,99160,148408,7.952,19.854,223653,77639,146014,6.226,17.936,23915,1.918,35.872,7472,7681,48107
1990,05,41306,48873,749841,736795,6118,12.650,5101,10.547,123671,44148,79523,5.992,16.785,97159,32305,64854,4.385,13.187,26512,3.598,26.373,3790,3848,21555
1990,06,541805,660730,11284942,11083632,93939,14.402,76989,11.804,2195062,786176,1408886,7.093,19.805,1793806,640851,1152955,5.782,16.184,401256,3.620,32.369,55120,56401,386122
1990,08,72293,86481,1277326,1255806,11948,13.956,10205,11.920,235165,91577,143588,7.292,18.726,192401,75644,116757,6.024,15.321,42764,3.405,30.642,7248,7414,45097
1990,09,72275,84136,1503005,1519746,9280,11.006,9645,11.439,210196,72746,137450,4.787,13.831,244044,86276,157768,5.677,16.058,-33848,-2.227,27.662,7089,7199,41351
1990,10,14099,16560,312717,310616,2268,13.956,1649,10.147,46615,15381,31234,4.952,15.007,42495,14463,28032,4.656,13.681,4120,1.326,27.362,1153,1163,6839
1990,11,14255,17243,396413,398498,1963,11.315,2175,12.537,57056,19967,37089,5.011,14.318,61679,17627,44052,4.423,15.478,-4623,-1.160,28.636,1511,1532,9850
1990,12,265351,324143,4681387,4629934,50716,15.869,41617,13.022,912616,371384,541232,8.021,19.711,807135,298811,508324,6.454,17.433,105481,2.278,34.866,31291,32038,194742
1990,13,113288,142854,2561470,2535527,19409,13.711,16820,11.882,458102,167202,290900,6.594,18.067,406362,140325,266037,5.534,16.027,51740,2.041,32.053,11872,12164,77076
1990,15,21577,26636,431786,420658,3424,13.059,2589,9.875,76721,29909,46812,7.110,18.238,53773,20335,33438,4.834,12.783,22948,5.455,25.566,1790,1838,11667
1990,16,20414,24039,307264,299823,3383,14.423,2215,9.444,57790,19637,38153,6.550,19.275,43342,14335,29007,4.781,14.456,14448,4.819,28.912,1585,1611,9399
1990,17,202821,244994,4647374,4593583,27910,11.508,22979,9.475,698664,237530,461134,5.171,15.210,591205,190003,401202,4.136,12.870,107459,2.339,25.740,16298,16620,103561
1990,18,95096,117810,2157919,2134747,13284,11.397,10783,9.251,315535,107146,208389,5.019,14.781,268866,81608,187258,3.823,12.595,46669,2.186,25.189,7814,8002,49173
1990,19,55084,67010,1021670,1006109,6654,10.011,5574,8.386,145334,46566,98768,4.628,14.445,113938,33792,80146,3.359,11.325,31396,3.121,22.649,4087,4188,23102
1990,20,50047,60145,893695,880854,6533,10.865,6500,10.810,138585,47824,90761,5.429,15.733,113735,40630,73105,4.613,12.912,24850,2.821,25.824,4725,4830,25317
1990,21,59898,72470,1193443,1174267,8665,12.059,7437,10.350,191987,68319,123668,5.818,16.350,153336,52241,101095,4.449,13.058,38651,3.292,26.116,5486,5572,31913
1990,22,65686,80998,1277958,1249783,9539,11.824,8891,11.021,233422,79301,154121,6.345,18.677,176793,65539,111254,5.244,14.146,56629,4.531,28.292,6349,6498,41725
1990,23,26374,30588,423463,429092,3495,11.355,3878,12.599,60366,24424,35942,5.692,14.068,71789,22293,49496,5.195,16.730,-11423,-2.662,28.137,2957,3001,15642
1990,24,84615,103955,1846628,1826136,13280,12.948,10491,10.229,315597,109448,206149,5.993,17.282,275093,90899,184194,4.978,15.064,40504,2.218,30.128,7386,7537,53645
1990,25,120540,143649,2789646,2848519,15063,10.401,17409,12.021,368350,131443,236907,4.614,12.931,486493,142873,343620,5.016,17.079,-118143,-4.148,25.863,12887,13114,84133
1990,26,153844,188929,3398906,3372113,21828,11.676,17871,9.559,522571,193621,328950,5.742,15.497,469681,136147,333534,4.037,13.928,52890,1.568,27.857,12885,13248,77989
1990,27,82849,99960,1834247,1809741,11278,11.397,9276,9.374,278134,88644,189490,4.898,15.369,227785,77706,150079,4.294,12.587,50349,2.782,25.173,6512,6655,42997
1990,28,39945,48452,742537,730961,5981,12.421,5378,11.169,119137,41708,77429,5.706,16.299,96663,33970,62693,4.647,13.224,22474,3.075,26.448,3906,3993,21147
1990,29,96772,117642,1990857,1968052,14023,12.014,12175,10.431,310598,109421,201177,5.560,15.782,264531,85788,178743,4.359,13.441,46067,2.341,26.883,8610,8832,51855
1990,30,19513,22399,223520,218463,2581,11.626,2183,9.833,38321,12088,26233,5.533,17.541,28237,9950,18287,4.555,12.925,10084,4.616,25.851,1559,1576,6393
1990,31,33656,39922,588091,576458,4070,10.258,3579,9.020,86667,30202,56465,5.239,15.034,63402,20196,43206,3.503,10.999,23265,4.036,21.997,2540,2585,13500
1990,32,23329,27350,546846,527217,4458,16.702,3142,11.771,117904,36930,80974,7.005,22.363,78295,26416,51879,5.010,14.851,39609,7.513,29.701,2256,2282,18867
1990,33,26148,30088,453461,463294,3606,11.815,4469,14.643,65404,26639,38765,5.750,14.117,84868,28371,56497,6.124,18.318,-19464,-4.201,28.234,3450,3505,19044
1990,34,164966,191452,3266916,3265695,22841,11.971,21557,11.298,522651,195995,326656,6.002,16.004,519839,158336,361503,4.848,15.918,2812,0.086,31.836,15777,15958,91156
1990,35,27452,32596,420687,413178,4390,13.597,3773,11.686,76303,28910,47393,6.997,18.467,61068,23259,37809,5.629,14.780,15235,3.687,29.560,2629,2683,15110
1990,36,356484,411478,7020092,7006216,49092,11.958,47193,11.496,1069438,368953,700485,5.266,15.264,1041020,339852,701168,4.851,14.859,28418,0.406,29.717,35840,36340,203620
1990,37,121606,151150,2708536,2669012,18947,12.701,15005,10.058,429103,149397,279706,5.597,16.077,350884,115725,235159,4.336,13.147,78219,2.931,26.293,10659,10928,63649
1990,38,14746,17201,197034,193870,1651,9.611,1604,9.338,28343,8814,19529,4.546,14.620,21968,7919,14049,4.085,11.331,6375,3.288,22.663,1185,1198,5124
1990,39,178170,226702,4261175,4228758,23985,10.654,20818,9.248,607796,211148,396648,4.993,14.373,543150,163725,379425,3.872,12.844,64646,1.529,25.688,14611,14975,97316
1990,40,56263,67938,942563,930571,8344,12.346,7634,11.296,161224,58828,102396,6.322,17.325,137765,50172,87593,5.392,14.804,23459,2.521,29.609,5509,5636,30468
1990,41,61204,72557,1017118,997017,9421,13.106,8070,11.227,185011,62951,122060,6.314,18.556,144625,53755,90870,5.392,14.506,40386,4.051,29.012,5732,5862,34853
1990,42,209246,256255,4608265,4564446,27432,10.802,22832,8.991,662318,208942,453376,4.578,14.510,574091,176424,397667,3.865,12.577,88227,1.933,25.155,16385,16728,104288
1990,44,22153,24795,392081,397490,2729,10.966,2910,11.694,53371,21412,31959,5.387,13.427,64690,19354,45336,4.869,16.275,-11319,-2.848,26.854,2249,2266,12313
1990,45,59310,73137,1294192,1267814,9545,13.212,7766,10.749,219996,83531,136465,6.589,17.352,166868,57539,109329,4.538,13.162,53128,4.191,26.324,5571,5711,34115
1990,46,15931,18276,219667,214283,2116,11.726,1654,9.166,37060,12946,24114,6.042,17.295,26411,10480,15931,4.891,12.325,10649,4.970,24.651,1194,1209,5057
1990,47,83257,103872,1886463,1866526,12796,12.417,11156,10.826,302540,111714,190826,5.985,16.209,262411,88063,174348,4.718,14.059,40129,2.150,28.118,8005,8154,50373
1990,48,279533,358019,5883342,5787691,48851,13.758,42970,12.102,1136566,435127,701439,7.518,19.638,942355,372201,570154,6.431,16.282,194211,3.356,32.564,30164,31208,213803
1990,49,27088,32838,572654,558668,4307,13.247,3655,11.242,107153,36339,70814,6.505,19.180,79524,29262,50262,5.238,14.235,27629,4.946,28.469,2544,2614,17221
1990,50,15787,17672,215650,217944,2062,11.686,2008,11.380,30066,10234,19832,4.696,13.795,34700,11116,23584,5.100,15.922,-4634,-2.126,27.591,1555,1567,7115
1990,51,107977,136758,2365842,2337394,17856,13.238,14116,10.465,393885,147050,246835,6.291,16.851,338283,103675,234608,4.435,14.473,55602,2.379,28.945,9946,10143,58477
1990,53,97998,116943,1723503,1677130,16828,14.674,12297,10.723,333767,107877,225890,6.432,19.901,242606,97485,145121,5.813,14.466,91161,5.436,28.931,8585,8786,51117
1990,54,28630,34489,491396,483381,3959,11.554,3509,10.241,77332,27539,49793,5.697,15.998,61710,21974,39736,4.546,12.766,15622,3.232,25.533,2575,2618,14119
1990,55,92839,111163,1969915,1938583,11631,10.576,9253,8.414,277646,94096,183550,4.854,14.322,215797,66370,149427,3.424,11.132,61849,3.190,22.263,6648,6840,39420
1990,56,11298,12984,133226,130065,1540,11.933,1382,10.709,24909,8225,16684,6.324,19.151,18553,7061,11492,5.429,14.264,6356,4.887,28.529,956,971,4527
1991,01,64048,80275,1351735,1356431,9738,12.174,9173,11.467,216462,90499,125963,6.672,15.958,225330,84091,141239,6.199,16.612,-8868,-0.654,31.916,6319,6480,50384
1991,02,10804,13053,162089,160593,1896,14.758,1485,11.559,33269,11900,21369,7.410,20.716,30198,9015,21183,5.614,18.804,3071,1.912,37.608,985,1007,5858
1991,04,64018,79974,1257486,1257967,11855,14.959,10405,13.130,237754,109273,128481,8.686,18.900,239287,87002,152285,6.916,19.022,-1533,-0.122,37.800,7192,7397,56367
1991,05,41164,49296,759543,757432,5978,12.184,5516,11.242,117904,44251,73653,5.842,15.566,114293,37236,77057,4.916,15.090,3611,0.477,30.179,3946,3996,23108
1991,06,539450,666418,10910869,11105632,91861,13.851,85419,12.880,1891944,733884,1158060,6.608,17.036,2279478,771273,1508205,6.945,20.525,-387534,-3.490,34.072,60282,61739,494404
1991,08,73714,88755,1291893,1284194,12601,14.391,10218,11.669,228098,89072,139026,6.936,17.762,213074,79640,133434,6.202,16.592,15024,1.170,33.184,7114,7280,49573
1991,09,69609,82016,1429553,1464084,8411,10.130,10440,12.574,192131,70672,121459,4.827,13.123,261233,79726,181507,5.445,17.843,-69102,-4.720,26.246,7475,7607,47051
1991,10,14251,17016,313889,313201,2305,13.731,1846,10.997,47647,19369,28278,6.184,15.213,46546,11996,34550,3.830,14.861,1101,0.352,29.723,1250,1286,7234
1991,11,14183,17218,384694,392923,2108,12.243,2108,12.243,51862,20053,31809,5.104,13.199,68788,20678,48110,5.263,17.507,-16926,-4.308,26.398,1279,1317,11743
1991,12,264845,326673,4598812,4640953,49056,15.082,46228,14.213,867850,384571,483279,8.286,18.700,950380,351874,598506,7.582,20.478,-82530,-1.778,37.400,33230,34115,225802
1991,13,112667,143609,2470924,2517488,19130,13.363,18221,12.728,405598,172091,233507,6.836,16.111,496161,188838,307323,7.501,19.709,-90563,-3.597,32.222,12398,12725,111033
1991,15,21883,27436,435194,433077,3608,13.347,2799,10.355,75742,32726,43016,7.557,17.489,71672,23725,47947,5.478,16.549,4070,0.940,33.099,1931,1982,14857
1991,16,20754,24616,311353,309163,3126,12.858,2517,10.353,56728,20799,35929,6.728,18.349,51968,20070,31898,6.492,16.809,4760,1.540,33.619,1715,1737,10181
1991,17,202608,247260,4593416,4620775,27808,11.303,25349,10.303,660725,255818,404907,5.536,14.299,716714,236127,480587,5.110,15.511,-55989,-1.212,28.598,17678,18085,141703
1991,18,95108,119291,2108141,2128758,13309,11.233,11699,9.874,289993,113253,176740,5.320,13.623,332519,102522,229997,4.816,15.620,-42526,-1.998,27.245,8283,8482,64241
1991,19,55167,67902,1025600,1023992,6725,9.976,5743,8.519,136486,45927,90559,4.485,13.329,132703,41528,91175,4.056,12.959,3783,0.369,25.919,4050,4130,23894
1991,20,49638,60336,887157,889961,6943,11.534,6661,11.066,134223,53771,80452,6.042,15.082,139740,48244,91496,5.421,15.702,-5517,-0.620,30.164,4648,4814,30971
1991,21,59444,73086,1190122,1191967,8520,11.713,7833,10.768,182936,73544,109392,6.170,15.347,187047,60538,126509,5.079,15.692,-4111,-0.345,30.695,5735,5835,38810
1991,22,65682,81951,1302336,1291410,9832,12.074,8799,10.805,234686,87459,147227,6.772,18.173,213549,79232,134317,6.135,16.536,21137,1.637,33.072,6185,6358,47329
1991,23,25560,30079,401092,412297,3337,11.004,3830,12.630,51184,20149,31035,4.887,12.414,73530,24243,49287,5.880,17.834,-22346,-5.420,24.829,2730,2760,14987
1991,24,83665,104115,1738684,1793229,12598,12.115,12348,11.874,250118,104219,145899,5.812,13.948,359001,119888,239113,6.686,20.020,-108883,-6.072,27.896,8494,8638,65463
1991,25,115081,139407,2588864,2691015,14445,10.212,18539,13.106,325442,124324,201118,4.620,12.094,528947,177250,351697,6.587,19.656,-203505,-7.562,24.187,12718,13125,108596
1991,26,153738,190567,3263051,3338408,21225,11.192,19375,10.217,438580,165271,273309,4.951,13.137,589804,189144,400660,5.666,17.667,-151224,-4.530,26.275,13657,14032,108192
1991,27,83447,101869,1798360,1814067,11955,11.857,9869,9.788,258842,100967,157875,5.566,14.269,290791,96288,194503,5.308,16.030,-31949,-1.761,28.537,6883,7071,57726
1991,28,39765,48761,746067,744656,5917,12.181,5548,11.421,115074,43903,71171,5.896,15.453,112439,36204,76235,4.862,15.099,2635,0.354,30.199,3897,3947,22909
1991,29,96077,118321,1940874,1959624,14087,11.949,13229,11.221,282005,112964,169041,5.765,14.391,319810,110324,209486,5.630,16.320,-37805,-1.929,28.782,9256,9525,65499
1991,30,19634,22763,224319,223544,2690,11.926,2277,10.095,36448,14018,22430,6.271,16.305,34774,11400,23374,5.100,15.556,1674,0.749,31.112,1641,1671,8007
1991,31,33648,40465,590098,587891,4287,10.674,3684,9.173,84824,30164,54660,5.131,14.429,80770,28812,51958,4.901,13.739,4054,0.690,27.478,2620,2680,19467
1991,32,24026,28518,540582,539427,4561,16.336,3365,12.052,99159,37613,61546,6.973,18.382,96054,28863,67191,5.351,17.807,3105,0.576,35.613,2369,2408,19379
1991,33,24916,29141,428402,444803,3447,11.650,4342,14.675,56863,25059,31804,5.634,12.784,89460,33226,56234,7.470,20.112,-32597,-7.328,25.568,3147,3200,20211
1991,34,160681,188191,3082870,3166894,21223,11.187,24263,12.789,448073,162962,285111,5.146,14.149,615168,192089,423079,6.066,19.425,-167095,-5.276,28.297,16863,17128,111284
1991,35,27690,33172,430467,425720,4557,13.868,3931,11.963,83910,34038,49872,7.995,19.710,74316,28904,45412,6.789,17.457,9594,2.254,34.913,2700,2771,17709
1991,36,349668,408058,6703646,6867225,47308,11.550,50353,12.294,923849,368276,555573,5.363,13.453,1254026,395604,858422,5.761,18.261,-330177,-4.808,26.906,37313,37916,259333
1991,37,120481,151663,2595759,2648638,17926,11.847,17223,11.382,351458,144720,206738,5.464,13.269,458596,145968,312628,5.511,17.314,-107138,-4.045,26.539,12040,12349,82956
1991,38,14628,17278,201214,198954,1766,10.252,1661,9.643,31395,12755,18640,6.411,15.780,26876,8958,17918,4.503,13.509,4519,2.271,27.017,1160,1185,5900
1991,39,177455,228183,4142513,4214629,23753,10.449,22026,9.689,540243,200833,339410,4.765,12.818,688287,219480,468807,5.208,16.331,-148044,-3.513,25.637,15102,15422,134461
1991,40,56727,69010,952409,946755,8668,12.668,7500,10.961,156211,62777,93434,6.631,16.500,143867,55052,88815,5.815,15.196,12344,1.304,30.392,5296,5430,34663
1991,41,61646,74027,1031471,1024427,9970,13.611,8415,11.488,186191,72238,113953,7.052,18.175,171736,61016,110720,5.956,16.764,14455,1.411,33.528,5881,6081,40728
1991,42,207552,256746,4517565,4566307,26055,10.164,25251,9.850,609250,223368,385882,4.892,13.342,707827,233158,474669,5.106,15.501,-98577,-2.159,26.685,17732,18227,136121
1991,44,21250,23958,365496,378684,2446,10.039,3259,13.376,49807,21304,28503,5.626,13.153,76471,23701,52770,6.259,20.194,-26664,-7.041,26.305,2306,2341,15402
1991,45,59394,74205,1262760,1279593,9606,13.046,8459,11.488,189849,82469,107380,6.445,14.837,223756,76105,147651,5.948,17.487,-33907,-2.650,29.673,5853,6038,44938
1991,46,16090,18705,229943,224207,2127,11.511,1672,9.049,40024,17461,22563,7.788,17.851,28818,9561,19257,4.264,12.853,11206,4.998,25.707,1205,1217,6477
1991,47,82662,104623,1850556,1869083,12768,12.257,11859,11.384,279489,112694,166795,6.029,14.953,316361,104045,212316,5.567,16.926,-36872,-1.973,29.907,8288,8471,65283
1991,48,281221,363559,5953727,5917530,49783,13.807,43788,12.144,1126933,453916,673017,7.671,19.044,1056926,416688,640238,7.042,17.861,70007,1.183,35.722,29970,30946,246637
1991,49,27707,33824,596073,584192,4712,14.147,3680,11.048,115026,40790,74236,6.982,19.690,92051,32480,59571,5.560,15.757,22975,3.933,31.514,2522,2599,21470
1991,50,15423,17442,205056,210180,1850,10.538,2078,11.836,26800,11522,15278,5.482,12.751,37172,11849,25323,5.638,17.686,-10372,-4.935,25.502,1541,1549,8290
1991,51,106430,136700,2257961,2309199,16573,12.128,16471,12.054,329987,141540,188447,6.129,14.290,432994,132495,300499,5.738,18.751,-103007,-4.461,28.580,11180,11543,76088
1991,53,99816,120498,1753154,1739266,16975,14.305,13313,11.219,324526,123122,201404,7.079,18.659,295127,91315,203812,5.250,16.968,29399,1.690,33.937,9097,9279,59413
1991,54,28509,34731,487270,488793,3868,11.183,3580,10.351,70694,28877,41817,5.908,14.463,73562,22764,50798,4.657,15.050,-2868,-0.587,28.926,2470,2510,14496
1991,55,93006,112826,1951733,1960299,11877,10.613,10050,8.980,254085,89458,164627,4.563,12.962,271139,90565,180574,4.620,13.832,-17054,-0.870,25.923,7074,7268,58362
1991,56,11478,13310,136935,135609,1648,12.538,1317,10.019,23640,7978,15662,5.883,17.433,20733,7183,13550,5.297,15.289,2907,2.144,30.578,932,938,5199
1992,01,64646,81087,1368905,1364074,9450,11.716,8588,10.648,216726,72246,144480,5.296,15.888,205987,68900,137087,5.051,15.101,10739,0.787,30.202,5788,5934,38735
1992,02,10982,13357,163884,165424,1824,13.831,1485,11.261,34064,10459,23605,6.323,20.592,36638,9308,27330,5.627,22.148,-2574,-1.556,41.184,921,939,5297
1992,04,64895,80802,1270962,1263194,11221,13.966,10313,12.835,243816,93583,150233,7.408,19.302,227988,81624,146364,6.462,18.049,15828,1.253,36.097,6511,6686,42293
1992,05,41632,49979,781235,775910,6006,12.106,5273,10.628,127530,41238,86292,5.315,16.436,116762,35781,80981,4.611,15.048,10768,1.388,30.097,3582,3657,21856
1992,06,531768,659229,10471475,10684729,82215,12.410,88729,13.393,1824006,657478,1166528,6.153,17.071,2248550,817325,1431225,7.649,21.045,-424544,-3.973,34.142,58964,60431,450625
1992,08,75409,90545,1330263,1309787,12360,13.797,10441,11.655,250730,94944,155786,7.249,19.143,208651,84016,124635,6.414,15.930,42079,3.213,31.860,6755,6903,43843
1992,09,67957,80408,1404032,1415667,7990,9.843,9526,11.735,198417,62809,135608,4.437,14.016,221557,67994,153563,4.803,15.650,-23140,-1.635,28.032,6298,6439,35781
1992,10,14240,17115,308665,310832,2192,12.853,2071,12.143,48863,20920,27943,6.730,15.720,52927,18327,34600,5.896,17.028,-4064,-1.307,31.440,1259,1269,7397
1992,11,14025,17086,393285,387881,1806,10.540,1902,11.101,65054,35894,29160,9.254,16.772,55781,16679,39102,4.300,14.381,9273,2.391,28.762,1127,1138,8679
1992,12,268693,330492,4590937,4588680,48440,14.746,44447,13.530,879841,352893,526948,7.691,19.174,876149,356894,519255,7.778,19.094,3692,0.080,38.187,30435,31230,196942
1992,13,114368,145279,2513146,2494719,19120,13.241,17354,12.018,452112,164622,287490,6.599,18.123,415473,159647,255826,6.399,16.654,36639,1.469,33.308,11012,11413,78150
1992,15,21769,27499,445088,439649,3029,11.042,2894,10.550,75732,23631,52101,5.375,17.226,64857,20824,44033,4.737,14.752,10875,2.474,29.504,1887,1918,12223
1992,16,21444,25396,324266,317232,3307,13.234,2494,9.980,59740,20352,39388,6.415,18.832,45671,14834,30837,4.676,14.397,14069,4.435,28.793,1618,1658,8430
1992,17,203066,248602,4556281,4566630,26918,10.866,25166,10.159,689965,230464,459501,5.047,15.109,709921,239931,469990,5.254,15.546,-19956,-0.437,30.218,16290,16661,124453
1992,18,95700,120590,2157448,2141151,12845,10.716,11403,9.513,344384,121197,223187,5.660,16.084,313495,94735,218760,4.424,14.641,30889,1.443,29.283,7636,7799,50156
1992,19,55502,68520,1043188,1033627,6594,9.670,5934,8.702,155908,52098,103810,5.040,15.084,136046,44967,91079,4.350,13.162,19862,1.922,26.324,3926,4013,24751
1992,20,49944,60950,896557,891457,6723,11.093,6031,9.951,139509,50639,88870,5.680,15.650,129626,41833,87793,4.693,14.541,9883,1.109,29.082,3976,4044,24648
1992,21,59600,73541,1203855,1195638,8130,11.094,7618,10.395,177797,58505,119292,4.893,14.870,161450,52888,108562,4.423,13.503,16347,1.367,27.007,5240,5335,31653
1992,22,66252,82672,1311196,1303034,9422,11.454,8590,10.443,233972,75898,158074,5.825,17.956,217048,75075,141973,5.762,16.657,16924,1.299,33.314,5570,5714,40954
1992,23,25298,29867,394049,396763,3176,10.603,3347,11.174,56621,20408,36213,5.144,14.271,62226,22043,40183,5.556,15.683,-5605,-1.413,28.542,2221,2262,10979
1992,24,83792,104446,1714024,1730309,11979,11.491,11577,11.106,270212,95624,174588,5.526,15.616,302756,98481,204275,5.692,17.497,-32544,-1.881,31.233,7313,7501,49767
1992,25,112932,137194,2555418,2566945,13658,9.880,15744,11.389,378033,129215,248818,5.034,14.727,399793,129904,269889,5.061,15.575,-21760,-0.848,29.454,10047,10303,68158
1992,26,153465,190724,3301197,3279608,19770,10.377,19375,10.169,507045,149276,357769,4.552,15.461,462522,142273,320249,4.338,14.103,44523,1.358,28.206,12664,12974,75848
1992,27,84170,102969,1842650,1818919,11298,11.039,10056,9.825,288041,92938,195103,5.110,15.836,240875,81793,159082,4.497,13.243,47166,2.593,26.486,6489,6680,43700
1992,28,39999,49002,754196,749340,5474,11.202,5203,10.647,116213,33878,82335,4.521,15.509,106130,34695,71435,4.630,14.163,10083,1.346,28.326,3465,3534,19589
1992,29,96612,118902,1982761,1969890,13390,11.295,12692,10.706,300197,99054,201143,5.028,15.239,274775,89933,184842,4.565,13.949,25422,1.291,27.897,8224,8403,43439
1992,30,20078,23378,236268,229842,2938,12.742,2297,9.962,44653,14157,30496,6.159,19.428,31937,12586,19351,5.476,13.895,12716,5.533,27.790,1529,1568,7161
1992,31,33964,40804,593364,590839,4089,10.065,3733,9.189,80345,25090,55255,4.247,13.598,75107,22895,52212,3.875,12.712,5238,0.887,25.424,2462,2514,13648
1992,32,24405,29132,541738,540559,4372,15.177,3722,12.920,91881,37010,54871,6.847,16.997,89260,28132,61128,5.204,16.513,2621,0.485,33.025,2461,2487,16822
1992,33,24617,29023,421995,420826,3413,11.740,3511,12.077,68205,24510,43695,5.824,16.207,65933,22667,43266,5.386,15.668,2272,0.540,31.335,2407,2450,12686
1992,34,158984,186212,3057761,3069280,19855,10.611,21670,11.581,479580,139908,339672,4.558,15.625,502764,160825,341939,5.240,16.381,-23184,-0.755,31.250,14311,14479,79699
1992,35,27933,33585,442371,436832,4320,12.942,3909,11.711,85368,32057,53311,7.339,19.543,74129,26009,48120,5.954,16.970,11239,2.573,33.939,2516,2587,14228
1992,36,344084,402210,6589439,6644998,43310,10.695,48798,12.050,978852,313585,665267,4.719,14.731,1088853,383220,705633,5.767,16.386,-110001,-1.655,29.461,34248,34709,193524
1992,37,120846,152563,2649698,2621691,16920,11.127,15924,10.472,415652,135606,280046,5.172,15.854,359875,125301,234574,4.779,13.727,55777,2.128,27.454,10353,10565,55659
1992,38,14610,17338,208332,205212,1670,9.649,1608,9.291,31273,9838,21435,4.794,15.239,25032,7243,17789,3.530,12.198,6241,3.041,24.396,1066,1077,4467
1992,39,177169,228293,4127291,4130597,22340,9.794,21971,9.632,579812,191697,388115,4.641,14.037,586405,190638,395767,4.615,14.197,-6593,-0.160,28.074,13900,14288,104007
1992,40,57052,69553,957975,953693,8233,11.890,7609,10.989,159164,55101,104063,5.778,16.689,151321,55488,95833,5.818,15.867,7843,0.822,31.734,5257,5373,31397
1992,41,62700,75228,1030095,1028738,9453,12.673,8175,10.960,178122,67255,110867,6.538,17.315,176006,63148,112858,6.138,17.109,2116,0.206,34.218,5299,5392,31870
1992,42,205455,255123,4475634,4503988,23918,9.351,25229,9.864,618315,203898,414417,4.527,13.728,678180,208647,469533,4.632,15.057,-59865,-1.329,27.456,16597,17002,101267
1992,44,20789,23475,359432,361762,2419,10.202,2891,12.193,55844,21893,33951,6.052,15.437,60220,22144,38076,6.121,16.646,-4376,-1.210,30.873,1898,1931,11840
1992,45,59592,74569,1278187,1269693,8755,11.773,8347,11.224,200269,72387,127882,5.701,15.773,182786,58147,124639,4.580,14.396,17483,1.377,28.792,5525,5616,32579
1992,46,16224,18907,241117,235606,1997,10.626,1771,9.423,39879,12528,27351,5.317,16.926,28819,9373,19446,3.978,12.232,11060,4.694,24.464,1171,1182,5826
1992,47,83245,105373,1898818,1874614,12213,11.634,11413,10.872,312323,96681,215642,5.157,16.661,264334,96633,167701,5.155,14.101,47989,2.560,28.201,7326,7496,46648
1992,48,285458,368891,6004073,5991023,48667,13.296,42932,11.729,1120397,429937,690460,7.176,18.701,1094605,379989,714616,6.343,18.271,25792,0.431,36.542,27724,28620,200950
1992,49,28554,34786,617280,606404,4822,14.065,3815,11.128,118560,42116,76444,6.945,19.551,96586,38201,58385,6.300,15.928,21974,3.624,31.855,2471,2527,23517
1992,50,15288,17314,205884,206001,1773,10.206,1889,10.874,29867,9995,19872,4.852,14.499,30064,9672,20392,4.695,14.594,-197,-0.096,28.997,1300,1310,6595
1992,51,107007,137321,2263786,2259845,16022,11.700,15256,11.141,357349,129022,228327,5.709,15.813,351126,116608,234518,5.160,15.538,6223,0.275,31.075,9549,9843,56003
1992,53,102516,123811,1791888,1769655,16949,13.884,13482,11.044,348153,124717,223436,7.048,19.674,304769,113739,191030,6.427,17.222,43384,2.452,34.444,8725,8886,50543
1992,54,28574,34848,483642,484966,3665,10.544,3490,10.040,73421,25091,48330,5.174,15.139,75821,26686,49135,5.503,15.634,-2400,-0.495,30.279,2218,2265,12142
1992,55,93584,113793,1983955,1965568,11055,9.762,9968,8.802,270452,81227,189225,4.132,13.759,233746,69540,164206,3.538,11.892,36706,1.867,23.784,6577,6686,37695
1992,56,11606,13411,138748,137701,1557,11.660,1441,10.792,24026,7353,16673,5.340,17.448,21928,7275,14653,5.283,15.924,2098,1.524,31.849,852,879,3904
1993,01,66295,82711,1416879,1392926,9602,11.724,7975,9.738,226900,67144,159756,4.820,16.289,178343,59535,118808,4.274,12.803,48557,3.486,25.607,5361,5502,31565
1993,02,11286,13583,165873,164829,1733,12.868,1503,11.160,30116,8426,21690,5.112,18.271,28179,8602,19577,5.219,17.096,1937,1.175,34.192,897,937,4565
1993,04,66946,82289,1317360,1293439,11160,13.686,9667,11.855,250776,82972,167804,6.415,19.388,204453,77137,127316,5.964,15.807,46323,3.581,31.614,6190,6360,41198
1993,05,43009,51268,812995,796813,6256,12.358,4969,9.815,129411,40081,89330,5.030,16.241,97558,32595,64963,4.091,12.244,31853,3.998,24.487,3425,3482,17817
1993,06,526516,648762,10470280,10506870,75544,11.552,85926,13.139,1828770,583860,1244910,5.557,17.405,1909555,680406,1229149,6.476,18.174,-80785,-0.769,34.811,55753,57312,350418
1993,08,79333,94129,1398190,1364908,13097,14.183,9522,10.312,259892,84695,175197,6.205,19.041,193586,68613,124973,5.027,14.183,66306,4.858,28.366,6211,6346,33962
1993,09,68252,80364,1380843,1391054,7921,9.855,7951,9.892,198872,59430,139442,4.272,14.296,220496,64512,155984,4.638,15.851,-21624,-1.555,28.593,5213,5311,26697
1993,10,14645,17430,311621,309899,2067,11.963,1763,10.204,47337,14025,33312,4.526,15.275,44085,12351,31734,3.985,14.226,3252,1.049,28.451,1060,1078,5360
1993,11,14069,16954,387125,387267,1726,10.140,1860,10.928,53894,15904,37990,4.107,13.917,54402,17748,36654,4.583,14.048,-508,-0.131,27.833,994,1019,6230
1993,12,278063,338573,4795259,4699015,49686,14.854,41552,12.422,968974,357571,611403,7.609,20.621,776794,302677,474117,6.441,16.531,192180,4.090,33.062,29017,29821,180453
1993,13,118393,148970,2607903,2560789,19330,13.139,15633,10.626,458716,155896,302820,6.088,17.913,364901,128087,236814,5.002,14.250,93815,3.664,28.499,10228,10499,67467
1993,15,21766,27339,430047,437523,2874,10.483,3030,11.052,60134,20919,39215,4.781,13.744,74154,23794,50360,5.438,16.949,-14020,-3.204,27.488,1953,1997,11149
1993,16,22316,26248,339723,331936,3349,12.970,2495,9.663,59476,20387,39089,6.142,17.918,44088,14259,29829,4.296,13.282,15388,4.636,26.564,1626,1658,8922
1993,17,206855,251807,4621901,4591595,26263,10.496,23065,9.218,695222,214883,480339,4.680,15.141,630903,191717,439186,4.175,13.740,64319,1.401,27.481,15234,15627,92343
1993,18,97875,122595,2220514,2189751,12551,10.323,10522,8.654,330440,93284,237156,4.260,15.090,270288,80521,189767,3.677,12.343,60152,2.747,24.687,7104,7295,43220
1993,19,56187,69032,1048491,1039067,6176,8.982,5636,8.196,139371,40438,98933,3.892,13.413,120942,35000,85942,3.368,11.639,18429,1.774,23.279,3791,3860,18137
1993,20,50932,61830,910880,903479,6489,10.570,5605,9.130,130279,38321,91958,4.241,14.420,115462,34023,81439,3.766,12.780,14817,1.640,25.559,3721,3803,20723
1993,21,60784,74676,1247820,1226482,8248,11.130,7104,9.587,195744,63919,131825,5.212,15.960,153291,49396,103895,4.027,12.498,42453,3.461,24.997,4834,4946,27212
1993,22,67890,84163,1327498,1319231,9300,11.149,7800,9.351,224653,71273,153380,5.403,17.029,208387,65724,142663,4.982,15.796,16266,1.233,31.592,5305,5411,39029
1993,23,25646,30075,409144,401596,3317,11.067,3110,10.377,64938,22274,42664,5.546,16.170,50217,17210,33007,4.285,12.504,14721,3.666,25.009,2011,2066,9139
1993,24,85438,105181,1721056,1717735,12068,11.515,11319,10.800,276252,93221,183031,5.427,16.082,269288,87218,182070,5.078,15.677,6964,0.405,31.354,6882,7102,44769
1993,25,114015,137815,2599914,2576761,14000,10.183,13351,9.710,406208,122350,283858,4.748,15.764,359444,115178,244266,4.470,13.949,46764,1.815,27.899,8653,9009,54998
1993,26,156406,193281,3391030,3349072,19979,10.406,17398,9.062,523900,162840,361060,4.862,15.643,441203,142126,299077,4.244,13.174,82697,2.469,26.348,11627,12049,67694
1993,27,86777,105502,1899329,1868758,11316,10.857,8763,8.408,289570,91864,197706,4.916,15.495,227855,72675,155180,3.889,12.193,61715,3.302,24.386,5736,5963,36413
1993,28,41019,50065,780952,765507,5826,11.761,4765,9.620,131646,46373,85273,6.058,17.197,100944,38235,62709,4.995,13.187,30702,4.011,26.373,3354,3394,23359
1993,29,98688,120622,2008743,1993971,13414,11.202,11670,9.745,296511,93431,203080,4.686,14.870,267436,84573,182863,4.241,13.412,29075,1.458,26.824,7859,8038,46974
1993,30,20503,23800,242703,239549,2704,11.462,2284,9.682,41060,12783,28277,5.336,17.141,34620,10926,23694,4.561,14.452,6440,2.688,28.904,1567,1587,7086
1993,31,34404,41185,612025,603178,3925,9.574,3545,8.647,85357,24782,60575,4.109,14.151,67418,20441,46977,3.389,11.177,17939,2.974,22.354,2404,2480,11762
1993,32,25179,29777,563330,552986,4400,14.937,3759,12.761,100438,35419,65019,6.405,18.163,79752,29677,50075,5.367,14.422,20686,3.741,28.844,2391,2432,16586
1993,33,24862,29226,433163,427313,3288,11.290,3081,10.579,67403,21282,46121,4.980,15.774,55657,17980,37677,4.208,13.025,11746,2.749,26.050,2070,2127,9659
1993,34,161480,188176,3084196,3065815,21020,11.230,19012,10.158,510546,155122,355424,5.060,16.653,475982,148640,327342,4.848,15.525,34564,1.127,31.051,12707,12988,70251
1993,35,28868,34371,456832,449115,4300,12.658,3500,10.303,82992,26530,56462,5.907,18.479,67974,23129,44845,5.150,15.135,15018,3.344,30.270,2306,2349,11978
1993,36,344754,402228,6522987,6542391,44492,11.062,44433,11.048,982654,321693,660961,4.917,15.020,1021451,328086,693365,5.015,15.613,-38797,-0.593,30.040,31294,31909,175681
1993,37,123395,155074,2713759,2680880,16921,11.001,14388,9.355,407304,123108,284196,4.592,15.193,341372,107823,233549,4.022,12.734,65932,2.459,25.467,9557,9773,57507
1993,38,14866,17590,214547,211087,1667,9.546,1412,8.086,31093,9135,21958,4.328,14.730,24241,7734,16507,3.664,11.484,6852,3.246,22.968,958,970,4381
1993,39,180138,230167,4197169,4163681,22097,9.640,20208,8.816,604206,186250,417956,4.473,14.511,537255,166638,370617,4.002,12.903,66951,1.608,25.807,12770,13275,79476
1993,40,58420,70711,972583,965497,8140,11.607,6974,9.945,156609,52340,104269,5.421,16.221,142598,48716,93882,5.046,14.769,14011,1.451,29.539,4716,4801,27756
1993,41,64346,76582,1053535,1041392,9221,12.149,7852,10.346,177869,54019,123850,5.187,17.080,152882,48878,104004,4.694,14.681,24987,2.399,29.361,5109,5193,23967
1993,42,205935,254875,4510752,4495525,22692,8.899,22915,8.987,625169,192442,432727,4.281,13.906,594943,175676,419267,3.908,13.234,30226,0.672,26.468,15282,15708,92440
1993,44,21140,23814,366825,362606,2604,11.014,2263,9.571,54586,17177,37409,4.737,15.054,46335,15585,30750,4.298,12.778,8251,2.275,25.557,1536,1569,8373
1993,45,60934,75899,1305202,1292040,8817,11.719,7490,9.955,193130,60957,132173,4.718,14.948,167341,57048,110293,4.415,12.952,25789,1.996,25.903,5005,5114,26076
1993,46,16576,19220,248553,244516,1936,10.155,1624,8.519,38277,10998,27279,4.498,15.654,30575,8810,21765,3.603,12.504,7702,3.150,25.009,1086,1112,5385
1993,47,85592,107585,1954147,1927194,12444,11.688,10205,9.585,315828,101697,214131,5.277,16.388,261503,80318,181185,4.168,13.569,54325,2.819,27.138,6699,6929,42429
1993,48,293615,375423,6194489,6098747,47682,12.813,41100,11.044,1198587,403416,795171,6.615,19.653,1007494,366326,641168,6.007,16.520,191093,3.133,33.039,26695,27616,182928
1993,49,29853,36016,651637,634381,4873,13.767,3635,10.269,116992,37109,79883,5.850,18.442,82065,32185,49880,5.073,12.936,34927,5.506,25.872,2416,2523,19133
1993,50,15573,17628,212949,209058,1951,11.169,1631,9.337,34617,13498,21119,6.457,16.559,27101,10912,16189,5.220,12.963,7516,3.595,25.927,1166,1192,4920
1993,51,109647,139550,2310930,2286948,15771,11.393,13523,9.769,367967,124310,243657,5.436,16.090,320771,103509,217262,4.526,14.026,47196,2.064,28.052,8580,8860,47994
1993,53,105820,126709,1815442,1804304,16515,13.185,13611,10.866,304943,98012,206931,5.432,16.901,283001,95430,187571,5.289,15.685,21942,1.216,31.370,8817,9082,46073
1993,54,29085,35301,495176,489424,3627,10.342,3169,9.036,76520,23155,53365,4.731,15.635,64976,21007,43969,4.292,13.276,11544,2.359,26.552,2109,2147,11143
1993,55,95730,115989,2043138,2012694,11413,9.933,9226,8.030,287813,81199,206614,4.034,14.300,227489,72096,155393,3.582,11.303,60324,2.997,22.605,6274,6454,36664
1993,56,12003,13951,141474,140114,1842,13.467,1295,9.468,25203,10035,15168,7.162,17.988,22436,7148,15288,5.102,16.013,2767,1.975,32.025,841,859,4058
1994,01,68231,84980,1451927,1437452,10379,12.372,8195,9.769,222605,81134,141471,5.644,15.486,194508,61627,132881,4.287,13.531,28097,1.955,27.063,5706,5846,35956
1994,02,11654,13980,172944,170370,1839,13.339,1453,10.539,33031,11976,21055,7.029,19.388,28000,8396,19604,4.928,16.435,5031,2.953,32.870,918,939,4254
1994,04,69730,86078,1414213,1368244,12882,15.291,9216,10.940,298389,114758,183631,8.387,21.808,205427,79378,126049,5.801,15.014,92962,6.794,30.028,6421,6582,41806
1994,05,44147,52802,838239,826228,6593,12.667,5086,9.772,133767,52295,81472,6.329,16.190,109397,40729,68668,4.930,13.241,24370,2.950,26.481,3661,3739,23806
1994,06,526819,649454,10430102,10440467,80736,12.430,80912,12.457,1804868,691016,1113852,6.619,17.287,1826191,660206,1165985,6.324,17.491,-21323,-0.204,34.574,53753,55521,359527
1994,08,83398,99024,1462649,1432108,14450,14.953,9679,10.016,266926,99280,167646,6.932,18.639,206499,74716,131783,5.217,14.419,60427,4.219,28.838,6852,6981,41880
1994,09,68660,81059,1372334,1376850,8170,10.116,7584,9.390,191119,60631,130488,4.404,13.881,200541,58978,141563,4.284,14.565,-9422,-0.684,27.762,5297,5402,31025
1994,10,14985,17891,313389,313308,2264,12.820,1803,10.209,49048,18249,30799,5.825,15.655,48595,13854,34741,4.422,15.510,453,0.145,31.021,1143,1152,6092
1994,11,14238,17185,392462,389081,1830,10.715,1617,9.468,53687,19251,34436,4.948,13.798,46527,14965,31562,3.846,11.958,7160,1.840,23.916,1054,1086,6796
1994,12,284818,347258,4987770,4898925,50327,14.669,41997,12.241,945428,359968,585460,7.348,19.299,765735,294115,471620,6.004,15.631,179693,3.668,31.261,30940,31600,187808
1994,13,122135,153868,2719642,2666747,20696,13.658,16018,10.571,478156,180242,297914,6.759,17.930,372194,142706,229488,5.351,13.957,105962,3.973,27.914,10983,11215,75098
1994,15,21785,27409,426712,429018,2829,10.327,2802,10.228,62445,27960,34485,6.517,14.555,67619,23301,44318,5.431,15.761,-5174,-1.206,29.111,1934,2010,15124
1994,16,23625,27744,362605,351767,3920,14.503,2488,9.205,67030,22709,44321,6.456,19.055,45385,14832,30553,4.216,12.902,21645,6.153,25.804,1712,1747,9813
1994,17,210450,256680,4747789,4692616,27608,10.852,23045,9.059,707629,233241,474388,4.970,15.080,596499,201619,394880,4.297,12.711,111130,2.368,25.423,15905,16243,103466
1994,18,100067,125589,2281658,2257548,13351,10.752,10506,8.461,330444,105209,225235,4.660,14.637,282104,92599,189505,4.102,12.496,48340,2.141,24.992,7355,7629,48726
1994,19,56953,70181,1074690,1064237,6685,9.596,5650,8.110,144222,45414,98808,4.267,13.552,123627,41239,82388,3.875,11.616,20595,1.935,23.233,4010,4119,22214
1994,20,52035,63187,942187,927332,7069,11.301,5799,9.271,143944,49344,94600,5.321,15.522,114546,38616,75930,4.164,12.352,29398,3.170,24.704,4047,4203,22766
1994,21,61851,76178,1282945,1267481,8255,10.934,6896,9.134,190187,64821,125366,5.114,15.005,159138,49868,109270,3.934,12.555,31049,2.450,25.111,4889,4987,30525
1994,22,69419,86213,1375463,1352347,10056,11.798,8102,9.505,234843,83557,151286,6.179,17.366,188452,57640,130812,4.262,13.935,46391,3.430,27.870,5644,5860,35540
1994,23,26071,30648,420032,415099,3517,11.580,2962,9.753,62820,20531,42289,4.946,15.134,53452,18332,35120,4.416,12.877,9368,2.257,25.754,2108,2148,12003
1994,24,86908,106929,1745265,1736246,12240,11.534,10621,10.009,277467,94774,182693,5.459,15.981,259568,87064,172504,5.014,14.950,17899,1.031,29.900,7086,7285,45335
1994,25,115923,140396,2635177,2625687,15022,10.793,12606,9.057,391899,126022,265877,4.800,14.926,372161,114914,257247,4.377,14.174,19738,0.752,28.348,8537,8715,59108
1994,26,159531,197423,3502255,3454811,21051,10.768,17198,8.797,529819,176696,353123,5.114,15.336,436568,152260,284308,4.407,12.637,93251,2.699,25.273,12077,12470,75030
1994,27,89187,108743,1968672,1941389,11926,11.123,8874,8.277,282566,91820,190746,4.730,14.555,227995,73199,154796,3.770,11.744,54571,2.811,23.488,6139,6296,41293
1994,28,41664,50953,825299,804953,5992,11.851,5205,10.295,143281,53503,89778,6.647,17.800,101944,32895,69049,4.087,12.665,41337,5.135,25.329,3793,3877,19775
1994,29,100781,123423,2067874,2041484,14693,12.032,12088,9.898,319329,106665,212664,5.225,15.642,266735,92950,173785,4.553,13.066,52594,2.576,26.131,8531,8744,50503
1994,30,21224,24616,249203,246271,2990,12.337,2230,9.201,40585,15339,25246,6.229,16.480,34613,10912,23701,4.431,14.055,5972,2.425,28.110,1589,1609,7168
1994,31,34966,42004,632142,623222,4265,10.243,3530,8.478,89782,31242,58540,5.013,14.406,72014,25244,46770,4.051,11.555,17768,2.851,23.110,2514,2560,13331
1994,32,26628,31548,624313,598202,5147,16.777,3410,11.115,133445,45705,87740,7.640,22.308,80071,32547,47524,5.441,13.385,53374,8.922,26.771,2384,2429,21546
1994,33,25480,29999,454322,445079,3625,12.229,2910,9.817,72546,23733,48813,5.332,16.300,54225,18846,35379,4.234,12.183,18321,4.116,24.366,1984,2012,10797
1994,34,163338,190789,3098218,3095145,21576,11.380,19183,10.118,463052,156713,306339,5.063,14.961,456994,152061,304933,4.913,14.765,6058,0.196,29.530,13144,13381,76295
1994,35,29811,35586,480511,470510,4763,13.607,3600,10.284,88190,30858,57332,6.558,18.743,68184,23698,44486,5.037,14.492,20006,4.252,28.983,2515,2553,13941
1994,36,345384,404365,6564306,6554935,45385,11.248,43640,10.816,965447,337718,627729,5.152,14.729,947412,314614,632798,4.800,14.453,18035,0.275,28.907,31310,31841,179941
1994,37,126986,159635,2836323,2782668,18427,11.701,14128,8.971,431169,144660,286509,5.199,15.495,324279,105412,218867,3.788,11.654,106890,3.841,23.307,9750,9987,58378
1994,38,15136,17925,222532,218991,1680,9.455,1368,7.699,31862,10167,21695,4.643,14.549,24794,7301,17493,3.334,11.322,7068,3.228,22.644,986,1002,4432
1994,39,183266,234396,4328094,4272684,23464,10.091,19698,8.472,628103,207643,420460,4.860,14.700,517544,160795,356749,3.763,12.113,110559,2.588,24.226,13065,13467,77538
1994,40,59651,72306,1000243,987922,8607,12.033,7048,9.854,158399,55711,102688,5.639,16.034,134064,45516,88548,4.607,13.570,24335,2.463,27.141,5040,5115,26057
1994,41,67194,80110,1115128,1087046,10845,13.833,7420,9.465,196392,71272,125120,6.556,18.067,140002,47735,92267,4.391,12.879,56390,5.187,25.758,5187,5291,27697
1994,42,205825,255948,4537695,4531957,23507,9.198,22723,8.892,619021,205818,413203,4.541,13.659,607299,203803,403496,4.497,13.400,11722,0.259,26.801,15432,15782,105864
1994,44,21472,24181,370565,369448,2692,11.212,2348,9.780,56507,23914,32593,6.473,15.295,53978,19139,34839,5.180,14.610,2529,0.685,29.221,1667,1702,9693
1994,45,62292,77656,1347876,1326895,9212,11.992,7541,9.816,210185,78272,131913,5.899,15.840,168748,56660,112088,4.270,12.718,41437,3.123,25.435,5185,5312,33583
1994,46,17074,19855,258878,253962,2187,11.184,1586,8.111,38956,13600,25356,5.355,15.339,29269,9505,19764,3.743,11.525,9687,3.814,23.050,1136,1157,5843
1994,47,87670,110399,2017555,1987402,12869,11.800,10190,9.344,319059,119761,199298,6.026,16.054,259326,96185,163141,4.840,13.048,59733,3.006,26.097,7046,7197,46450
1994,48,301635,385920,6363258,6295933,50534,13.266,40580,10.653,1124376,415622,708754,6.601,17.859,989923,339098,650825,5.386,15.723,134453,2.136,31.446,27861,28687,186047
1994,49,31489,38052,693006,672989,5652,15.249,3677,9.921,126035,44171,81864,6.563,18.728,86358,31927,54431,4.744,12.832,39677,5.896,25.664,2631,2707,20350
1994,50,15808,17896,214486,214273,1820,10.241,1573,8.851,29481,9445,20036,4.408,13.759,28797,8944,19853,4.174,13.439,684,0.319,26.879,1117,1135,4949
1994,51,112381,142842,2379602,2349989,16359,11.578,13268,9.390,368014,128319,239695,5.460,15.660,309273,100814,208459,4.290,13.161,58741,2.500,26.321,8781,9003,49494
1994,53,109113,130687,1879940,1862538,17403,13.513,13595,10.557,305132,108476,196656,5.824,16.383,270957,80156,190801,4.304,14.548,34175,1.835,29.095,9360,9555,46301
1994,54,29621,36064,507556,503028,3776,10.573,3072,8.602,72583,24828,47755,4.936,14.429,63763,19473,44290,3.871,12.676,8820,1.753,25.352,2166,2184,10531
1994,55,97365,118327,2099463,2077074,11642,9.928,9523,8.121,273817,87150,186667,4.196,13.183,228972,68620,160352,3.304,11.024,44845,2.159,22.048,6658,6832,38341
1994,56,12523,14570,150457,146379,1836,12.858,1255,8.789,27492,10881,16611,7.433,18.781,19260,5713,13547,3.903,13.158,8232,5.624,26.315,839,856,3571
1995,01,70159,87429,1519027,1483043,10569,12.261,8115,9.414,247715,84774,162941,5.716,16.703,175591,57483,118108,3.876,11.840,72124,4.863,23.680,5762,5901,35626
1995,02,12047,14397,175916,174222,1892,13.333,1478,10.416,30026,10138,19888,5.819,17.234,26619,8114,18505,4.657,15.279,3407,1.956,30.558,974,1002,4523
1995,04,72416,89387,1499122,1456329,13028,14.851,9705,11.063,292650,112887,179763,7.751,20.095,206413,79474,126939,5.457,14.174,86237,5.922,28.347,6651,6843,48933
1995,05,45373,54407,882018,859559,6741,12.576,5130,9.571,145969,48613,97356,5.656,16.982,100881,39862,61019,4.637,11.736,45088,5.245,23.473,3743,3794,22686
1995,06,531694,655916,10711714,10568352,82283,12.608,75695,11.599,1850945,646668,1204277,6.119,17.514,1566617,549089,1017528,5.196,14.824,284328,2.690,29.647,51373,53005,315432
1995,08,87259,103654,1545102,1502242,14986,14.790,10326,10.191,297339,112495,184844,7.488,19.793,211164,74118,137046,4.934,14.057,86175,5.736,28.113,7241,7348,44253
1995,09,69666,82265,1394058,1381848,8619,10.557,7381,9.040,200399,75960,124439,5.497,14.502,176091,54885,121206,3.972,12.743,24308,1.759,25.486,5026,5221,27364
1995,10,15449,18464,329470,321167,2358,12.971,1788,9.836,55686,17913,37773,5.577,17.339,38857,13686,25171,4.261,12.099,16829,5.240,24.197,1173,1197,6725
1995,11,14353,17381,394794,393641,1846,10.681,1649,9.541,54672,16475,38197,4.185,13.889,53173,15188,37985,3.858,13.508,1499,0.381,27.016,1042,1067,6775
1995,12,290633,354961,5198624,5088941,50266,14.317,42520,12.111,1009817,416419,593398,8.183,19.843,788212,304286,483926,5.979,15.489,221605,4.355,30.977,31258,32102,202161
1995,13,126327,159544,2886011,2804402,21643,13.812,15959,10.184,532585,201501,331084,7.185,18.991,369147,137289,231858,4.895,13.163,163438,5.828,26.326,11022,11295,71985
1995,15,21888,27600,420914,422501,2883,10.484,2681,9.749,54429,21490,32939,5.086,12.883,57790,18261,39529,4.322,13.678,-3361,-0.796,25.765,1847,1891,8716
1995,16,24626,28832,374777,368523,3848,13.606,2748,9.716,64155,21788,42367,5.912,17.409,51615,19840,31775,5.384,14.006,12540,3.403,28.012,1917,1935,8750
1995,17,214592,262092,4896499,4817747,28782,11.098,23303,8.985,750858,261147,489711,5.421,15.585,592796,194458,398338,4.036,12.304,158062,3.281,24.609,15775,16164,101679
1995,18,102289,128798,2374083,2327158,14233,11.191,11007,8.654,358539,122463,236076,5.262,15.407,264751,87231,177520,3.748,11.377,93788,4.030,22.753,7739,7990,47421
1995,19,57726,71316,1117264,1095838,6927,9.791,5788,8.181,156641,49011,107630,4.472,14.294,114290,39893,74397,3.640,10.429,42351,3.865,20.859,4086,4197,24065
1995,20,52903,64427,972767,957552,6994,10.963,5733,8.986,140403,49748,90655,5.195,14.663,109860,36376,73484,3.799,11.473,30543,3.190,22.946,4078,4170,21887
1995,21,63135,77986,1342340,1312417,8715,11.307,6899,8.951,213068,72505,140563,5.525,16.235,152353,52792,99561,4.023,11.609,60715,4.626,23.217,4891,4992,29658
1995,22,70699,87862,1413816,1393081,9835,11.301,8174,9.392,242128,89834,152294,6.449,17.381,200178,73131,127047,5.250,14.369,41950,3.011,28.739,5681,5910,40907
1995,23,26712,31325,432029,425989,3650,11.779,2973,9.595,62474,20433,42041,4.797,14.666,49804,15925,33879,3.738,11.691,12670,2.974,23.383,2059,2102,10026
1995,24,89021,109440,1805361,1773572,13051,12.065,10522,9.727,291907,98631,193276,5.561,16.459,227850,82322,145528,4.642,12.847,64057,3.612,25.694,7161,7370,43997
1995,25,118400,143579,2705389,2668447,16049,11.304,12836,9.041,408559,133909,274650,5.018,15.311,333978,113084,220894,4.238,12.516,74581,2.795,25.032,8560,9001,63016
1995,26,163523,202361,3664765,3581498,22401,11.207,17445,8.728,589557,198356,391201,5.538,16.461,424854,141222,283632,3.943,11.862,164703,4.599,23.725,12093,12398,77506
1995,27,91266,111266,2043855,2005490,11830,10.755,9289,8.445,294706,98366,196340,4.905,14.695,217586,68659,148927,3.424,10.850,77120,3.845,21.699,6340,6530,39469
1995,28,42491,52052,857710,839838,6098,11.841,4988,9.686,142439,52943,89496,6.304,16.960,106744,37174,69570,4.426,12.710,35695,4.250,25.420,3594,3698,21994
1995,29,102729,125931,2135300,2100344,14734,11.819,12207,9.792,337373,109250,228123,5.202,16.063,268080,92077,176003,4.384,12.764,69293,3.299,25.527,8638,8859,50170
1995,30,21916,25427,259733,253935,3171,12.680,2333,9.329,42865,16473,26392,6.487,16.880,31284,11142,20142,4.388,12.320,11581,4.561,24.639,1660,1681,7595
1995,31,35363,42624,658679,644867,4103,9.697,3479,8.222,93611,29194,64417,4.527,14.516,66156,21165,44991,3.282,10.259,27455,4.257,20.518,2512,2565,12694
1995,32,28121,33329,662464,641138,5395,16.634,3603,11.109,123301,50551,72750,7.885,19.232,81101,26210,54891,4.088,12.650,42200,6.582,25.299,2586,2635,19101
1995,33,26319,30989,472968,462665,3788,12.424,2788,9.144,74259,27190,47069,5.877,16.050,53720,19247,34473,4.160,11.611,20539,4.439,23.222,1947,2036,11754
1995,34,167667,195640,3179599,3135771,23333,12.077,18455,9.552,499627,172151,327476,5.490,15.933,410870,142103,268767,4.532,13.103,88757,2.830,26.205,12936,13198,77479
1995,35,30612,36572,502760,490775,4771,13.226,3774,10.462,89701,33266,56435,6.778,18.277,65303,24633,40670,5.019,13.306,24398,4.971,26.612,2665,2720,15218
1995,36,350048,409923,6630656,6592699,47217,11.599,41559,10.209,975631,340615,635016,5.167,14.799,898099,279708,618391,4.243,13.623,77532,1.176,27.245,29942,30519,165349
1995,37,131437,165192,2958913,2896612,19484,11.998,13896,8.557,448642,147060,301582,5.077,15.489,322488,104178,218310,3.597,11.133,126154,4.355,22.267,9698,9966,57216
1995,38,15383,18195,231344,226397,1655,9.164,1383,7.658,35095,10999,24096,4.858,15.502,25319,9227,16092,4.076,11.183,9776,4.318,22.367,969,981,5140
1995,39,187000,239295,4495316,4409002,24677,10.420,19742,8.336,668438,221337,447101,5.020,15.161,497230,157656,339574,3.576,11.278,171208,3.883,22.555,13254,13702,84533
1995,40,60646,73599,1027960,1013947,8467,11.607,7166,9.823,160698,55518,105180,5.475,15.849,132645,46968,85677,4.632,13.082,28053,2.767,26.164,5237,5365,28764
1995,41,69310,82706,1170775,1142274,10829,13.303,8223,10.102,203130,71003,132127,6.216,17.783,146812,51634,95178,4.520,12.853,56318,4.930,25.705,5785,5934,32654
1995,42,208905,259996,4653793,4595617,25470,9.874,21397,8.295,650945,220389,430556,4.796,14.164,534866,188116,346750,4.093,11.639,116079,2.526,23.277,14563,15083,103950
1995,44,21692,24474,371712,367728,2618,10.765,2311,9.502,53322,17598,35724,4.786,14.500,45362,14694,30668,3.996,12.336,7960,2.165,24.672,1617,1638,7650
1995,45,64077,79928,1398208,1373273,9915,12.585,7626,9.680,217624,79690,137934,5.803,15.847,166414,58745,107669,4.278,12.118,51210,3.729,24.236,5383,5555,34897
1995,46,17420,20293,271071,264950,2066,10.292,1627,8.105,38788,11768,27020,4.442,14.640,26588,9706,16882,3.663,10.035,12200,4.605,20.070,1163,1185,5456
1995,47,90080,113562,2124175,2068510,13574,12.122,10402,9.289,352209,121273,230936,5.863,17.027,239799,78789,161010,3.809,11.593,112410,5.434,23.186,7170,7373,44791
1995,48,308739,395524,6664036,6510615,51352,13.144,41664,10.664,1236155,456526,779629,7.012,18.987,930612,331453,599159,5.091,14.294,305543,4.693,28.588,28723,29705,189859
1995,49,33084,39969,737153,714701,5875,15.062,3949,10.124,136871,51029,85842,7.140,19.151,91766,30566,61200,4.277,12.840,45105,6.311,25.680,2801,2873,19529
1995,50,16101,18237,218138,216440,1882,10.415,1548,8.567,31212,10253,20959,4.737,14.421,27604,10471,17133,4.838,12.754,3608,1.667,25.507,1122,1132,6414
1995,51,115807,146925,2471499,2427362,17451,12.045,13373,9.230,397016,140855,256161,5.803,16.356,307908,107991,199917,4.449,12.685,89108,3.671,25.370,9036,9307,53083
1995,53,111352,133509,1933170,1905979,17567,13.299,14732,11.153,314906,116061,198845,6.089,16.522,260925,91523,169402,4.802,13.690,53981,2.832,27.380,10155,10365,55043
1995,54,30307,36899,527342,518165,3996,10.955,3152,8.641,81017,27058,53959,5.222,15.635,62416,20854,41562,4.025,12.046,18601,3.590,24.091,2176,2201,11246
1995,55,99129,120632,2181307,2139193,11922,9.979,9604,8.039,298725,96084,202641,4.492,13.964,215181,64067,151114,2.995,10.059,83544,3.905,20.118,6816,7023,37874
1995,56,12900,14962,152925,157215,1777,12.034,1385,9.380,24707,9008,15699,5.730,15.715,32598,7076,25522,4.501,20.735,-7891,-5.019,31.431,948,960,4319
1996,01,71082,89030,1525906,1517465,10555,11.985,8637,9.807,230584,81623,148961,5.379,15.195,213373,71437,141936,4.708,14.061,17211,1.134,28.122,6276,6392,40604
1996,02,12229,14601,177460,176192,1831,12.666,1540,10.653,29542,8596,20946,4.879,16.767,27261,10017,17244,5.685,15.472,2281,1.295,30.945,1008,1028,5390
1996,04,74304,92105,1569033,1528447,13160,14.535,10031,11.079,295001,110787,184214,7.248,19.301,213029,77978,135051,5.102,13.938,81972,5.363,27.875,6974,7158,49175
1996,05,45750,55076,891118,883956,6453,11.811,5571,10.197,129695,44423,85272,5.025,14.672,115088,35030,80058,3.963,13.020,14607,1.652,26.039,4068,4181,23114
1996,06,536928,662674,10856228,10749565,83649,12.718,73770,11.216,1893908,664630,1229278,6.183,17.618,1679822,587245,1092577,5.463,15.627,214086,1.992,31.254,50470,52025,332282
1996,08,89464,106351,1577910,1556428,14724,14.051,11597,11.067,296387,119674,176713,7.689,19.043,254360,98662,155698,6.339,16.343,42027,2.700,32.685,7990,8126,49117
1996,09,69452,82353,1397257,1392295,8071,9.827,7629,9.289,198901,76301,122600,5.480,14.286,189684,61434,128250,4.412,13.624,9217,0.662,27.248,5181,5359,32146
1996,10,15643,18692,331548,329402,2186,11.807,1830,9.884,48389,18317,30072,5.561,14.690,44207,13610,30597,4.132,13.420,4182,1.270,26.841,1205,1241,6909
1996,11,14345,17412,366517,376796,1813,10.447,1698,9.784,46938,16280,30658,4.321,12.457,66253,14797,51456,3.927,17.583,-19315,-5.126,24.914,1078,1109,7228
1996,12,294490,360361,5305921,5238547,50052,14.019,43395,12.154,1014654,410858,603796,7.843,19.369,882041,333736,548305,6.371,16.838,132613,2.531,33.675,31597,32286,202627
1996,13,129596,163927,2960544,2916164,22325,13.830,17311,10.724,522281,202371,319910,6.940,17.910,434551,157200,277351,5.391,14.901,87730,3.008,29.803,11916,12175,79753
1996,15,21709,27343,414392,415551,2805,10.234,2935,10.709,60571,27515,33056,6.621,14.576,62861,20579,42282,4.952,15.127,-2290,-0.551,29.152,1905,2011,10539
1996,16,25298,29624,383773,377617,3983,13.654,3077,10.548,69987,24603,45384,6.515,18.534,58054,21086,36968,5.584,15.374,11933,3.160,30.748,2139,2164,11774
1996,17,215936,264663,4891674,4868346,28428,10.817,24737,9.412,707329,243649,463680,5.005,14.529,661918,194641,467277,3.998,13.596,45411,0.933,27.193,17027,17467,101523
1996,18,103016,130288,2378534,2369077,13679,10.576,11773,9.103,343033,129661,213372,5.473,14.480,323578,100546,223032,4.244,13.658,19455,0.821,27.317,8194,8435,54239
1996,19,57907,71837,1139267,1124725,6706,9.388,5902,8.262,153882,53103,100779,4.721,13.682,124462,36142,88320,3.213,11.066,29420,2.616,22.132,4195,4276,22663
1996,20,53239,65083,992559,977708,6932,10.731,5961,9.228,150271,54457,95814,5.570,15.370,120790,41377,79413,4.232,12.354,29481,3.015,24.709,4269,4377,25520
1996,21,63505,78941,1346892,1340676,8625,11.013,7371,9.412,196689,75113,121576,5.603,14.671,184174,58633,125541,4.373,13.737,12515,0.933,27.475,5240,5360,33383
1996,22,71731,89280,1441531,1422452,9704,10.975,7989,9.035,233800,78113,155687,5.491,16.436,195391,61488,133903,4.323,13.736,38409,2.700,27.472,5684,5809,36712
1996,23,27114,31812,432604,430921,3702,11.749,3095,9.823,59108,22080,37028,5.124,13.717,55767,18836,36931,4.371,12.941,3341,0.775,25.883,2157,2179,11055
1996,24,89435,110196,1799643,1794155,12309,11.234,11055,10.090,275735,103808,171927,5.786,15.369,266467,87472,178995,4.875,14.852,9268,0.517,29.704,7463,7638,48313
1996,25,119184,144835,2711953,2692912,15146,10.528,13195,9.172,384361,124922,259439,4.639,14.273,346500,126407,220093,4.694,12.867,37861,1.406,25.734,8753,9059,66854
1996,26,165380,205424,3659426,3642429,21910,10.771,17898,8.799,517299,177578,339721,4.875,14.202,485472,139378,346094,3.827,13.328,31827,0.874,26.657,12713,13055,83702
1996,27,92808,113281,2080302,2053471,12037,10.746,9497,8.479,294687,99659,195028,4.853,14.351,240578,73676,166902,3.588,11.716,54109,2.635,23.431,6591,6763,46371
1996,28,42915,52810,855095,852224,6118,11.687,5197,9.928,130122,54106,76016,6.349,15.269,123798,42281,81517,4.961,14.526,6324,0.742,29.053,3790,3855,24536
1996,29,103408,127426,2144813,2126296,14273,11.293,12208,9.659,324291,116293,207998,5.469,15.251,287192,90866,196326,4.273,13.507,37099,1.745,27.013,8889,9040,50193
1996,30,22422,25871,262744,260347,3127,12.215,2585,10.098,41158,15510,25648,5.957,15.809,36254,13450,22804,5.166,13.925,4904,1.884,27.851,1727,1750,8395
1996,31,35496,42886,673843,664485,4166,9.764,3729,8.740,93609,31726,61883,4.775,14.087,74783,23457,51326,3.530,11.254,18826,2.833,22.509,2649,2709,13898
1996,32,29041,34629,697910,676945,5498,16.216,4048,11.940,140857,60407,80450,8.923,20.808,99251,38332,60919,5.662,14.662,41606,6.146,29.323,2834,2886,22922
1996,33,26896,31685,478396,471600,3761,12.025,2946,9.419,70730,23061,47669,4.890,14.998,57125,18883,38242,4.004,12.113,13605,2.885,24.226,2013,2087,11598
1996,34,169050,197576,3170509,3156666,22726,11.581,20041,10.213,498564,178953,319611,5.669,15.794,472441,156352,316089,4.953,14.966,26123,0.828,29.933,14085,14306,80666
1996,35,30992,37199,505812,499946,4670,12.688,3887,10.560,89102,32580,56522,6.517,17.822,77199,28137,49062,5.628,15.441,11903,2.381,30.883,2695,2737,15608
1996,36,351154,411568,6602858,6591514,46603,11.366,43541,10.619,957086,348695,608391,5.290,14.520,934327,316121,618206,4.796,14.175,22759,0.345,28.349,31583,32267,188383
1996,37,134425,169319,3014949,2977623,20030,11.998,15274,9.149,455183,174266,280917,5.853,15.287,379781,121620,258161,4.084,12.755,75402,2.532,25.509,10379,10635,60916
1996,38,15447,18279,232209,230688,1623,8.915,1474,8.097,32290,10064,22226,4.363,13.997,29194,8657,20537,3.753,12.655,3096,1.342,25.310,1015,1036,5052
1996,39,187608,241026,4527323,4495411,23627,9.860,20828,8.692,641514,218905,422609,4.870,14.270,576562,177511,399051,3.949,12.826,64952,1.445,25.651,14061,14469,92616
1996,40,61092,74470,1053714,1037251,8630,11.681,7456,10.092,169942,67315,102627,6.490,16.384,137366,47657,89709,4.595,13.243,32576,3.141,26.487,5438,5547,30448
1996,41,70656,84546,1213684,1187517,10681,12.798,8500,10.185,207238,70003,137235,5.895,17.451,155387,51827,103560,4.364,13.085,51851,4.366,26.170,6065,6193,34016
1996,42,208538,261075,4643323,4622820,24636,9.475,22481,8.647,622654,221755,400899,4.797,13.469,583475,188433,395042,4.076,12.622,39179,0.848,25.243,15603,16036,102262
1996,44,21763,24593,369299,369225,2587,10.563,2381,9.722,48294,15973,32321,4.326,13.080,48437,15788,32649,4.276,13.119,-143,-0.039,26.160,1687,1697,8861
1996,45,65202,81652,1418039,1404813,10101,12.525,8088,10.029,216341,81766,134575,5.820,15.400,189276,59595,129681,4.242,13.473,27065,1.927,26.947,5647,5805,34846
1996,46,17571,20530,275312,272183,2141,10.514,1806,8.869,39242,15437,23805,5.672,14.418,32948,10741,22207,3.946,12.105,6294,2.312,24.210,1305,1339,6574
1996,47,91263,115848,2151737,2133888,13766,12.022,11076,9.673,329085,127203,201882,5.961,15.422,293417,98194,195223,4.602,13.750,35668,1.672,27.501,7900,8051,54841
1996,48,313528,402415,6813702,6713340,51706,12.987,43159,10.840,1231324,481780,749544,7.176,18.341,1030049,353454,676595,5.265,15.343,201275,2.998,30.687,29863,30870,203578
1996,49,34594,41747,771122,751760,6192,15.182,4270,10.469,140469,55841,84628,7.428,18.685,101665,33607,68058,4.470,13.524,38804,5.162,27.047,3036,3110,22201
1996,50,16148,18360,222990,219853,1889,10.340,1705,9.333,33355,13629,19726,6.199,15.172,27243,10398,16845,4.730,12.391,6112,2.780,24.783,1246,1267,6563
1996,51,116782,148775,2500866,2479956,16944,11.482,14526,9.844,392600,144362,248238,5.821,15.831,351967,112468,239499,4.535,14.192,40633,1.638,28.385,9862,10162,56021
1996,53,112845,136142,1952308,1931993,18235,13.554,15032,11.173,312847,119013,193834,6.160,16.193,271485,87422,184063,4.525,14.052,41362,2.141,28.104,10534,10773,58056
1996,54,30319,37132,522328,524367,3865,10.459,3511,9.501,74681,28656,46025,5.465,14.242,78815,23562,55253,4.493,15.031,-4134,-0.788,28.484,2426,2460,12978
1996,55,99776,121878,2193837,2177373,11688,9.661,9907,8.188,271652,87264,184388,4.008,12.476,238403,67800,170603,3.114,10.949,33249,1.527,21.898,7053,7201,38509
1996,56,13118,15207,151933,151798,1822,12.106,1509,10.026,22828,8254,14574,5.438,15.038,22700,6870,15830,4.526,14.954,128,0.084,29.908,1060,1091,4545
1997,01,71680,90195,1555639,1542627,10799,12.049,9655,10.773,266672,98562,168110,6.389,17.287,240801,87133,153668,5.648,15.610,25871,1.677,31.220,6666,6805,47082
1997,02,12422,14820,184554,181040,1889,12.856,1635,11.128,36346,10221,26125,5.646,20.076,29431,8939,20492,4.938,16.257,6915,3.820,32.513,1044,1056,4758
1997,04,76464,95154,1672652,1626768,14433,15.413,11411,12.186,366925,138807,228118,8.533,22.555,276056,113280,162776,6.964,16.970,90869,5.586,33.939,7466,7639,52127
1997,05,46011,55575,907096,900100,6685,12.083,6188,11.185,145134,51702,93432,5.744,16.124,131274,48957,82317,5.439,14.584,13860,1.540,29.169,4322,4422,25001
1997,06,542671,667765,11268960,11081616,86830,13.051,81965,12.319,2223976,782212,1441764,7.059,20.069,1845336,723729,1121607,6.531,16.652,378640,3.417,33.304,51630,53501,363337
1997,08,91819,109457,1649212,1615650,15755,14.598,12697,11.764,334074,132702,201372,8.214,20.677,266489,104500,161989,6.468,16.494,67585,4.183,32.988,8408,8559,51524
1997,09,69490,82422,1452127,1431659,8384,10.176,8327,10.106,245302,79915,165387,5.582,17.134,204352,77792,126560,5.434,14.274,40950,2.860,28.548,5357,5519,35413
1997,10,15992,19142,347798,341478,2456,12.978,2020,10.674,61321,22868,38453,6.697,17.958,49168,17875,31293,5.235,14.399,12153,3.559,28.797,1273,1289,8266
1997,11,14236,17281,374861,370490,1871,10.786,2001,11.536,59008,22001,37007,5.938,15.927,50135,17508,32627,4.726,13.532,8873,2.395,27.064,1170,1227,7558
1997,12,297082,365535,5472057,5402298,52363,14.426,47262,13.020,1117734,430499,687235,7.969,20.690,975216,413004,562212,7.645,18.052,142518,2.638,36.104,33302,34222,230265
1997,13,131901,167345,3036341,2998876,22530,13.600,19171,11.572,570526,209159,361367,6.975,19.025,496471,187635,308836,6.257,16.555,74055,2.469,33.110,12782,13085,91393
1997,15,21634,27214,417113,417014,2812,10.306,2954,10.826,59607,19628,39979,4.707,14.294,59170,19821,39349,4.753,14.189,437,0.105,28.378,1908,1965,10968
1997,16,26051,30529,395556,389959,4359,14.489,3469,11.531,73873,27867,46006,7.146,18.944,63210,23853,39357,6.117,16.209,10663,2.734,32.419,2302,2348,13698
1997,17,217187,266397,5000122,4955769,28929,10.894,27238,10.257,796597,266695,529902,5.382,16.074,709106,247733,461373,4.999,14.309,87491,1.765,28.617,17776,18295,121805
1997,18,103469,131362,2434967,2409302,14086,10.767,13009,9.944,379886,120824,259062,5.015,15.767,328940,117390,211550,4.872,13.653,50946,2.115,27.306,8710,8985,60076
1997,19,57972,72101,1158957,1150849,6901,9.590,6620,9.199,175792,64943,110849,5.643,15.275,159634,58042,101592,5.043,13.871,16158,1.404,27.742,4382,4491,27970
1997,20,53708,65842,1026061,1010878,7331,11.197,6587,10.061,169832,61484,108348,6.082,16.800,139388,50277,89111,4.974,13.789,30444,3.012,27.578,4342,4436,25460
1997,21,64118,80046,1400483,1374713,9039,11.370,7947,9.996,237689,82551,155138,6.005,17.290,185776,64659,121117,4.703,13.514,51913,3.776,27.028,5336,5483,35501
1997,22,72527,90405,1483183,1463364,10253,11.410,9161,10.195,268230,91402,176828,6.246,18.330,228002,79704,148298,5.447,15.581,40228,2.749,31.161,6163,6326,41798
1997,23,27550,32400,442814,437346,3780,11.773,3196,9.954,66524,22351,44173,5.111,15.211,55755,21201,34554,4.848,12.748,10769,2.462,25.497,2151,2197,12512
1997,24,90166,111266,1871431,1839792,13451,12.144,12442,11.233,347116,127572,219544,6.934,18.867,284013,106867,177146,5.809,15.437,63103,3.430,30.874,8018,8264,50684
1997,25,121354,147384,2779978,2748717,16159,11.057,13678,9.359,450428,159015,291413,5.785,16.387,390033,140779,249254,5.122,14.190,60395,2.197,28.379,8820,9052,67331
1997,26,166914,206820,3765820,3718095,22261,10.799,20910,10.143,631096,201965,429131,5.432,16.974,531475,186297,345178,5.011,14.294,99621,2.679,28.589,13706,14209,92628
1997,27,94577,115495,2147243,2117233,12882,11.260,10703,9.355,337439,110208,227231,5.205,15.938,277765,98758,179007,4.664,13.119,59674,2.818,26.238,6865,7096,48235
1997,28,43251,53545,886321,873673,6276,11.802,5545,10.427,147069,48964,98105,5.604,16.833,121588,37622,83966,4.306,13.917,25481,2.917,27.834,3869,3923,21707
1997,29,103377,127665,2218700,2185000,14170,11.108,13966,10.948,366008,118587,247421,5.427,16.751,298177,100554,197623,4.602,13.647,67831,3.104,27.293,9578,9867,55261
1997,30,22933,26381,269434,266398,3198,12.239,2696,10.318,46920,16504,30416,6.195,17.613,40829,14190,26639,5.327,15.326,6091,2.286,30.653,1816,1841,8417
1997,31,35806,43247,682746,678777,4391,10.198,4012,9.318,104378,39158,65220,5.769,15.377,96426,30730,65696,4.527,14.206,7952,1.172,28.412,2671,2748,16663
1997,32,30458,36499,749265,727591,6403,17.999,4554,12.801,156013,61268,94745,8.421,21.442,113050,40862,72188,5.616,15.538,42963,5.905,31.075,2984,3047,20437
1997,33,27359,32213,494804,487996,3704,11.592,3185,9.968,77633,24988,52645,5.121,15.909,63996,23119,40877,4.738,13.114,13637,2.794,26.228,2078,2125,11404
1997,34,171577,200088,3262519,3222963,24491,12.317,21996,11.062,593394,202659,390735,6.288,18.411,510635,203908,306727,6.327,15.844,82759,2.568,31.687,14552,14931,98107
1997,35,31105,37632,515415,511480,4897,13.090,4456,11.911,96269,38363,57906,7.500,18.822,88545,30696,57849,6.001,17.312,7724,1.510,34.623,2947,2991,19131
1997,36,354504,415400,6747984,6694298,49254,11.909,45597,11.025,1098913,369832,729081,5.525,16.416,989463,370734,618729,5.538,14.781,109450,1.635,29.561,32342,32994,195839
1997,37,138375,175529,3126518,3071972,22940,13.304,16729,9.702,528195,192317,335878,6.260,17.194,418318,148320,269998,4.828,13.617,109877,3.577,27.234,10969,11265,71679
1997,38,15311,18145,242452,237569,1637,8.989,1770,9.719,39924,12227,27697,5.147,16.805,30032,11350,18682,4.778,12.641,9892,4.164,25.283,1206,1236,7653
1997,39,188449,242512,4618735,4581380,24922,10.307,23509,9.722,717479,254264,463215,5.550,15.661,641505,213641,427864,4.663,14.002,75974,1.658,28.005,14912,15412,99832
1997,40,61632,75391,1095236,1075989,9138,12.194,8236,10.990,198649,71252,127397,6.622,18.462,159836,55352,104484,5.144,14.855,38813,3.607,29.710,5686,5818,33731
1997,41,71805,86007,1272185,1248881,10996,12.890,9591,11.243,234807,78069,156738,6.251,18.801,187050,67727,119323,5.423,14.977,47757,3.824,29.955,6449,6553,35182
1997,42,209882,263491,4749922,4701498,26759,10.201,24402,9.303,737859,254524,483335,5.414,15.694,641654,233033,408621,4.957,13.648,96205,2.046,27.296,15725,16310,119009
1997,44,22002,24823,385170,380827,2642,10.690,2426,9.816,59219,19609,39610,5.149,15.550,50658,16755,33903,4.400,13.302,8561,2.248,26.604,1722,1740,9649
1997,45,66593,83694,1451401,1435240,10730,12.978,8702,10.525,241986,90140,151846,6.280,16.860,208971,77519,131452,5.401,14.560,33015,2.300,29.120,5857,5998,42612
1997,46,17648,20666,280596,278102,2196,10.662,2058,9.992,42261,15173,27088,5.456,15.196,37425,13387,24038,4.814,13.457,4836,1.739,26.915,1352,1397,7164
1997,47,91945,117464,2214009,2187164,14110,12.094,12519,10.730,377312,129749,247563,5.932,17.251,322778,109850,212928,5.022,14.758,54534,2.493,29.516,8408,8666,59260
1997,48,316731,408225,7103755,6970378,53239,13.133,47577,11.736,1429112,540030,889082,7.747,20.503,1161046,436174,724872,6.258,16.657,268066,3.846,33.314,31660,32713,233310
1997,49,35972,43456,824973,799106,6537,15.339,4858,11.399,172276,66114,106162,8.273,21.559,119346,43553,75793,5.450,14.935,52930,6.624,29.870,3288,3380,23777
1997,50,16336,18576,227527,225057,2008,10.873,1793,9.708,33954,14349,19605,6.376,15.087,29272,10507,18765,4.669,13.007,4682,2.080,26.013,1262,1275,6220
1997,51,118939,151720,2613863,2556498,18547,12.343,15628,10.401,470773,160385,310388,6.274,18.415,356330,128278,228052,5.018,13.938,114443,4.477,27.876,9842,10251,61848
1997,53,114657,138116,2001992,1967333,18883,13.768,16952,12.360,382577,134136,248441,6.818,19.446,312518,120693,191825,6.135,15.885,70059,3.561,31.771,10767,11001,62245
1997,54,30468,37540,535043,529525,4097,10.972,3701,9.911,84964,29844,55120,5.636,16.045,73769,24422,49347,4.612,13.931,11195,2.114,27.862,2484,2548,12898
1997,55,100717,123169,2253592,2228518,12194,9.951,10944,8.931,322941,105527,217414,4.735,14.491,272586,90561,182025,4.064,12.232,50355,2.260,24.463,7221,7452,45762
1997,56,13244,15219,155281,153483,1795,11.800,1781,11.708,28692,9469,19223,6.169,18.694,25028,10150,14878,6.613,16.307,3664,2.387,32.613,1057,1068,4597
1998,01,72239,91147,1606059,1595945,10101,11.120,9474,10.430,246496,83490,163006,5.231,15.445,225369,78213,147156,4.901,14.121,21127,1.324,28.243,6459,6702,41018
1998,02,12705,15169,195890,192065,1901,12.643,1635,10.874,36424,12398,24026,6.455,18.964,28977,9778,19199,5.091,15.087,7447,3.877,30.174,1021,1056,4662
1998,04,77919,97195,1751750,1717061,12959,13.451,11260,11.687,338177,126640,211537,7.375,19.695,270009,104102,165907,6.063,15.725,68168,3.970,31.450,7405,7591,51487
1998,05,46001,55998,947911,932162,6335,11.337,6094,10.906,150409,58591,91818,6.285,16.136,118728,41096,77632,4.409,12.737,31681,3.399,25.474,4236,4336,24829
1998,06,553728,681454,11902708,11659374,84020,12.430,73055,10.807,2205119,721385,1483734,6.187,18.913,1716290,619479,1096811,5.313,14.720,488829,4.193,29.441,46804,48026,311448
1998,08,94539,113230,1761617,1715004,15621,14.004,12247,10.980,344023,124811,219212,7.278,20.060,250436,87193,163243,5.084,14.603,93587,5.457,29.205,8229,8336,45517
1998,09,69767,83005,1485887,1473928,7955,9.600,7667,9.253,225979,76215,149764,5.171,15.332,202473,60981,141492,4.137,13.737,23506,1.595,27.474,4963,5072,27961
1998,10,16474,19727,354167,352178,2421,12.404,2003,10.262,60188,21209,38979,6.022,17.090,54930,19295,35635,5.479,15.597,5258,1.493,31.194,1224,1239,7724
1998,11,14345,17426,386658,385941,1780,10.231,1724,9.909,56477,18848,37629,4.884,14.634,54577,20025,34552,5.189,14.141,1900,0.492,28.283,932,961,7201
1998,12,301204,371629,5752137,5639892,49911,13.522,44898,12.163,1159440,451911,707529,8.013,20.558,933486,392027,541459,6.951,16.551,225954,4.006,33.103,30585,31574,199747
1998,13,135132,172402,3203707,3147090,23223,13.647,18769,11.029,595669,225205,370464,7.156,18.928,479644,178156,301488,5.661,15.241,116025,3.687,30.482,12121,12512,83610
1998,15,21653,27126,410545,413300,2635,9.678,2836,10.416,56837,21794,35043,5.273,13.752,62098,21436,40662,5.187,15.025,-5261,-1.273,27.504,1746,1785,9921
1998,16,26637,31311,424105,413953,4049,13.071,3383,10.921,80772,32805,47967,7.925,19.512,60084,19538,40546,4.720,14.515,20688,4.998,29.029,2298,2318,11318
1998,17,220192,270650,5190649,5127835,27709,10.300,24448,9.088,789714,250661,539053,4.888,15.401,661905,210115,451790,4.098,12.908,127809,2.492,25.816,15914,16306,99632
1998,18,104511,133021,2533572,2501522,13255,10.011,12010,9.071,373327,126862,246465,5.071,14.924,308246,97241,211005,3.887,12.322,65081,2.602,24.645,7941,8139,49686
1998,19,58630,73030,1220382,1198208,6652,9.147,6032,8.295,171847,49357,122490,4.119,14.342,127341,39769,87572,3.319,10.628,44506,3.714,21.255,3988,4082,21028
1998,20,54389,66912,1075915,1059644,7017,10.544,6288,9.449,171073,59276,111797,5.594,16.144,138087,49442,88645,4.666,13.031,32986,3.113,26.063,4185,4315,24740
1998,21,64928,81561,1447286,1430587,8712,10.767,7420,9.170,230642,86974,143668,6.080,16.122,195902,61504,134398,4.299,13.694,34740,2.428,27.388,5015,5105,29490
1998,22,73415,91606,1566455,1543990,9729,10.671,8855,9.713,270187,90485,179702,5.860,17.499,224094,77224,146870,5.002,14.514,46093,2.985,29.028,5843,6034,42259
1998,23,28230,33219,460159,454016,3761,11.445,3045,9.266,66043,21649,44394,4.768,14.546,53317,17051,36266,3.756,11.743,12726,2.803,23.487,2058,2086,10119
1998,24,91135,112592,1951279,1922528,12464,11.116,11536,10.288,325830,118695,207135,6.174,16.948,268268,96802,171466,5.035,13.954,57562,2.994,27.908,7284,7545,47340
1998,25,123316,149802,2881413,2844647,14895,10.004,13063,8.774,445666,137524,308142,4.834,15.667,369828,110536,259292,3.886,13.001,75838,2.666,26.002,8253,8436,52924
1998,26,168473,209358,3891060,3850585,21121,10.130,19402,9.306,585057,190216,394841,4.940,15.194,502959,157364,345595,4.087,13.062,82098,2.132,26.124,12841,13333,82079
1998,27,97064,118257,2251379,2212218,12137,10.364,9846,8.407,345710,106702,239008,4.823,15.627,267847,79921,187926,3.613,12.108,77863,3.520,24.215,6450,6598,42168
1998,28,43695,54237,938308,925651,5947,11.017,5437,10.072,140096,46600,93496,5.034,15.135,115387,40960,74427,4.425,12.465,24709,2.669,24.931,3732,3823,22495
1998,29,104494,129382,2289741,2273715,13819,10.730,12632,9.808,333009,117066,215943,5.149,14.646,301398,94536,206862,4.158,13.256,31611,1.390,26.512,8446,8638,47208
1998,30,23471,27020,277074,275429,3305,12.356,2763,10.329,44892,16713,28179,6.068,16.299,41716,16581,25135,6.020,15.146,3176,1.153,30.292,1907,1947,8386
1998,31,36128,43758,713726,702618,4138,9.488,3850,8.827,104957,31201,73756,4.441,14.938,82382,29224,53158,4.159,11.725,22575,3.213,23.450,2624,2700,15709
1998,32,31949,38504,799184,780529,6189,16.473,4320,11.499,150495,59030,91465,7.563,19.281,113129,37280,75849,4.776,14.494,37366,4.787,28.988,2867,2897,18646
1998,33,28000,32822,520403,509785,3478,10.681,2962,9.096,82488,24404,58084,4.787,16.181,61176,20281,40895,3.978,12.000,21312,4.181,24.001,1919,1955,11621
1998,34,174674,204103,3406623,3356622,23238,11.481,19837,9.801,593248,192180,401068,5.725,17.674,492196,167637,324559,4.994,14.663,101052,3.011,29.327,13052,13255,75002
1998,35,31482,38173,538907,534064,4509,11.873,4120,10.848,90983,34282,56701,6.419,17.036,81431,30433,50998,5.698,15.247,9552,1.789,30.495,2684,2765,14979
1998,36,360592,422598,6939428,6870284,46424,11.064,40392,9.627,1128790,351662,777128,5.119,16.430,988163,314372,673791,4.576,14.383,140627,2.047,28.766,27116,27580,147965
1998,37,141501,180378,3238680,3199709,21449,12.035,17146,9.620,506831,182187,324644,5.694,15.840,428065,159542,268523,4.986,13.378,78766,2.462,26.756,11154,11419,67845
1998,38,15440,18288,251861,248391,1630,8.934,1544,8.463,37670,12359,25311,4.976,15.166,30941,11689,19252,4.706,12.457,6729,2.709,24.913,1033,1065,5528
1998,39,190309,245012,4798963,4736231,22799,9.334,21270,8.708,714156,222004,492152,4.687,15.079,588858,194183,394675,4.100,12.433,125298,2.646,24.866,13492,13939,86606
1998,40,62386,76437,1156041,1132985,8508,11.183,7796,10.247,197744,67445,130299,5.953,17.453,151972,56456,95516,4.983,13.413,45772,4.040,26.827,5248,5420,33071
1998,41,73024,87387,1303800,1293130,10428,12.009,9328,10.742,212927,76411,136516,5.909,16.466,189993,67695,122298,5.235,14.692,22934,1.774,29.385,6080,6175,33460
1998,42,212211,266813,4908698,4852092,24588,9.257,22201,8.358,711467,231870,479597,4.779,14.663,596174,179085,417089,3.691,12.287,115293,2.376,24.574,14212,14659,87078
1998,44,22355,25177,403116,395927,2476,9.887,2208,8.817,59597,19516,40081,4.929,15.053,44840,11999,32841,3.031,11.325,14757,3.727,22.651,1507,1521,6374
1998,45,68154,85847,1532654,1502018,10326,12.162,8445,9.946,257429,84525,172904,5.627,17.139,196364,66596,129768,4.434,13.073,61065,4.066,26.147,5516,5620,31973
1998,46,17904,20969,294066,288655,2122,10.172,1908,9.146,42191,12321,29870,4.268,14.616,31518,10758,20760,3.727,10.919,10673,3.697,21.838,1331,1368,6391
1998,47,92668,119298,2302156,2270297,13534,11.416,12042,10.158,375357,140752,234605,6.200,16.533,310764,109419,201345,4.820,13.688,64593,2.845,27.377,8026,8226,49084
1998,48,322449,416878,7544849,7377165,51414,12.439,44310,10.720,1440827,508868,931959,6.898,19.531,1103320,373344,729976,5.061,14.956,337507,4.575,29.912,28742,30002,185052
1998,49,37089,44806,843443,837604,6262,14.169,5040,11.404,155887,57538,98349,6.869,18.611,143487,43407,100080,5.182,17.131,12400,1.480,34.261,3318,3368,22329
1998,50,16493,18679,237441,233217,1852,9.928,1802,9.660,34622,10626,23996,4.556,14.845,26124,8974,17150,3.848,11.202,8498,3.644,22.403,1223,1250,5115
1998,51,121226,155427,2706489,2669936,18099,11.767,14873,9.669,440538,161984,278554,6.067,16.500,365563,129364,236199,4.845,13.692,74975,2.808,27.384,9361,9683,57372
1998,53,117314,141417,2090456,2059668,17959,12.825,15177,10.839,353291,116277,237014,5.645,17.153,291630,97814,193816,4.749,14.159,61661,2.994,28.318,10073,10241,53990
1998,54,30610,37904,550172,544495,3706,9.811,3444,9.118,84406,32005,52401,5.878,15.502,73363,20796,52567,3.819,13.474,11043,2.028,26.947,2282,2311,11241
1998,55,102127,124943,2319904,2294671,11611,9.343,10269,8.263,312843,93089,219754,4.057,13.633,261697,85247,176450,3.715,11.405,51146,2.229,22.809,6770,6946,40845
1998,56,13593,15615,163855,161953,1817,11.759,1492,9.655,28668,10445,18223,6.449,17.701,24937,8948,15989,5.525,15.398,3731,2.304,30.795,1022,1038,4614
1999,01,72248,91627,1620838,1613801,9695,10.608,9222,10.091,248851,90704,158147,5.621,15.420,234933,79945,154988,4.954,14.558,13918,0.862,29.115,6274,6436,40406
1999,02,12776,15301,195934,195417,1730,11.357,1595,10.470,28874,8510,20364,4.355,14.776,27781,7810,19971,3.997,14.216,1093,0.559,28.433,1048,1068,4463
1999,04,79431,99953,1821519,1784922,13831,14.031,11080,11.240,348927,130583,218344,7.316,19.549,274775,101269,173506,5.674,15.394,74152,4.154,30.788,7310,7579,56273
1999,05,46028,56315,952949,950539,6273,11.166,5997,10.675,141780,47290,94490,4.975,14.916,137240,53662,83578,5.645,14.438,4540,0.478,28.876,4142,4262,24909
1999,06,561533,693478,12232395,12077403,84915,12.350,73057,10.626,2190448,788463,1401985,6.528,18.137,1884870,679168,1205702,5.623,15.607,305578,2.530,31.213,46901,48445,347566
1999,08,96490,116191,1826003,1793528,15557,13.562,12602,10.986,349535,133937,215598,7.468,19.489,284271,111463,172808,6.215,15.850,65264,3.639,31.700,8363,8614,52068
1999,09,69615,83201,1521453,1504741,7683,9.243,7534,9.063,224922,71338,153584,4.741,14.948,190393,65989,124404,4.385,12.653,34529,2.295,25.306,4888,5025,29216
1999,10,16864,20176,360060,357626,2453,12.291,2016,10.101,57919,23695,34224,6.626,16.195,52917,17955,34962,5.021,14.797,5002,1.399,29.594,1215,1243,8130
1999,11,14332,17476,391035,388929,1798,10.304,1746,10.006,56351,19582,36769,5.035,14.489,51387,20672,30715,5.315,13.212,4964,1.276,26.425,968,993,7238
1999,12,302990,374736,5943828,5858687,50310,13.482,47166,12.639,1168899,395747,773152,6.755,19.952,999440,406335,593105,6.936,17.059,169459,2.892,34.118,31251,32252,209854
1999,13,137422,175176,3334164,3270707,22247,12.802,19450,11.192,603183,216034,387149,6.605,18.442,473891,172901,300990,5.286,14.489,129292,3.953,28.978,12303,12694,84898
1999,15,21558,26981,415550,413735,2550,9.425,2698,9.972,58658,23083,35575,5.579,14.178,55187,20024,35163,4.840,13.339,3471,0.839,26.677,1690,1761,10780
1999,16,27202,32246,432467,428624,4144,13.037,3227,10.152,70292,27190,43102,6.344,16.399,62910,23696,39214,5.528,14.677,7382,1.722,29.354,2212,2246,12988
1999,17,220800,272799,5326988,5265096,27092,9.969,25006,9.202,792603,267564,525039,5.082,15.054,666054,214439,451615,4.073,12.650,126549,2.404,25.301,16221,16695,105386
1999,18,104298,133593,2585132,2560826,12578,9.434,12051,9.039,366416,117801,248615,4.600,14.309,317445,103174,214271,4.029,12.396,48971,1.912,24.792,8215,8437,55704
1999,19,58497,73450,1245418,1233540,6455,8.810,6086,8.307,175397,57770,117627,4.683,14.219,151765,48450,103315,3.928,12.303,23632,1.916,24.606,4230,4346,24480
1999,20,54432,67274,1104305,1090157,6742,10.049,6381,9.511,171813,61523,110290,5.644,15.760,142949,52824,90125,4.846,13.113,28864,2.648,26.225,4229,4346,25253
1999,21,65115,82087,1460815,1452658,8419,10.292,7855,9.602,214444,78035,136409,5.372,14.762,199057,62377,136680,4.294,13.703,15387,1.059,27.406,5203,5360,32595
1999,22,73255,91925,1576260,1573630,9340,10.177,9035,9.845,242220,79636,162584,5.061,15.392,236764,82948,153816,5.271,15.046,5456,0.347,30.091,6046,6262,49097
1999,23,28812,33870,471446,466194,3661,10.909,3038,9.053,67864,21900,45964,4.698,14.557,57393,18905,38488,4.055,12.311,10471,2.246,24.622,2038,2083,11192
1999,24,91703,113276,1979986,1964458,12134,10.745,11428,10.120,324617,111968,212649,5.700,16.525,292770,106737,186033,5.433,14.903,31847,1.621,29.807,7132,7277,51894
1999,25,125600,152367,2943949,2915180,15940,10.549,13420,8.881,447244,142966,304278,4.904,15.342,389910,123823,266087,4.248,13.375,57334,1.967,26.750,8544,8815,61464
1999,26,168451,210346,3959252,3927983,20354,9.699,19375,9.232,592203,203123,389080,5.171,15.077,528693,168650,360043,4.294,13.460,63510,1.617,26.919,12882,13235,84556
1999,27,98271,120359,2312838,2282654,12342,10.343,10283,8.617,336555,115388,221167,5.055,14.744,275880,92628,183252,4.058,12.086,60675,2.658,24.172,6711,6936,44983
1999,28,43765,54618,942303,939652,5961,10.949,5615,10.313,136370,44290,92080,4.713,14.513,131476,48447,83029,5.156,13.992,4894,0.521,27.984,3928,4002,23948
1999,29,104668,130273,2335213,2316159,13586,10.463,12737,9.809,343633,110183,233450,4.757,14.836,304999,104871,200128,4.528,13.168,38634,1.668,26.337,8628,8819,48807
1999,30,23673,27328,288198,282341,3014,11.089,2719,10.003,47861,16291,31570,5.770,16.951,36261,13155,23106,4.659,12.843,11600,4.109,25.686,1862,1905,8530
1999,31,36262,44046,728953,722102,4003,9.114,3757,8.554,106542,33257,73285,4.606,14.754,92410,35882,56528,4.969,12.797,14132,1.957,25.595,2576,2668,20993
1999,32,33267,40674,856519,828615,6757,17.064,4603,11.625,177249,74991,102258,9.050,21.391,120921,39286,81635,4.741,14.593,56328,6.798,29.186,3082,3183,22460
1999,33,28318,33389,532020,526129,3369,10.174,2821,8.519,73645,23936,49709,4.549,13.998,61818,18725,43093,3.559,11.750,11827,2.248,23.499,1946,1996,10875
1999,34,175428,205359,3457508,3429885,22091,10.790,20834,10.176,550479,192029,358450,5.599,16.049,494044,163346,330698,4.762,14.404,56435,1.645,28.808,13633,13936,88776
1999,35,31346,38432,542027,541721,4420,11.537,4179,10.908,87348,33592,53756,6.201,16.124,86362,27832,58530,5.138,15.942,986,0.182,31.884,2782,2843,15991
1999,36,362464,426618,7050848,6998588,45100,10.621,41118,9.683,1043214,338675,704539,4.839,14.906,938664,312585,626079,4.466,13.412,104550,1.494,26.824,28007,28503,162101
1999,37,143793,182319,3320683,3282489,20798,11.469,18854,10.397,543202,190834,352368,5.814,16.548,468174,170241,297933,5.186,14.263,75028,2.286,28.526,11391,11793,72263
1999,38,15380,18328,251700,252286,1486,8.114,1456,7.951,31888,11639,20249,4.613,12.640,32694,10134,22560,4.017,12.959,-806,-0.319,25.279,1004,1023,5537
1999,39,190037,245892,4835320,4818779,21860,8.906,21006,8.558,679413,214537,464876,4.452,14.099,648569,223598,424971,4.640,13.459,30844,0.640,26.918,13594,14140,94852
1999,40,62246,76628,1156421,1157370,8405,10.981,8234,10.757,186302,68089,118213,5.883,16.097,188685,70489,118196,6.090,16.303,-2383,-0.206,32.194,5484,5648,34882
1999,41,73502,88564,1325558,1314335,10385,11.803,9225,10.485,212039,73304,138735,5.577,16.133,189830,71572,118258,5.445,14.443,22209,1.690,28.886,6335,6511,38651
1999,42,212308,267529,4969503,4939977,23826,8.917,23165,8.670,688878,233238,455640,4.721,13.945,631179,203961,427218,4.129,12.777,57699,1.168,25.554,14897,15337,95470
1999,44,22244,25197,410122,408616,2352,9.337,2339,9.285,55357,16430,38927,4.021,13.547,52484,15348,37136,3.756,12.844,2873,0.703,25.689,1648,1662,7745
1999,45,69394,87423,1566343,1548550,10249,11.830,8669,10.007,246292,86168,160124,5.564,15.905,212408,70075,142333,4.525,13.717,33884,2.188,27.433,5579,5850,35605
1999,46,17961,21110,298574,296152,2074,9.855,1943,9.233,39624,14330,25294,4.839,13.380,34872,11925,22947,4.027,11.775,4752,1.605,23.550,1343,1381,6293
1999,47,92313,119869,2339021,2326055,13046,10.910,12456,10.417,361655,129769,231886,5.579,15.548,337307,118247,219060,5.084,14.501,24348,1.047,29.002,8189,8433,51497
1999,48,323084,421095,7707769,7635447,50453,12.041,46291,11.048,1399350,480603,918747,6.294,18.327,1254059,463116,790943,6.065,16.424,145291,1.903,32.848,30340,31419,229341
1999,49,38095,46505,880830,870099,6767,14.821,5074,11.113,152990,58993,93997,6.780,17.583,131027,49088,81939,5.642,15.059,21963,2.524,30.118,3471,3572,29164
1999,50,16724,19059,243613,240762,1930,10.226,1558,8.255,33012,10600,22412,4.403,13.711,27169,8926,18243,3.707,11.285,5843,2.427,22.569,1148,1167,5969
1999,51,121988,156467,2782846,2745565,16953,10.871,15902,10.197,445969,152637,293332,5.559,16.243,371688,126783,244905,4.618,13.538,74281,2.705,27.076,9582,9908,59883
1999,53,118089,142868,2153421,2122976,17294,12.165,15873,11.166,363985,131936,232049,6.215,17.145,303431,106384,197047,5.011,14.293,60554,2.852,28.585,10601,11008,59963
1999,54,30532,37878,546503,546549,3574,9.438,3554,9.385,74451,28398,46053,5.196,13.622,74832,25148,49684,4.601,13.692,-381,-0.070,27.244,2376,2439,12715
1999,55,102450,125997,2363806,2341955,11278,8.987,10274,8.187,312400,93513,218887,3.993,13.339,268679,82424,186255,3.519,11.472,43721,1.867,22.945,6946,7146,43544
1999,56,13565,15693,168367,166195,1752,11.191,1677,10.712,28710,9545,19165,5.743,17.275,24371,8702,15669,5.236,14.664,4339,2.611,29.328,1140,1149,4687
2000,01,71640,91228,1654566,1640107,9202,10.062,9644,10.546,252762,74096,178666,4.518,15.411,224228,81354,142874,4.960,13.672,28534,1.740,27.343,6437,6656,43160
2000,02,12786,15363,207596,202298,1769,11.531,1726,11.251,38630,13542,25088,6.694,19.096,27959,10511,17448,5.196,13.821,10671,5.275,27.641,1110,1145,6089
2000,04,80294,101738,1922122,1876667,13558,13.441,11826,11.724,377724,135419,242305,7.216,20.127,286409,99458,186951,5.300,15.262,91315,4.866,30.523,7645,7903,51643
2000,05,46131,56716,988474,971362,6275,11.100,5909,10.452,150811,46223,104588,4.759,15.526,115988,42107,73881,4.335,11.941,34823,3.585,23.882,3995,4081,23130
2000,06,569458,702386,12724657,12494529,83685,11.988,75001,10.744,2342688,756934,1585754,6.058,18.750,1880773,719679,1161094,5.760,15.053,461915,3.697,30.106,46474,48228,322485
2000,08,98351,118811,1929189,1880465,15542,13.225,12966,11.033,368941,128609,240332,6.839,19.620,270984,97414,173570,5.180,14.410,97957,5.209,28.821,8337,8628,51617
2000,09,69733,83369,1542364,1535949,7502,9.004,7400,8.882,213345,67446,145899,4.391,13.890,199815,69278,130537,4.510,13.009,13530,0.881,26.018,4642,4806,28763
2000,10,17302,20785,378487,369384,2675,13.048,2107,10.278,69784,29902,39882,8.095,18.892,51657,18870,32787,5.109,13.985,18127,4.907,27.969,1277,1299,6978
2000,11,14380,17653,405541,398832,1759,10.007,1608,9.148,58800,19214,39586,4.818,14.743,45850,13710,32140,3.438,11.496,12950,3.247,22.992,904,910,5791
2000,12,303677,376499,6178593,6056920,48639,12.948,46960,12.501,1188851,404690,784161,6.681,19.628,944116,397298,546818,6.559,15.587,244735,4.041,31.175,30760,31641,191648
2000,13,138474,177497,3434601,3390667,22221,12.599,19969,11.322,603762,209737,394025,6.186,17.807,515797,188174,327623,5.550,15.212,87965,2.594,30.425,12676,12979,86178
2000,15,21743,27149,429929,423092,2566,9.480,2402,8.874,59878,18870,41008,4.460,14.152,46524,17703,28821,4.184,10.996,13354,3.156,21.992,1497,1547,8560
2000,16,27513,32671,450595,444235,3943,12.147,3523,10.853,82392,34039,48353,7.662,18.547,69272,21421,47851,4.822,15.594,13120,2.953,31.187,2309,2380,13336
2000,17,221187,274189,5440692,5388844,27214,9.949,25924,9.477,849791,262736,587055,4.876,15.769,747177,285708,461469,5.302,13.865,102614,1.904,27.731,16278,16737,111033
2000,18,103855,133668,2684280,2636191,12544,9.385,12531,9.375,399504,118405,281099,4.492,15.155,304764,100463,204301,3.811,11.561,94740,3.594,23.122,8129,8400,48998
2000,19,58351,73572,1277313,1264129,6186,8.412,6121,8.323,167674,55910,111764,4.423,13.264,141071,48392,92679,3.828,11.160,26603,2.104,22.319,4095,4228,23205
2000,20,54493,67588,1119662,1111903,6750,10.008,6461,9.580,168220,60788,107432,5.467,15.129,153111,56308,96803,5.064,13.770,15109,1.359,27.540,4190,4288,23443
2000,21,64828,82236,1512027,1488591,8035,9.777,7923,9.641,229519,75930,153589,5.101,15.419,182522,62157,120365,4.176,12.261,46997,3.157,24.523,5166,5302,33445
2000,22,72792,92035,1597546,1587773,9348,10.161,9281,10.088,260995,99474,161521,6.265,16.438,241019,86132,154887,5.425,15.180,19976,1.258,30.359,6003,6214,49687
2000,23,29176,34427,492038,482407,3569,10.444,3059,8.952,72821,23576,49245,4.887,15.095,53472,19377,34095,4.017,11.084,19349,4.011,22.169,2093,2139,10770
2000,24,92007,114017,2069238,2035004,11991,10.547,11347,9.980,349558,111771,237787,5.492,17.177,281791,103884,177907,5.105,13.847,67767,3.330,27.694,7085,7252,42497
2000,25,127020,154539,3053949,3004498,15700,10.229,13582,8.849,495754,154479,341275,5.142,16.500,397291,144537,252754,4.811,13.223,98463,3.277,26.446,8556,8925,63350
2000,26,168533,210843,4044936,4010723,20188,9.585,19765,9.384,616471,200243,416228,4.993,15.371,550794,197549,353245,4.926,13.733,65677,1.638,27.466,12578,12946,88473
2000,27,99297,121861,2374843,2345079,11941,9.855,10547,8.705,348042,105617,242425,4.504,14.841,288157,91544,196613,3.904,12.288,59885,2.554,24.575,6873,7083,44114
2000,28,43254,54507,956347,950599,5598,10.258,5732,10.503,134243,47814,86429,5.030,14.122,122089,42318,79771,4.452,12.843,12154,1.279,25.687,3851,3949,22524
2000,29,104703,130862,2379619,2359953,13441,10.292,12917,9.891,353205,114073,239132,4.834,14.967,314681,104067,210614,4.410,13.334,38524,1.632,26.668,8639,8842,48707
2000,30,23920,27739,299382,294040,3115,11.308,2730,9.911,49064,16136,32928,5.488,16.686,38366,13942,24424,4.742,13.048,10698,3.638,26.096,1852,1889,8272
2000,31,36494,44587,753910,741725,4202,9.480,3680,8.302,110885,37084,73801,5.000,14.950,86828,25261,61567,3.406,11.706,24057,3.243,23.412,2407,2486,12348
2000,32,34260,42030,910599,885128,6512,15.744,5176,12.514,177176,64170,113006,7.250,20.017,126012,44794,81218,5.061,14.237,51164,5.780,28.473,3321,3385,22238
2000,33,28471,33657,559259,546320,3328,9.925,3076,9.174,92871,29846,63025,5.463,16.999,67478,24209,43269,4.431,12.351,25393,4.648,24.703,1975,2038,12215
2000,34,175854,206731,3557959,3513377,22122,10.735,20815,10.101,593077,185650,407427,5.284,16.881,505432,183995,321437,5.237,14.386,87645,2.495,28.772,13367,13650,80862
2000,35,31183,38457,555154,549848,4279,11.127,4276,11.119,91297,30978,60319,5.634,16.604,80900,29099,51801,5.292,14.713,10397,1.891,29.426,2821,2890,15726
2000,36,364900,430875,7289012,7185127,45482,10.606,41419,9.658,1139277,370333,768944,5.154,15.856,929709,339649,590060,4.727,12.939,209568,2.917,25.879,27286,27898,163303
2000,37,144508,184056,3401169,3367460,19655,10.725,18061,9.855,521118,173222,347896,5.144,15.475,455770,161929,293841,4.809,13.535,65348,1.941,27.069,11800,12157,72208
2000,38,15254,18217,256065,253798,1410,7.713,1540,8.424,33334,9687,23647,3.817,13.134,28688,9392,19296,3.701,11.303,4646,1.831,22.607,1099,1130,6064
2000,39,189589,246446,4993886,4930323,21766,8.839,21359,8.674,754792,236386,518406,4.795,15.309,630805,200086,430719,4.058,12.794,123987,2.515,25.589,13365,13881,87878
2000,40,61976,76677,1201808,1181154,8100,10.566,8066,10.522,205112,72928,132184,6.174,17.365,164323,59750,104573,5.059,13.912,40789,3.453,27.824,5276,5441,30973
2000,41,73658,88830,1354171,1342319,9881,11.138,9655,10.883,220306,81130,139176,6.044,16.412,195614,69847,125767,5.203,14.573,24692,1.840,29.146,6270,6470,34244
2000,42,212810,268726,5066131,5023797,23766,8.859,22840,8.514,736419,243528,492891,4.847,14.659,653063,234072,418991,4.659,12.999,83356,1.659,25.999,14289,14832,88533
2000,44,22350,25401,419985,415760,2444,9.657,2259,8.926,63247,20632,42615,4.962,15.212,54779,20305,34474,4.884,13.176,8468,2.037,26.351,1505,1544,8109
2000,45,69681,88085,1613255,1597454,9587,10.922,8965,10.214,251997,81444,170553,5.098,15.775,221613,73364,148249,4.593,13.873,30384,1.902,27.746,5785,5943,35365
2000,46,18049,21246,307421,303738,1983,9.359,1868,8.816,45750,13568,32182,4.467,15.062,38283,12575,25708,4.140,12.604,7467,2.458,25.208,1272,1318,6082
2000,47,91639,119832,2392524,2363216,12364,10.314,12461,10.395,382876,121201,261675,5.129,16.201,325176,117388,207788,4.967,13.760,57700,2.442,27.520,7986,8241,48657
2000,48,323899,424385,8024802,7880799,49532,11.713,46524,11.002,1474658,508897,965761,6.457,18.712,1190076,439428,750648,5.576,15.101,284582,3.611,30.202,29584,30864,205976
2000,49,38834,47765,909482,895314,6522,13.834,5279,11.198,157375,57744,99631,6.450,17.578,129245,45180,84065,5.046,14.436,28130,3.142,28.871,3541,3621,25391
2000,50,16784,19178,253562,248632,1802,9.421,1700,8.888,37603,12163,25440,4.892,15.124,27703,8672,19031,3.488,11.142,9900,3.982,22.284,1199,1209,5211
2000,51,122961,158264,2905944,2850433,17095,10.859,15416,9.793,491227,165938,325289,5.822,17.233,380338,137743,242595,4.832,13.343,110889,3.890,26.686,9479,9791,56638
2000,53,118714,144045,2235009,2202729,17042,11.877,15935,11.105,386386,128734,257652,5.844,17.541,320083,103656,216427,4.706,14.531,66303,3.010,29.062,10462,10822,56283
2000,54,30298,37788,564535,557610,3457,9.134,3573,9.441,79004,26934,52070,4.830,14.168,65338,21555,43783,3.866,11.718,13666,2.451,23.435,2287,2370,12349
2000,55,102633,127032,2419191,2392455,11467,9.061,10501,8.298,327930,104307,223623,4.360,13.707,274258,91953,182305,3.843,11.463,53672,2.243,22.927,6964,7161,40790
2000,56,13709,15875,174474,171497,1674,10.601,1505,9.531,29159,8939,20220,5.212,17.003,23117,7477,15640,4.360,13.480,6042,3.523,26.959,971,995,4388
2001,01,70613,90886,1609864,1631090,9450,10.379,9773,10.734,232382,94032,138350,5.765,14.247,273646,95946,177700,5.882,16.777,-41264,-2.530,28.494,6410,6705,50686
2001,02,12729,15341,210561,208691,1751,11.423,1726,11.260,35878,10901,24977,5.224,17.192,32312,13041,19271,6.249,15.483,3566,1.709,30.966,1012,1041,5192
2001,04,81492,103478,1944720,1935966,13983,13.626,12272,11.958,354097,134407,219690,6.943,18.290,335691,139794,195897,7.221,17.340,18406,0.951,34.679,7406,7635,52386
2001,05,45554,56523,982450,985064,6099,10.772,6293,11.114,141053,55324,85729,5.616,14.319,146046,50215,95831,5.098,14.826,-4993,-0.507,28.638,4306,4438,28488
2001,06,574996,711695,12950956,12841007,85738,12.123,76763,10.854,2251505,758700,1492805,5.908,17.534,2031047,729156,1301891,5.678,15.817,220458,1.717,31.634,49154,50719,358110
2001,08,100139,121565,1984387,1958820,16448,13.685,13699,11.398,384921,141941,242980,7.246,19.651,333854,128783,205071,6.575,17.044,51067,2.607,34.087,8812,9015,55656
2001,09,69213,83403,1546711,1545140,7682,9.216,7580,9.094,216738,78063,138675,5.052,14.027,213214,74341,138873,4.811,13.799,3524,0.228,27.598,4708,4862,27675
2001,10,17635,21295,385917,382280,2604,12.376,2095,9.957,64149,23043,41106,6.028,16.781,56540,17550,38990,4.591,14.790,7609,1.990,29.580,1277,1305,7275
2001,11,14302,17656,402498,400566,1845,10.498,1681,9.565,61719,22373,39346,5.585,15.408,57363,21954,35409,5.481,14.320,4356,1.087,28.641,914,937,7037
2001,12,307550,382899,6418412,6298715,51911,13.669,45653,12.021,1283034,461108,821926,7.321,20.370,1048664,397409,651255,6.309,16.649,234370,3.721,33.298,29480,30371,188174
2001,13,139785,179977,3448138,3448110,22816,12.764,20355,11.388,564752,219274,345478,6.359,16.379,565648,201408,364240,5.841,16.405,-896,-0.026,32.757,12486,13107,93182
2001,15,22046,27528,437600,434368,2714,9.923,2357,8.618,58090,20165,37925,4.642,13.373,51838,17912,33926,4.124,11.934,6252,1.439,23.868,1437,1488,8337
2001,16,27795,33029,463167,457105,4183,12.725,3868,11.767,80294,30025,50269,6.569,17.566,68666,26452,42214,5.787,15.022,11628,2.544,30.044,2322,2394,14336
2001,17,220278,274072,5375605,5412595,26337,9.608,26403,9.632,748183,259952,488231,4.803,13.823,823246,272397,550849,5.033,15.210,-75063,-1.387,27.646,16677,17329,115878
2001,18,103096,133107,2593259,2627102,12539,9.403,13014,9.760,334659,114619,220040,4.363,12.739,400805,134816,265989,5.132,15.257,-66146,-2.518,25.477,7971,8257,61381
2001,19,57560,72872,1250060,1258879,5907,8.064,6665,9.099,143282,47495,95787,3.773,11.382,161412,49148,112264,3.904,12.822,-18130,-1.440,22.763,4259,4411,23898
2001,20,54137,67538,1111776,1118906,6684,9.891,6761,10.005,148011,53648,94363,4.795,13.228,162792,54549,108243,4.875,14.549,-14781,-1.321,26.456,4358,4469,25270
2001,21,64686,82190,1489016,1501006,7968,9.692,8005,9.737,200295,67135,133160,4.473,13.344,224658,75081,149577,5.002,14.967,-24363,-1.623,26.688,5039,5219,33348
2001,22,72610,91970,1590513,1594298,9323,10.134,9380,10.196,238374,81088,157286,5.086,14.952,246451,84353,162098,5.291,15.458,-8077,-0.507,29.903,5712,5919,41510
2001,23,29284,34752,495749,493842,3606,10.430,3252,9.406,69926,27308,42618,5.530,14.160,66651,24166,42485,4.893,13.496,3275,0.663,26.993,2202,2234,12114
2001,24,92756,115234,2082051,2073573,12716,11.096,11454,9.995,324233,118950,205283,5.736,15.636,306650,109609,197041,5.286,14.788,17583,0.848,29.577,6909,7284,50652
2001,25,127242,155240,3090528,3070349,15304,9.885,14460,9.340,480218,154599,325619,5.035,15.641,438855,155911,282944,5.078,14.293,41363,1.347,28.587,9052,9294,71276
2001,26,167414,210695,3966543,4008900,20452,9.706,20493,9.725,565429,193007,372422,4.814,14.104,648302,210236,438066,5.244,16.172,-82873,-2.067,28.209,12898,13345,90430
2001,27,99936,123719,2383465,2377436,12940,10.541,11021,8.978,335369,126803,208566,5.334,14.106,323945,103946,219999,4.372,13.626,11424,0.481,27.252,6974,7200,49748
2001,28,42662,54129,922895,941011,5578,10.271,5939,10.935,124191,48120,76071,5.114,13.198,160640,59165,101475,6.287,17.071,-36449,-3.873,26.395,3832,3995,28602
2001,29,103505,130352,2369931,2374497,12700,9.726,13141,10.064,330118,113857,216261,4.795,13.903,338333,117611,220722,4.953,14.249,-8215,-0.346,27.805,8661,8878,54217
2001,30,24170,28137,303706,301601,3101,11.098,2710,9.699,46976,16163,30813,5.359,15.576,42562,14361,28201,4.762,14.112,4414,1.464,28.224,1766,1796,9184
2001,31,36554,44834,741776,748395,4213,9.417,4023,8.992,98478,37802,60676,5.051,13.159,112253,37706,74547,5.038,14.999,-13775,-1.841,26.317,2502,2593,15727
2001,32,34929,42958,936939,923921,6526,15.352,5626,13.235,170509,70663,99846,7.648,18.455,145287,49596,95691,5.368,15.725,25222,2.730,31.450,3636,3730,26669
2001,33,28545,33826,557894,556587,3335,9.885,3160,9.366,76436,26667,49769,4.791,13.733,73453,27064,46389,4.862,13.197,2983,0.536,26.394,2068,2141,11419
2001,34,176697,208636,3617910,3587751,22612,10.887,20740,9.986,591989,197913,394076,5.516,16.500,529297,175069,354228,4.880,14.753,62692,1.747,29.506,13462,13740,81806
2001,35,31144,38521,554256,554490,4373,11.367,4275,11.112,92723,32648,60075,5.888,16.722,93428,31806,61622,5.736,16.849,-705,-0.127,33.444,2577,2638,14420
2001,36,367147,434085,7271739,7267387,46067,10.657,42421,9.814,1033977,356481,677496,4.905,14.228,1025919,365044,660875,5.023,14.117,8058,0.111,28.234,27437,28023,172552
2001,37,145433,185800,3440419,3420362,20773,11.235,18954,10.251,552238,192041,360197,5.615,16.146,508793,174283,334510,5.095,14.875,43445,1.270,29.751,11831,12305,76667
2001,38,15181,18229,257641,256832,1512,8.290,1530,8.389,32464,12309,20155,4.793,12.640,30959,9393,21566,3.657,12.054,1505,0.586,24.108,1025,1043,6291
2001,39,187953,245914,4893471,4943009,21666,8.805,21956,8.923,642863,228376,414487,4.620,13.005,742301,229864,512437,4.650,15.017,-99438,-2.012,26.011,13551,14146,95559
2001,40,61775,76901,1210751,1207570,8166,10.634,7952,10.355,189985,69911,120074,5.789,15.733,183724,67758,115966,5.611,15.214,6261,0.518,30.429,5160,5293,31266
2001,41,73830,89606,1359824,1356148,10482,11.752,9656,10.826,216825,81700,135125,6.024,15.988,209281,66806,142475,4.926,15.432,7544,0.556,30.864,6283,6468,33219
2001,42,212355,270098,5074930,5070139,24703,9.172,23161,8.600,702210,254424,447786,5.018,13.850,690052,233123,456929,4.598,13.610,12158,0.240,27.220,14501,15170,106104
2001,44,22325,25456,413735,416375,2390,9.404,2307,9.077,51980,16838,35142,4.044,12.484,56678,16285,40393,3.911,13.612,-4698,-1.128,24.968,1514,1555,8351
2001,45,69503,88331,1599268,1606416,9746,11.050,9486,10.755,238872,87197,151675,5.428,14.870,252164,86534,165630,5.387,15.697,-13292,-0.827,29.740,6016,6273,43190
2001,46,18069,21376,314992,311337,2053,9.626,1958,9.180,45685,21155,24530,6.795,14.674,39181,11777,27404,3.783,12.585,6504,2.089,25.170,1276,1300,6566
2001,47,90584,119221,2356921,2374874,12435,10.407,12963,10.849,346773,119218,227555,5.020,14.602,382213,137361,244852,5.784,16.094,-35440,-1.492,29.203,7947,8304,67359
2001,48,325622,429170,8157687,8098783,51144,11.982,46467,10.886,1450748,542871,907877,6.703,17.913,1331783,515175,816608,6.361,16.444,118965,1.469,32.888,29092,30220,225583
2001,49,39820,48822,910905,911294,7038,14.565,6034,12.488,161572,61467,100105,6.745,17.730,164449,65540,98909,7.192,18.046,-2877,-0.316,35.460,3617,3713,29419
2001,50,16659,19133,254089,252159,1666,8.712,1648,8.617,32507,10386,22121,4.119,12.891,28675,10049,18626,3.985,11.372,3832,1.520,22.744,1155,1169,5665
2001,51,123943,159934,2939039,2924030,17390,10.933,15638,9.832,473014,175813,297201,6.013,16.177,443326,142598,300728,4.877,15.161,29688,1.015,30.323,9344,9711,61137
2001,53,118991,145118,2252900,2243750,17145,11.858,16079,11.121,357813,123243,234570,5.493,15.947,339960,113542,226418,5.060,15.151,17853,0.796,30.303,10290,10560,59019
2001,54,29679,37196,557144,559884,3232,8.626,3774,10.073,74256,23480,50776,4.194,13.263,79733,27654,52079,4.939,14.241,-5477,-0.978,26.525,2408,2462,11414
2001,55,102355,127141,2387558,2402883,11109,8.742,10971,8.634,282265,89330,192935,3.718,11.747,313271,98938,214333,4.117,13.037,-31006,-1.290,23.494,7034,7370,46510
2001,56,13843,16037,178382,176434,1799,11.271,1649,10.331,29179,10217,18962,5.791,16.538,25366,8759,16607,4.964,14.377,3813,2.161,28.754,1033,1049,4844
2002,01,70730,91403,1579853,1596739,10227,11.204,9976,10.929,257001,99909,157092,6.257,16.095,291203,95923,195280,6.007,18.237,-34202,-2.142,32.191,6024,6192,49161
2002,02,12858,15635,213166,212382,2133,13.763,1859,11.995,39759,15421,24338,7.261,18.721,38224,12346,25878,5.813,17.998,1535,0.723,35.996,1033,1046,6576
2002,04,82144,105098,1933769,1942446,14820,14.202,13320,12.765,386683,157850,228833,8.126,19.907,404611,144155,260456,7.421,20.830,-17928,-0.923,39.814,7827,8060,62443
2002,05,46006,57400,971146,979913,6887,12.071,6195,10.858,151775,54615,97160,5.573,15.489,170113,59822,110291,6.105,17.360,-18338,-1.871,30.977,3897,3989,35455
2002,06,578856,721354,12655210,12852778,95032,13.246,87235,12.159,2298475,930441,1368034,7.239,17.883,2696585,911780,1784805,7.094,20.981,-398110,-3.097,35.766,52863,54544,467199
2002,08,100793,122692,1918648,1957691,16613,13.580,15891,12.990,341133,138830,202303,7.092,17.425,420240,141780,278460,7.242,21.466,-79107,-4.041,34.851,9329,9571,63378
2002,09,68684,83180,1541267,1547554,8334,9.992,8786,10.534,237216,90835,146381,5.870,15.328,249858,82627,167231,5.339,16.145,-12642,-0.817,30.657,5045,5125,34487
2002,10,17547,21601,385290,386754,2698,12.554,2478,11.530,66254,31779,34475,8.217,17.131,68659,22954,45705,5.935,17.753,-2405,-0.622,34.262,1397,1448,9041
2002,11,14628,18082,414246,414416,2208,12.280,2005,11.151,67931,25570,42361,6.170,16.392,68047,23820,44227,5.748,16.420,-116,-0.028,32.784,993,1013,11619
2002,12,313008,390274,6297611,6376261,56611,14.630,49968,12.913,1215193,497023,718170,7.795,19.058,1376669,554280,822389,8.693,21.591,-161476,-2.532,38.116,30243,31037,233716
2002,13,141464,182205,3370905,3426530,24289,13.398,22464,12.391,565942,235901,330041,6.885,16.516,678418,253228,425190,7.390,19.799,-112476,-3.283,33.033,12769,13128,118572
2002,15,22228,27844,439014,440898,3077,11.094,2861,10.315,67078,28541,38537,6.473,15.214,70663,23515,47148,5.333,16.027,-3585,-0.813,30.428,1637,1677,12099
2002,16,28129,33591,452390,458283,4458,13.367,3977,11.925,81888,34194,47694,7.461,17.868,93011,30940,62071,6.751,20.296,-11123,-2.427,35.737,2282,2332,18286
2002,17,218845,273530,5174291,5289864,29625,10.805,30921,11.278,784309,313479,470830,5.926,14.827,1018696,348832,669864,6.594,19.258,-234387,-4.431,29.653,17399,18052,165063
2002,18,103338,133863,2532020,2572700,14321,10.711,14007,10.476,375340,151509,223831,5.889,14.589,455618,139108,316510,5.407,17.710,-80278,-3.120,29.179,7957,8312,63252
2002,19,57334,72839,1229791,1245270,6817,9.342,7079,9.701,162421,64009,98412,5.140,13.043,193083,61300,131783,4.923,15.505,-30662,-2.462,26.086,4038,4179,31271
2002,20,54029,67759,1100667,1109460,7382,10.895,7376,10.886,174018,73317,100701,6.608,15.685,192173,63571,128602,5.730,17.321,-18155,-1.636,31.370,4339,4475,31714
2002,21,64537,82738,1463997,1479235,8811,10.670,8482,10.272,219206,84037,135169,5.681,14.819,249384,73987,175397,5.002,16.859,-30178,-2.040,29.638,5085,5215,35240
2002,22,73119,92824,1575028,1587120,10169,10.992,9553,10.326,258660,103902,154758,6.547,16.297,284203,96284,187919,6.067,17.907,-25543,-1.609,32.595,5640,5857,48685
2002,23,29187,34968,487854,494768,3892,11.142,3817,10.927,70591,28674,41917,5.795,14.267,84324,27958,56366,5.651,17.043,-13733,-2.776,28.535,2314,2347,14773
2002,24,93774,117002,2064390,2080632,14108,12.133,12669,10.895,336973,137710,199263,6.619,16.196,369891,130524,239367,6.273,17.778,-32918,-1.582,32.391,7043,7271,61198
2002,25,126587,155786,2988422,3049692,16620,10.670,16564,10.634,457081,176134,280947,5.775,14.988,581378,197940,383438,6.490,19.064,-124297,-4.076,29.976,9872,10100,88727
2002,26,165834,209883,3867243,3924604,22828,10.840,24225,11.504,626897,264455,362442,6.738,15.974,742796,250277,492519,6.377,18.927,-115899,-2.953,31.947,14047,14430,113873
2002,27,99843,124372,2352400,2377493,13876,11.171,13561,10.917,355967,130366,225601,5.483,14.972,405402,130002,275400,5.468,17.052,-49435,-2.079,29.945,7757,7984,60988
2002,28,42924,54589,913617,920190,6210,11.408,5905,10.848,142402,56950,85452,6.189,15.475,155931,53308,102623,5.793,16.946,-13529,-1.470,30.951,3560,3629,25035
2002,29,104283,131782,2336958,2361443,15678,11.945,14618,11.137,371339,150859,220480,6.388,15.725,418765,142825,275940,6.048,17.733,-47426,-2.008,31.450,8661,8899,70441
2002,30,24288,28376,300494,302291,3260,11.514,3135,11.072,50225,19298,30927,6.384,16.615,53754,18105,35649,5.989,17.782,-3529,-1.167,33.230,1827,1849,9371
2002,31,36622,45174,741112,741844,4590,10.186,4368,9.693,114266,45696,68570,6.160,15.403,115905,35550,80355,4.792,15.624,-1639,-0.221,30.806,2568,2622,17507
2002,32,35571,44182,932464,942493,7049,16.163,5907,13.545,176401,73127,103274,7.759,18.716,198223,62546,135677,6.636,21.032,-21822,-2.315,37.433,3609,3678,28048
2002,33,28420,33945,548719,555838,3574,10.531,3558,10.484,79734,31577,48157,5.681,14.345,94037,29917,64120,5.382,16.918,-14303,-2.573,28.690,2159,2213,15982
2002,34,176332,209444,3585256,3609080,24193,11.559,23894,11.416,608124,220248,387876,6.103,16.850,655016,216292,438724,5.993,18.149,-46892,-1.299,33.700,14500,14769,98802
2002,35,31297,38689,553712,555764,4650,12.028,4592,11.878,98784,40325,58459,7.256,17.774,103117,36006,67111,6.479,18.554,-4333,-0.780,35.549,2585,2647,17389
2002,36,367644,436168,7182568,7272782,50890,11.677,50164,11.511,1178844,491122,687722,6.753,16.209,1360678,513007,847671,7.054,18.709,-181834,-2.500,32.418,29865,30440,220774
2002,37,145722,187122,3327190,3391429,21813,11.682,21008,11.251,509727,212307,297420,6.260,15.030,635444,208318,427126,6.142,18.737,-125717,-3.707,30.060,12258,12639,91722
2002,38,15047,18258,255083,257168,1665,9.114,1685,9.224,36542,16167,20375,6.287,14.209,40583,13563,27020,5.274,15.781,-4041,-1.571,28.419,1014,1033,7110
2002,39,186782,245467,4734689,4824786,24279,9.866,25502,10.363,710125,269617,440508,5.588,14.718,888566,276166,612400,5.724,18.417,-178441,-3.698,29.437,14183,14674,125490
2002,40,62344,77568,1191179,1202627,8881,11.483,8422,10.890,202630,78923,123707,6.563,16.849,225526,82226,143300,6.837,18.753,-22896,-1.904,33.698,4944,5093,39007
2002,41,73593,89904,1327314,1346820,10672,11.873,10639,11.836,213668,81807,131861,6.074,15.865,252541,84362,168179,6.264,18.751,-38873,-2.886,31.729,6375,6521,44938
2002,42,212065,270557,5013367,5060695,26618,9.832,26968,9.961,761888,298796,463092,5.904,15.055,856297,310556,545741,6.137,16.921,-94409,-1.866,30.110,15053,15621,127369
2002,44,22225,25538,417396,416389,2651,10.383,2638,10.332,65336,27478,37858,6.599,15.691,62694,19765,42929,4.747,15.057,2642,0.635,30.113,1565,1581,9757
2002,45,69896,89110,1542987,1576879,10365,11.668,9809,11.042,228745,88570,140175,5.617,14.506,296580,92592,203988,5.872,18.808,-67835,-4.302,29.012,5903,6058,47011
2002,46,18301,21775,304246,309598,2403,11.127,2045,9.469,46127,16570,29557,5.352,14.899,56695,19447,37248,6.281,18.312,-10568,-3.413,29.798,1297,1317,9358
2002,47,90238,119198,2304897,2336910,13295,11.131,13774,11.532,367891,137451,230440,5.882,15.743,432505,144569,287936,6.186,18.508,-64614,-2.765,31.485,7931,8160,62016
2002,48,328340,434118,7973185,8088904,55318,12.800,51405,11.895,1479766,636224,843542,7.865,18.294,1712442,601826,1110616,7.440,21.170,-232676,-2.876,36.588,29609,30721,250137
2002,49,40815,50049,907328,910140,7546,15.252,6398,12.932,166475,65391,101084,7.185,18.291,171944,56881,115063,6.250,18.892,-5469,-0.601,36.582,3685,3758,29958
2002,50,16563,19091,255033,256414,1838,9.591,1983,10.348,37495,14073,23422,5.488,14.623,40127,13533,26594,5.278,15.649,-2632,-1.026,29.246,1172,1198,6417
2002,51,125346,162158,2921941,2941472,19173,11.888,17420,10.801,487007,195312,291695,6.640,16.557,525798,190771,335027,6.486,17.875,-38791,-1.319,33.113,9671,10000,80943
2002,53,118499,145496,2160242,2211298,18212,12.516,18230,12.529,342790,140267,202523,6.343,15.502,445982,141990,303992,6.421,20.168,-103192,-4.667,31.004,10921,11169,75029
2002,54,29408,37042,565662,563454,3619,9.733,3901,10.491,89790,28502,61288,5.058,15.936,85304,27129,58175,4.815,15.139,4486,0.796,30.279,2340,2374,14261
2002,55,102093,127611,2364893,2385709,12785,10.023,12664,9.929,334082,130956,203126,5.489,14.003,377276,113377,263899,4.752,15.814,-43194,-1.811,28.007,7532,7740,56128
2002,56,14150,16395,177836,177834,2056,12.662,1742,10.728,33789,13601,20188,7.648,19.000,33882,12498,21384,7.028,19.053,-93,-0.052,38.001,1051,1062,5918
2003,01,71272,92206,1598244,1589272,9580,10.438,8725,9.507,246112,77042,169070,4.848,15.486,227737,71766,155971,4.516,14.330,18375,1.156,28.659,5859,5935,34103
2003,02,13280,16141,218543,215227,2030,12.780,1517,9.550,40667,14038,26629,6.522,18.895,33713,10194,23519,4.736,15.664,6954,3.231,31.328,929,952,4895
2003,04,84197,107571,1980647,1958096,14564,13.699,12047,11.332,389557,140158,249399,7.158,19.895,347288,130952,216336,6.688,17.736,42269,2.159,35.472,7725,7852,53430
2003,05,46715,58500,982318,976794,6512,11.240,5385,9.295,141164,46662,94502,4.777,14.452,130245,40214,90031,4.117,13.334,10919,1.118,26.668,3724,3789,18225
2003,06,590896,733787,12830723,12743764,91497,12.578,78840,10.838,2258055,769544,1488511,6.039,17.719,2079841,684308,1395533,5.370,16.320,178214,1.398,32.641,51848,53547,362853
2003,08,103270,125394,1902556,1910034,16832,13.572,14078,11.352,317046,121437,195609,6.358,16.599,332009,114951,217058,6.018,17.382,-14963,-0.783,33.198,9080,9227,55833
2003,09,68899,83303,1545100,1544594,7640,9.180,7489,8.998,218542,67591,150951,4.376,14.149,217805,68396,149409,4.428,14.101,737,0.048,28.202,4769,4818,26360
2003,10,17920,22040,382847,384005,2467,11.312,2006,9.198,50758,16939,33819,4.411,13.218,53414,17810,35604,4.638,13.910,-2656,-0.692,26.436,1269,1288,7357
2003,11,14679,18096,414184,414115,1756,9.709,1736,9.599,55243,17310,37933,4.180,13.340,55082,17106,37976,4.131,13.301,161,0.039,26.602,929,938,5317
2003,12,325117,403160,6439730,6361935,59692,15.049,46699,11.773,1233930,449805,784125,7.070,19.396,1076700,430756,645944,6.771,16.924,157230,2.471,33.848,31518,32058,193930
2003,13,145102,186179,3363171,3365811,24171,13.125,20131,10.931,529081,194494,334587,5.779,15.719,534571,176025,358546,5.230,15.882,-5490,-0.163,31.439,12625,12931,77896
2003,15,22738,28347,457726,448200,2936,10.451,2426,8.636,70581,21286,49295,4.749,15.748,51177,19600,31577,4.373,11.418,19404,4.329,22.837,1494,1543,10261
2003,16,29320,34899,465474,459046,4699,13.725,3373,9.852,77814,26787,51027,5.835,16.951,65533,21401,44132,4.662,14.276,12281,2.675,28.552,2228,2269,10267
2003,17,222188,277421,5205622,5189780,29217,10.608,25246,9.166,766018,243842,522176,4.699,14.760,734873,240112,494761,4.627,14.160,31145,0.600,28.320,16067,16410,111784
2003,18,104380,135210,2557760,2544852,13146,9.773,11759,8.742,372308,116891,255417,4.593,14.630,345630,113543,232087,4.462,13.582,26678,1.048,27.163,7583,7825,51450
2003,19,58060,73607,1229709,1229558,6906,9.433,6109,8.345,155742,53877,101865,4.382,12.667,155411,46376,109035,3.772,12.640,331,0.027,25.279,3768,3855,20825
2003,20,54622,68441,1110578,1106648,6957,10.220,6218,9.135,160843,60359,100484,5.454,14.534,152957,49915,103042,4.510,13.822,7886,0.713,27.643,4033,4119,24675
2003,21,64926,83404,1467864,1465741,8050,9.692,7350,8.850,206323,67870,138453,4.630,14.076,203153,62567,140586,4.269,13.860,3170,0.216,27.720,4878,5019,30578
2003,22,74038,93753,1599975,1587813,9372,10.048,8402,9.008,252227,81739,170488,5.148,15.885,227542,72593,154949,4.572,14.331,24685,1.555,28.661,5500,5609,38460
2003,23,29845,35709,490302,488738,3770,10.672,3004,8.504,68190,23733,44457,4.856,13.952,65289,20656,44633,4.226,13.359,2901,0.594,26.717,2015,2044,10473
2003,24,96172,119423,2084435,2074040,13184,11.153,10749,9.093,313711,103898,209813,5.009,15.126,293794,87064,206730,4.198,14.165,19917,0.960,28.331,6738,6893,38683
2003,25,129922,159053,2989134,2991120,17358,11.028,14054,8.929,427836,134802,293034,4.507,14.304,432955,144782,288173,4.840,14.475,-5119,-0.171,28.607,8701,8830,55044
2003,26,167662,212157,3868522,3867965,21822,10.342,19506,9.245,584076,199789,384287,5.165,15.100,584370,173653,410717,4.490,15.108,-294,-0.008,30.201,12680,13078,90490
2003,27,102449,127303,2370896,2360596,14178,11.268,11213,8.912,350741,125644,225097,5.323,14.858,330351,103806,226545,4.397,13.994,20390,0.864,27.989,6995,7095,41273
2003,28,43406,55170,918223,915755,5858,10.676,5264,9.593,140616,49197,91419,5.372,15.355,135902,44633,91269,4.874,14.840,4714,0.515,29.681,3488,3535,21519
2003,29,106619,134409,2375958,2356380,15419,11.587,12738,9.573,343857,103037,240820,4.373,14.593,305474,98334,207140,4.173,12.964,38383,1.629,25.927,8529,8752,49259
2003,30,25132,29264,305796,303067,3444,11.953,2543,8.826,47577,17005,30572,5.611,15.699,42208,12882,29326,4.251,13.927,5369,1.772,27.854,1705,1721,7470
2003,31,37215,45921,758786,749877,4522,9.931,3751,8.238,116824,36681,80143,4.892,15.579,99245,30760,68485,4.102,13.235,17579,2.344,26.470,2403,2442,12461
2003,32,37229,46131,971136,952518,7381,16.367,5312,11.779,173444,60321,113123,6.333,18.209,136293,43051,93242,4.520,14.309,37151,3.900,28.617,3550,3595,23424
2003,33,28793,34415,543133,546033,3566,10.434,3091,9.044,75491,26061,49430,4.773,13.825,80775,22026,58749,4.034,14.793,-5284,-0.968,27.651,2129,2153,11688
2003,34,178706,212019,3585933,3585422,23896,11.341,21284,10.101,562576,181201,381375,5.054,15.691,562145,182987,379158,5.104,15.679,431,0.012,31.357,14382,14578,92190
2003,35,31938,39381,573814,563620,4519,11.579,3814,9.772,99711,36529,63182,6.481,17.691,79817,29406,50411,5.217,14.161,19894,3.530,28.323,2346,2399,13558
2003,36,375880,444537,7297886,7235656,50910,11.563,42419,9.634,1118689,353332,765357,4.883,15.461,993000,317076,675924,4.382,13.724,125689,1.737,27.447,29765,30167,161574
2003,37,147799,189702,3360591,3344304,21188,11.247,18564,9.854,521577,186297,335280,5.571,15.596,489565,158069,331496,4.727,14.639,32012,0.957,29.278,11708,11924,68741
2003,38,15256,18452,261540,258172,1560,8.502,1355,7.384,35821,10010,25811,3.877,13.875,29109,9537,19572,3.694,11.275,6712,2.600,22.550,865,870,4903
2003,39,188067,247022,4754938,4746804,23153,9.404,21534,8.746,674392,212194,462198,4.470,14.207,660718,197601,463117,4.163,13.919,13674,0.288,27.838,13323,13730,87092
2003,40,63032,78422,1177198,1184522,8301,10.646,7406,9.498,174923,58031,116892,4.899,14.767,189705,57109,132596,4.821,16.015,-14782,-1.248,29.535,5053,5105,29577
2003,41,75444,91954,1335399,1330187,10977,12.076,8871,9.759,206601,64057,142544,4.816,15.532,196983,67629,129354,5.084,14.809,9618,0.723,29.617,5706,5803,29994
2003,42,214353,273532,5002913,5007562,25584,9.405,22543,8.288,697443,225958,471485,4.512,13.928,708144,216474,491670,4.323,14.141,-10701,-0.214,27.856,14363,14738,90416
2003,44,22716,26036,423748,420285,2756,10.691,2243,8.701,60844,19175,41669,4.562,14.477,53460,15647,37813,3.723,12.720,7384,1.757,25.440,1441,1480,7418
2003,45,71252,90708,1556307,1549644,10247,11.398,8628,9.597,243171,92843,150328,5.991,15.692,230637,80513,150124,5.196,14.883,12534,0.809,29.766,5633,5719,37300
2003,46,18595,22014,306617,305588,2182,9.969,1931,8.822,41713,13043,28670,4.268,13.650,39659,14179,25480,4.640,12.978,2054,0.672,25.956,1228,1246,6395
2003,47,90982,120230,2303620,2303799,12971,10.837,11904,9.945,352987,130730,222257,5.675,15.322,353596,113745,239851,4.937,15.348,-609,-0.026,30.644,7517,7734,47541
2003,48,333622,440061,8010563,7991474,52926,12.111,46852,10.721,1384796,504031,880765,6.307,17.328,1343386,494371,849015,6.186,16.810,41410,0.518,33.620,29553,30347,212331
2003,49,42694,51956,904007,905036,7837,15.368,5917,11.603,153655,61926,91729,6.842,16.978,154627,57209,97418,6.321,17.085,-972,-0.107,33.956,3836,3913,29994
2003,50,16833,19491,254462,254687,1938,10.050,1524,7.903,34361,10852,23509,4.261,13.491,35082,10934,24148,4.293,13.775,-721,-0.283,26.983,1030,1042,5582
2003,51,128243,165589,2934841,2927557,18869,11.517,15375,9.384,439318,148908,290410,5.086,15.006,426669,142022,284647,4.851,14.574,12649,0.432,29.148,9334,9646,57346
2003,53,121278,148229,2213698,2199741,18213,12.403,15434,10.511,355462,115282,240180,5.241,16.159,328838,108038,220800,4.911,14.949,26624,1.210,29.898,9918,10076,48892
2003,54,29450,37232,560619,562977,3527,9.501,3311,8.919,74957,26273,48684,4.667,13.314,79422,23252,56170,4.130,14.108,-4465,-0.793,26.629,2139,2265,13322
2003,55,103013,128844,2394639,2379028,12010,9.368,10726,8.366,322091,107241,214850,4.508,13.539,290849,85708,205141,3.603,12.226,31242,1.313,24.451,6978,7095,39884
2003,56,14498,16779,182729,180281,1930,11.636,1546,9.321,31766,10018,21748,5.557,17.620,26862,8889,17973,4.931,14.900,4904,2.720,29.800,1037,1058,5051
2004,01,71881,93032,1640291,1619496,9482,10.238,8650,9.340,255807,81489,174318,5.032,15.795,214723,74003,140720,4.570,13.259,41084,2.537,26.517,5685,5763,35949
2004,02,13403,16263,223624,221056,1851,11.425,1729,10.672,35389,9758,25631,4.414,16.009,30299,11379,18920,5.148,13.706,5090,2.303,27.413,1047,1080,5133
2004,04,86226,110265,2043400,2010553,14607,13.408,11958,10.977,365936,130854,235082,6.508,18.201,299242,117503,181739,5.844,14.884,66694,3.317,29.767,7558,7775,50593
2004,05,47156,59087,997508,990164,6150,10.460,5564,9.464,144870,47603,97267,4.808,14.631,130795,45449,85346,4.590,13.209,14075,1.421,26.419,3841,3901,20819
2004,06,596558,740326,12994198,12908197,88882,12.058,82476,11.189,2148517,729566,1418951,5.652,16.645,1988329,739716,1248613,5.731,15.404,160188,1.241,30.807,53557,55107,378452
2004,08,104249,126799,1919960,1909934,16208,12.853,14807,11.742,304784,115689,189095,6.057,15.958,285322,104280,181042,5.460,14.939,19462,1.019,29.878,9466,9613,53030
2004,09,68887,83673,1547834,1546456,7755,9.288,7404,8.867,204043,67442,136601,4.361,13.194,201349,65747,135602,4.251,13.020,2694,0.174,26.040,4715,4772,26564
2004,10,18180,22451,392829,387963,2555,11.489,2130,9.578,60626,23206,37420,5.982,15.627,50812,20061,30751,5.171,13.097,9814,2.530,26.194,1317,1337,7743
2004,11,14866,18436,423254,418759,2042,11.178,1707,9.344,59532,19368,40164,4.625,14.216,50392,15046,35346,3.593,12.034,9140,2.183,24.067,977,1009,6240
2004,12,339873,419733,6695620,6598645,65051,15.809,48551,11.799,1250635,439583,811052,6.662,18.953,1061257,396331,664926,6.006,16.083,189378,2.870,32.166,32394,33161,212622
2004,13,148417,190184,3432294,3399537,23736,12.613,19749,10.494,563583,195356,368227,5.747,16.578,498699,178366,320333,5.247,14.670,64884,1.909,29.339,12637,12850,76867
2004,15,23112,28822,471081,464351,2843,9.945,2374,8.304,63706,19913,43793,4.288,13.719,50616,15457,35159,3.329,10.900,13090,2.819,21.801,1545,1582,8904
2004,16,30147,35816,484764,475099,4558,12.892,3637,10.287,84554,39033,45521,8.216,17.797,64981,23369,41612,4.919,13.677,19573,4.120,27.355,2271,2298,12152
2004,17,223131,278538,5218721,5212727,28284,10.175,27168,9.773,728535,225504,503031,4.326,13.976,714711,236837,477874,4.543,13.711,13824,0.265,27.422,16792,17514,112876
2004,18,104770,136188,2587918,2573121,13048,9.615,12074,8.898,353842,112974,240868,4.391,13.751,323095,110985,212110,4.313,12.557,30747,1.195,25.113,7866,8123,51563
2004,19,58052,73575,1242741,1235941,6338,8.612,6376,8.664,158335,45815,112520,3.707,12.811,144396,48730,95666,3.943,11.683,13939,1.128,23.366,4040,4122,21794
2004,20,55034,68868,1116932,1113852,6768,9.861,6305,9.186,146252,51371,94881,4.612,13.130,140567,44592,95975,4.003,12.620,5685,0.510,25.240,4030,4117,22869
2004,21,65186,83794,1487269,1477970,7968,9.531,7577,9.064,208019,69231,138788,4.684,14.075,189462,68392,121070,4.627,12.819,18557,1.256,25.638,4903,5063,34875
2004,22,74539,94349,1618140,1609420,9083,9.658,8476,9.013,236192,69614,166578,4.325,14.676,219288,67957,151331,4.222,13.625,16904,1.050,27.251,5513,5637,37001
2004,23,29971,35880,495443,492715,3572,9.979,3401,9.501,61242,19070,42172,3.870,12.429,55808,19432,36376,3.944,11.327,5434,1.103,22.653,2284,2320,12011
2004,24,97577,121015,2149024,2118227,13069,10.870,11493,9.559,328390,106150,222240,5.011,15.503,265916,96743,169173,4.567,12.554,62474,2.949,25.107,7163,7282,42938
2004,25,127654,156981,2983208,2987823,15228,9.636,17335,10.969,384071,128549,255522,4.302,12.855,394557,135059,259498,4.520,13.206,-10486,-0.351,25.709,12087,12248,58438
2004,26,167064,210962,3864355,3865466,20447,9.664,21677,10.245,542138,189961,352177,4.914,14.025,545869,198840,347029,5.144,14.122,-3731,-0.097,28.050,13256,13870,96046
2004,27,103411,128625,2379456,2376393,13535,10.576,12236,9.561,310847,96189,214658,4.048,13.081,304992,105635,199357,4.445,12.834,5855,0.246,25.668,7551,7724,46611
2004,28,43649,55603,931113,924636,5572,10.060,5138,9.277,134308,44927,89381,4.859,14.526,120673,41177,79496,4.453,13.051,13635,1.475,26.102,3447,3508,19597
2004,29,108469,136650,2401779,2390041,15697,11.582,13455,9.928,345079,120781,224298,5.054,14.438,321914,116685,205229,4.882,13.469,23165,0.969,26.938,9016,9140,50593
2004,30,25750,29901,315497,310574,3601,12.176,2950,9.974,48856,16163,32693,5.204,15.731,38772,15996,22776,5.150,12.484,10084,3.247,24.968,1862,1893,8755
2004,31,37341,46052,757020,757684,4114,8.946,3987,8.670,94307,32758,61549,4.323,12.447,95309,24954,70355,3.293,12.579,-1002,-0.132,24.894,2547,2607,13926
2004,32,38709,47888,1022416,997252,7490,15.934,5725,12.179,184417,66943,117474,6.713,18.493,134083,53694,80389,5.384,13.445,50334,5.047,26.891,3741,3846,27919
2004,33,29082,34793,550596,547026,3585,10.360,3206,9.265,68768,21979,46789,4.018,12.571,62002,21309,40693,3.895,11.334,6766,1.237,22.669,2128,2177,12064
2004,34,179531,211942,3621477,3608880,23295,10.987,23443,11.057,565152,180247,384905,4.995,15.660,541715,209611,332104,5.808,15.011,23437,0.649,30.021,14882,15052,86330
2004,35,32277,39755,582046,577862,4303,10.875,3926,9.923,91546,31056,60490,5.374,15.842,83058,31250,51808,5.408,14.373,8488,1.469,28.747,2490,2521,12963
2004,36,377861,447306,7368435,7351581,50593,11.345,47905,10.742,1059897,346016,713881,4.707,14.417,1026305,347821,678484,4.731,13.960,33592,0.457,27.921,32120,32579,178401
2004,37,150121,192488,3378984,3367045,21086,11.034,18323,9.588,496056,166452,329604,4.944,14.733,475867,162919,312948,4.839,14.133,20189,0.600,28.266,11612,11863,74174
2004,38,15389,18607,267647,264565,1595,8.609,1435,7.745,33308,10305,23003,3.895,12.590,27203,9447,17756,3.571,10.282,6105,2.308,20.564,932,938,4798
2004,39,187121,246569,4733723,4744818,22037,8.929,22524,9.126,615263,200670,414593,4.229,12.967,637351,227976,409375,4.805,13.433,-22088,-0.466,25.934,13899,14480,103673
2004,40,63612,79271,1187103,1182310,8249,10.462,7400,9.385,177740,59229,118511,5.010,15.033,168215,57664,110551,4.877,14.228,9525,0.806,28.455,4859,4971,28290
2004,41,76355,93147,1350553,1343722,10480,11.323,9302,10.050,190270,66218,124052,4.928,14.160,176692,67185,109507,5.000,13.149,13578,1.010,26.299,6011,6111,32471
2004,42,215227,274413,5060561,5032371,24590,8.975,23730,8.661,674877,205927,468950,4.092,13.411,620613,215352,405261,4.279,12.332,54264,1.078,24.665,14817,15125,95185
2004,44,23091,26532,437219,431347,2825,10.748,2329,8.861,61960,19455,42505,4.510,14.364,50516,16164,34352,3.747,11.711,11444,2.653,23.422,1572,1579,8536
2004,45,72314,92149,1571651,1565113,10038,10.979,8599,9.405,224181,78178,146003,4.995,14.324,212461,70827,141634,4.525,13.575,11720,0.749,27.150,5673,5776,35646
2004,46,18793,22256,311882,309025,2170,9.802,1933,8.732,45014,13623,31391,4.408,14.566,39015,16088,22927,5.206,12.625,5999,1.941,25.250,1233,1240,5327
2004,47,92139,121661,2341795,2323957,12663,10.469,11247,9.299,342991,113859,229132,4.899,14.759,307616,105543,202073,4.542,13.237,35375,1.522,26.473,7184,7393,46180
2004,48,337106,445350,8095531,8053271,52327,11.820,47057,10.629,1350832,506637,844195,6.291,16.774,1273284,466074,807210,5.787,15.811,77548,0.963,31.622,30260,31079,212206
2004,49,44027,53479,922408,912300,7734,14.669,6223,11.803,172837,64770,108067,7.100,18.945,152226,67593,84633,7.409,16.686,20611,2.259,33.372,3947,3992,23877
2004,50,16934,19567,253254,254157,1775,9.089,1701,8.710,27512,9368,18144,3.686,10.825,29478,9353,20125,3.680,11.598,-1966,-0.774,21.650,1082,1095,4843
2004,51,131616,169748,3040487,2989903,19267,11.490,15145,9.032,481114,157038,324076,5.252,16.091,378490,126051,252439,4.216,12.659,102624,3.432,25.318,9369,9555,55523
2004,53,122924,150468,2258893,2236461,17835,11.941,15626,10.462,335244,107219,228025,4.794,14.990,291267,96768,194499,4.327,13.024,43977,1.966,26.047,10042,10225,51053
2004,54,29567,37456,568765,564456,3467,9.285,3235,8.664,77255,25297,51958,4.482,13.687,68998,24078,44920,4.266,12.224,8257,1.463,24.448,2123,2180,10875
2004,55,103194,129387,2436575,2415061,11412,8.839,10869,8.418,313800,94458,219342,3.911,12.993,269885,90445,179440,3.745,11.175,43915,1.818,22.350,7006,7231,41162
2004,56,14650,16929,188677,185716,1835,10.887,1687,10.009,30699,9346,21353,5.032,16.530,24816,9265,15551,4.989,13.362,5883,3.168,26.725,1030,1036,4511
2005,01,72498,94168,1676828,1658910,9686,10.349,8529,9.113,266368,82488,183880,4.972,16.057,232113,73038,159075,4.403,13.992,34255,2.065,27.984,5690,5796,32280
2005,02,13563,16557,226934,223533,1896,11.557,1592,9.704,35672,10786,24886,4.825,15.958,28800,7501,21299,3.356,12.884,6872,3.074,25.768,1021,1051,4914
2005,04,89389,114844,2165845,2105323,16292,14.473,11745,10.433,412971,160645,252326,7.630,19.616,293674,100703,192971,4.783,13.949,119297,5.666,27.898,7595,7839,49713
2005,05,47514,59907,1013674,1005744,6404,10.763,5593,9.400,137334,46309,91025,4.604,13.655,121740,38203,83537,3.798,12.104,15594,1.550,24.209,3985,4043,22775
2005,06,607244,755021,13188704,13102781,95264,12.740,80694,10.792,2092562,755202,1337360,5.764,15.970,1916073,632111,1283962,4.824,14.623,176489,1.347,29.247,54415,55738,352563
2005,08,106957,130182,1941161,1932397,17595,13.693,14232,11.075,300147,113595,186552,5.878,15.532,282921,96354,186567,4.986,14.641,17226,0.891,29.282,9269,9421,50351
2005,09,69225,84146,1522183,1534658,8209,9.782,7751,9.237,183845,73125,110720,4.765,11.980,207765,73679,134086,4.801,13.538,-23920,-1.559,23.959,4810,4873,28735
2005,10,18371,22564,397531,394824,2417,10.741,2296,10.203,56787,19318,37469,4.893,14.383,51338,19469,31869,4.931,13.003,5449,1.380,26.006,1351,1369,9635
2005,11,14997,18653,424610,423942,1881,10.142,1667,8.988,54084,18226,35858,4.299,12.757,53190,16042,37148,3.784,12.547,894,0.211,25.093,904,926,6031
2005,12,354930,437291,6816481,6754062,67808,15.823,50318,11.742,1236779,492496,744283,7.292,18.312,1116436,449868,666568,6.661,16.530,120343,1.782,33.060,33430,33952,221660
2005,13,152053,194852,3482432,3458259,24969,12.968,20350,10.569,546890,202928,343962,5.868,15.814,499635,169969,329666,4.915,14.448,47255,1.366,28.895,13090,13351,80304
2005,15,23549,29458,486951,479039,2999,10.289,2376,8.152,72019,27299,44720,5.699,15.034,55977,16762,39215,3.499,11.685,16042,3.349,23.371,1521,1581,8299
2005,16,31701,37572,515745,500548,5255,14.321,3501,9.541,93806,37836,55970,7.559,18.741,62914,20020,42894,4.000,12.569,30892,6.172,25.138,2302,2336,13181
2005,17,225393,281928,5232920,5225127,30357,10.832,27004,9.636,714423,258794,455629,4.953,13.673,698080,223009,475071,4.268,13.360,16343,0.313,26.720,17160,17575,116844
2005,18,104870,136834,2613129,2600931,13013,9.532,12371,9.062,338610,115312,223298,4.433,13.019,315316,95371,219945,3.667,12.123,23294,0.896,24.246,8129,8375,53248
2005,19,58349,74099,1265893,1254312,6539,8.856,6017,8.149,156234,50544,105690,4.030,12.456,133250,39102,94148,3.117,10.623,22984,1.832,21.247,4047,4132,21389
2005,20,55440,69429,1123505,1120570,6769,9.789,6213,8.985,151189,50246,100943,4.484,13.492,145242,50778,94464,4.531,12.961,5947,0.531,25.923,4105,4193,22780
2005,21,65573,84622,1515628,1503178,8308,9.865,7496,8.901,213979,68952,145027,4.587,14.235,188998,53885,135113,3.585,12.573,24981,1.662,25.146,5070,5177,30017
2005,22,74693,94848,1612563,1615781,9238,9.766,8736,9.235,240026,74217,165809,4.593,14.855,245594,87746,157848,5.431,15.200,-5568,-0.345,29.710,5746,5918,43404
2005,23,30287,36334,497994,496736,3692,10.224,3244,8.984,62089,21300,40789,4.288,12.499,59583,17790,41793,3.581,11.995,2506,0.504,23.990,2135,2153,9970
2005,24,99462,123282,2169978,2161350,13965,11.431,11731,9.603,308098,110662,197436,5.120,14.255,291306,95175,196131,4.403,13.478,16792,0.777,26.956,7336,7454,48389
2005,25,126904,156793,3002196,2994227,15445,9.844,15660,9.981,380461,128633,251828,4.296,12.706,362929,124264,238665,4.150,12.121,17532,0.586,24.242,10446,10607,56902
2005,26,167169,211737,3794330,3828750,21105,9.985,20355,9.630,509739,189512,320227,4.950,13.313,578242,152314,425928,3.978,15.103,-68503,-1.789,26.627,13382,13656,88397
2005,27,104756,130426,2418233,2398772,13556,10.466,11755,9.075,319987,110916,209071,4.624,13.340,280332,85239,195093,3.553,11.686,39655,1.653,23.373,7485,7585,43337
2005,28,43657,55860,926453,928951,5696,10.221,5438,9.758,124133,42399,81734,4.564,13.363,128833,41712,87121,4.490,13.869,-4700,-0.506,26.725,3574,3648,22598
2005,29,110344,139240,2397995,2399850,16060,11.642,13476,9.769,311001,115450,195551,4.811,12.959,315508,89611,225897,3.734,13.147,-4507,-0.188,25.918,9328,9497,51537
2005,30,26473,30733,326937,321150,3638,11.998,2815,9.284,52094,21218,30876,6.607,16.221,40580,11964,28616,3.725,12.636,11514,3.585,25.272,1856,1882,7597
2005,31,37657,46507,771333,764771,4293,9.275,3848,8.314,104124,32489,71635,4.248,13.615,91136,27166,63970,3.552,11.917,12988,1.698,23.834,2498,2554,13518
2005,32,40284,49926,1086851,1054532,7870,16.114,5695,11.661,200289,71338,128951,6.765,18.993,135558,52342,83216,4.964,12.855,64731,6.138,25.710,3870,3951,34963
2005,33,29356,35266,553296,551703,3679,10.502,3210,9.163,70736,26534,44202,4.809,12.821,67259,19955,47304,3.617,12.191,3477,0.630,24.382,2212,2234,13157
2005,34,181311,214140,3599452,3612764,24747,11.615,22604,10.609,508113,182308,325805,5.046,14.064,535405,193559,341846,5.358,14.820,-27292,-0.755,28.129,15077,15263,89228
2005,35,32767,40531,598659,589956,4535,11.298,3754,9.352,99624,34677,64947,5.878,16.887,82115,24828,57287,4.208,13.919,17509,2.968,27.838,2440,2494,15184
2005,36,382336,450466,7353387,7363020,50880,11.334,47805,10.649,997501,365587,631914,4.965,13.547,1017792,335425,682367,4.556,13.823,-20291,-0.276,27.095,32043,32445,179724
2005,37,153283,196319,3406990,3392694,22535,11.592,18701,9.620,506003,186670,319333,5.502,14.914,479170,152527,326643,4.496,14.124,26833,0.791,28.247,12110,12408,74357
2005,38,15547,18847,272552,270081,1718,9.178,1462,7.810,34886,10657,24229,3.946,12.917,30074,10925,19149,4.045,11.135,4812,1.782,22.270,977,988,4728
2005,39,186748,247091,4746328,4740745,22576,9.146,22087,8.948,644803,223224,421579,4.709,13.601,633729,189886,443843,4.005,13.368,11074,0.234,26.735,14161,14501,96362
2005,40,64324,80516,1215626,1202001,8695,10.884,7446,9.320,182442,68515,113927,5.700,15.178,155715,50782,104933,4.225,12.955,26727,2.224,25.909,5104,5205,30045
2005,41,78674,95825,1400785,1375821,11805,12.493,9148,9.681,213589,77470,136119,5.631,15.524,163255,57287,105968,4.164,11.866,50334,3.658,23.732,5912,6065,30045
2005,42,216434,276717,5074961,5072094,26398,9.579,24127,8.755,643241,231498,411743,4.564,12.682,637250,199761,437489,3.938,12.564,5991,0.118,25.128,15423,15792,88880
2005,44,23200,26744,441483,439978,2751,10.326,2546,9.557,54086,20219,33867,4.595,12.293,50962,15610,35352,3.548,11.583,3124,0.710,23.166,1688,1696,9209
2005,45,73813,94313,1596335,1583683,10878,11.668,8708,9.341,234622,86419,148203,5.457,14.815,209214,65193,144021,4.117,13.211,25408,1.604,26.421,5859,5968,35012
2005,46,19082,22565,316776,314076,2191,9.777,1882,8.398,40547,10938,29609,3.483,12.910,35356,10990,24366,3.499,11.257,5191,1.653,22.514,1222,1241,5595
2005,47,92897,123236,2363733,2352894,13119,10.713,11553,9.435,334433,111530,222903,4.740,14.214,312673,93697,218976,3.982,13.289,21760,0.925,26.578,7630,7840,47298
2005,48,341890,453122,8272885,8190726,53673,11.947,45985,10.235,1348716,505057,843659,6.166,16.466,1185849,377079,808770,4.604,14.478,162867,1.988,28.956,30071,30859,204076
2005,49,45946,55648,963886,943519,8357,15.315,6196,11.355,176803,61455,115348,6.513,18.739,135498,49094,86404,5.203,14.361,41305,4.378,28.722,3975,4052,24879
2005,50,17026,19722,258994,256266,1830,9.313,1687,8.585,33837,10654,23183,4.157,13.204,28211,9065,19146,3.537,11.009,5626,2.195,22.017,1107,1119,5536
2005,51,134712,173479,3065813,3051650,19816,11.546,16125,9.395,446075,157820,288255,5.172,14.618,417213,127887,289326,4.191,13.672,28862,0.946,27.343,10094,10383,57067
2005,53,126412,154517,2319871,2289645,19743,12.947,15700,10.295,364802,123907,240895,5.412,15.933,303091,102525,200566,4.478,13.237,61711,2.695,26.475,10072,10286,50918
2005,54,29552,37599,569965,569325,3581,9.543,3435,9.154,75287,24196,51091,4.250,13.224,73982,21203,52779,3.724,12.995,1305,0.229,25.989,2305,2332,10950
2005,55,104201,130958,2451635,2441388,12155,9.337,10591,8.136,304570,96877,207693,3.968,12.475,283645,84870,198775,3.476,11.618,20925,0.857,23.236,7094,7289,43416
2005,56,14995,17396,194348,191822,2053,11.962,1587,9.247,31568,10906,20662,5.685,16.457,26420,8032,18388,4.187,13.773,5148,2.684,27.546,1106,1114,5168
2006,01,73345,96404,1724262,1700413,10751,11.283,8516,8.937,269887,104640,165247,6.154,15.872,221775,66760,155015,3.926,13.042,48112,2.829,26.085,5971,6089,35760
2006,02,13802,17020,241991,236082,2170,12.926,1705,10.156,41048,11539,29509,4.888,17.387,29467,8829,20638,3.740,12.482,11581,4.905,24.963,1128,1149,5071
2006,04,94666,122344,2341793,2256370,19578,16.508,12077,10.184,459179,176583,282596,7.826,20.350,287229,103425,183804,4.584,12.730,171950,7.621,25.459,8079,8260,54359
2006,05,47863,61116,1044049,1028867,7110,11.751,5894,9.741,146105,51794,94311,5.034,14.201,115419,34890,80529,3.391,11.218,30686,2.983,22.436,4212,4298,21297
2006,06,624976,780552,13759031,13503175,105904,13.794,80265,10.455,2354901,872469,1482432,6.461,17.440,1843103,612295,1230808,4.534,13.649,511798,3.790,27.299,55854,56895,331123
2006,08,110063,134607,2027153,1984945,19390,14.645,14971,11.308,350069,137915,212154,6.948,17.636,265757,97061,168696,4.890,13.389,84312,4.248,26.777,9833,9973,51997
2006,09,69413,85170,1547808,1535564,8876,10.484,7853,9.276,207815,75220,132595,4.899,13.533,182716,63516,119200,4.136,11.899,25099,1.635,23.798,5407,5511,31312
2006,10,18394,22759,389499,392689,2676,11.805,2496,11.011,55598,20737,34861,5.281,14.158,62033,26241,35792,6.682,15.797,-6435,-1.639,28.317,1661,1697,8656
2006,11,15300,19205,435690,430177,2197,11.607,1642,8.675,63234,21200,42034,4.928,14.700,51832,14686,37146,3.414,12.049,11402,2.651,24.098,936,947,6069
2006,12,369695,456494,7194770,7007463,71529,16.006,52303,11.704,1314367,501650,812717,7.159,18.757,945746,355284,590462,5.070,13.496,368621,5.260,26.993,36474,37011,205763
2006,13,157057,201960,3616984,3552597,27599,13.910,20494,10.329,601244,232444,368800,6.543,16.924,474519,167038,307481,4.702,13.357,126725,3.567,26.714,13691,13959,84263
2006,15,24160,30509,511322,499101,3384,11.286,2335,7.787,76172,27982,48190,5.606,15.262,51593,15250,36343,3.055,10.337,24579,4.925,20.674,1578,1608,8893
2006,16,33786,40021,544764,530805,6277,16.181,3822,9.852,95060,34932,60128,6.581,17.909,67385,24439,42946,4.604,12.695,27675,5.214,25.390,2656,2685,17184
2006,17,228450,287173,5354916,5297928,32818,11.534,27544,9.680,789981,284173,505808,5.364,14.911,676968,239428,437540,4.519,12.778,113013,2.133,25.556,18053,18414,121730
2006,18,105873,139144,2667214,2641905,14927,10.817,12622,9.147,368528,130153,238375,4.926,13.949,317170,98300,218870,3.721,12.005,51358,1.944,24.011,8208,8381,49466
2006,19,58285,75096,1299497,1282843,7749,10.388,6754,9.054,167903,58433,109470,4.555,13.088,134410,38823,95587,3.026,10.478,33493,2.611,20.955,4635,4743,21625
2006,20,55589,70131,1161431,1144858,7521,10.780,6797,9.742,166420,58043,108377,5.070,14.536,132626,41734,90892,3.645,11.584,33794,2.952,23.169,4618,4720,22761
2006,21,65961,85813,1548930,1531950,8914,10.462,7701,9.038,219018,73983,145035,4.829,14.297,185369,59845,125524,3.906,12.100,33649,2.196,24.200,5253,5344,29496
2006,22,72037,92606,1590450,1601522,10419,11.117,12654,13.501,274611,97874,176737,6.111,17.147,298386,101016,197370,6.308,18.631,-23775,-1.485,34.294,7532,7692,46025
2006,23,30649,37072,506374,502520,4279,11.659,3538,9.640,66219,26027,40192,5.179,13.177,58586,19019,39567,3.785,11.658,7633,1.519,23.317,2538,2562,11031
2006,24,101583,126626,2238793,2204514,15231,12.189,11896,9.520,345791,125435,220356,5.690,15.686,277863,95359,182504,4.326,12.604,67928,3.081,25.209,7899,8033,45072
2006,25,128551,159623,3071698,3038100,17117,10.820,14267,9.018,437210,149366,287844,4.916,14.391,372198,121787,250411,4.009,12.251,65012,2.140,24.502,9538,9697,58531
2006,26,167342,213056,3783131,3782494,22539,10.612,21220,9.991,527127,182404,344723,4.822,13.936,525416,175876,349540,4.650,13.891,1711,0.045,27.781,14416,14656,83760
2006,27,106159,133386,2472336,2445836,15557,11.794,12602,9.554,346083,120910,225173,4.944,14.150,292293,94545,197748,3.866,11.951,53790,2.199,23.901,8440,8588,48751
2006,28,43357,56021,946575,937424,6290,11.244,6132,10.961,147923,54866,93057,5.853,15.780,130318,42600,87718,4.544,13.902,17605,1.878,27.803,3982,4061,21448
2006,29,109793,140297,2444604,2420599,16546,11.840,15457,11.060,354098,128524,225574,5.310,14.629,304536,99495,205041,4.110,12.581,49562,2.048,25.162,11067,11281,52596
2006,30,27504,31992,338722,333236,4306,13.730,3046,9.712,55217,20725,34492,6.219,16.570,44133,13575,30558,4.074,13.244,11084,3.326,26.488,2073,2098,8738
2006,31,37817,47151,785755,778747,4847,10.351,4200,8.969,102736,39871,62865,5.120,13.192,88110,26385,61725,3.388,11.314,14626,1.878,22.629,2851,2917,14170
2006,32,42473,53024,1166694,1127755,8941,17.374,5816,11.302,222676,86255,136421,7.648,19.745,147051,47839,99212,4.242,13.039,75625,6.706,26.079,4117,4168,25984
2006,33,29579,35781,573133,563639,3925,11.049,3410,9.599,84719,28811,55908,5.112,15.031,65627,20942,44685,3.716,11.643,19092,3.387,23.287,2409,2444,11293
2006,34,183959,218604,3687225,3644950,26650,12.317,22174,10.248,564922,211118,353804,5.792,15.499,479433,156540,322893,4.295,13.153,85489,2.345,26.307,15730,15878,79701
2006,35,33546,41668,633716,616099,5172,12.583,4040,9.829,112560,40476,72084,6.570,18.270,77204,27220,49984,4.418,12.531,35356,5.739,25.062,2702,2738,15209
2006,36,386157,457427,7514794,7439456,54437,11.992,47480,10.459,1076308,381885,694423,5.133,14.468,925228,304210,621018,4.089,12.437,151080,2.031,24.874,34672,35056,184404
2006,37,156967,202952,3532008,3472340,25367,12.707,18724,9.379,562714,213263,349451,6.142,16.206,443526,150136,293390,4.324,12.773,119188,3.432,25.546,12832,13052,71323
2006,38,15654,19142,281976,277230,1969,10.367,1671,8.798,39212,13591,25621,4.902,14.144,29791,9532,20259,3.438,10.746,9421,3.398,21.492,1136,1149,5229
2006,39,186238,248829,4807159,4777170,24809,10.005,23066,9.302,662174,234857,427317,4.916,13.861,603342,200697,402645,4.201,12.630,58832,1.232,25.259,15161,15537,93543
2006,40,65211,81997,1278365,1247472,9406,11.577,7913,9.739,212408,80308,132100,6.438,17.027,150618,52693,97925,4.224,12.074,61790,4.953,24.148,5307,5457,27703
2006,41,81131,99304,1457010,1429473,12800,13.119,9324,9.557,225981,80927,145054,5.661,15.809,171338,52230,119108,3.654,11.986,54643,3.823,23.972,6470,6525,30453
2006,42,216686,280077,5192638,5135514,27940,10.036,24569,8.825,694399,251844,442555,4.904,13.522,580718,183542,397176,3.574,11.308,113681,2.214,22.616,16608,17057,94634
2006,44,23501,27251,441952,441675,3079,11.406,2565,9.502,61167,22917,38250,5.189,13.849,60807,16163,44644,3.659,13.767,360,0.082,27.535,1735,1774,8778
2006,45,75521,97116,1651182,1624469,11762,12.289,8948,9.349,259768,97193,162575,5.983,15.991,207185,65344,141841,4.022,12.754,52583,3.237,25.508,6162,6317,33248
2006,46,19292,22910,329714,323215,2532,11.136,2187,9.618,46009,15857,30152,4.906,14.235,33086,10436,22650,3.229,10.237,12923,3.998,20.473,1527,1559,6699
2006,47,94108,125784,2453162,2409781,14492,11.640,11922,9.576,375863,134216,241647,5.570,15.597,289054,92171,196883,3.825,11.995,86809,3.602,23.990,7808,8027,45179
2006,48,348242,465892,8717159,8501687,59710,12.995,46920,10.211,1544067,569954,974113,6.704,18.162,1115932,396928,719004,4.669,13.126,428135,5.036,26.252,30882,31668,192297
2006,49,48906,59285,1027781,996278,9759,16.982,6122,10.653,185138,65917,119221,6.616,18.583,122153,39355,82798,3.950,12.261,62985,6.322,24.522,4126,4218,23987
2006,50,17123,19944,262088,260645,2002,10.096,1774,8.946,30815,9892,20923,3.795,11.823,27858,8334,19524,3.197,10.688,2957,1.134,21.376,1271,1283,5252
2006,51,138321,179667,3194747,3133182,22455,12.718,16255,9.206,512455,182270,330185,5.817,16.356,389669,119431,270238,3.812,12.437,122786,3.919,24.874,10934,11102,61078
2006,53,130224,159924,2419649,2371873,21607,13.743,16203,10.306,402524,142122,260402,5.992,16.971,309132,94198,214934,3.971,13.033,93392,3.937,26.066,11092,11256,53032
2006,54,29418,37777,589850,580694,3786,10.045,3614,9.588,86551,30601,55950,5.270,14.905,68320,21458,46862,3.695,11.765,18231,3.140,23.530,2478,2518,12056
2006,55,104396,132550,2482644,2471147,13489,10.238,11895,9.028,312323,110116,202207,4.456,12.639,287731,84488,203243,3.419,11.644,24592,0.995,23.287,8166,8314,44392
2006,56,15420,17896,206698,201228,2307,13.075,1805,10.230,36793,12499,24294,6.211,18.284,25875,8742,17133,4.344,12.859,10918,5.426,25.717,1194,1206,5446
2007,01,74184,97866,1716764,1720833,10872,11.195,9368,9.646,257701,92859,164842,5.396,14.975,266336,90437,175899,5.255,15.477,-8635,-0.502,29.951,5865,6070,36366
2007,02,13832,17173,244515,243170,2047,11.979,1877,10.984,42930,14833,28097,6.100,17.654,40084,9689,30395,3.984,16.484,2846,1.170,32.968,1150,1166,4875
2007,04,97172,126169,2388460,2365054,18193,14.643,14343,11.544,448528,156379,292149,6.612,18.965,402595,129886,272709,5.492,17.023,45933,1.942,34.045,9168,9343,59043
2007,05,48019,61720,1027259,1035807,6666,10.857,6020,9.805,143975,50574,93401,4.883,13.900,160749,49037,111712,4.734,15.519,-16774,-1.619,27.800,4037,4082,22950
2007,06,632951,791088,13722807,13744916,100731,12.820,89983,11.452,2183108,756574,1426534,5.504,15.883,2227586,758588,1468998,5.519,16.207,-44478,-0.324,31.766,58485,59569,366650
2007,08,112061,137459,2063393,2047199,18959,13.939,16068,11.814,358717,132312,226405,6.463,17.522,326577,115638,210939,5.649,15.952,32140,1.570,31.905,10233,10343,54419
2007,09,68918,85116,1525608,1537524,8250,9.691,8281,9.727,208681,74793,133888,4.865,13.573,231610,65233,166377,4.243,15.064,-22929,-1.491,27.145,5207,5286,31678
2007,10,18147,22779,386067,387784,2626,11.531,2614,11.479,65749,28632,37117,7.383,16.955,69603,26525,43078,6.840,17.949,-3854,-0.994,33.910,1522,1527,10100
2007,11,15377,19406,435401,435804,2105,10.905,1899,9.838,70339,21849,48490,5.013,16.140,71596,22010,49586,5.050,16.429,-1257,-0.288,32.280,1003,1010,6928
2007,12,372826,462192,7189491,7206552,67644,14.728,61864,13.469,1228049,488967,739082,6.785,17.041,1270068,478555,791513,6.641,17.624,-42019,-0.583,34.081,41654,42340,251099
2007,13,160393,206749,3627467,3624247,27656,13.535,22827,11.171,579595,227107,352488,6.266,15.992,572067,202064,370003,5.575,15.784,7528,0.208,31.569,14519,14919,90753
2007,15,24305,30693,515993,513432,3102,10.138,2914,9.523,76377,25404,50973,4.948,14.876,71318,26707,44611,5.202,13.890,5059,0.985,27.781,1761,1822,12360
2007,16,35059,41605,546154,545413,5882,14.416,4274,10.475,94070,35561,58509,6.520,17.247,93066,29472,63594,5.404,17.063,1004,0.184,34.127,2935,2960,16839
2007,17,229079,288797,5355328,5355780,31231,10.846,29512,10.249,779812,271507,508305,5.069,14.560,780892,253211,527681,4.728,14.580,-1080,-0.020,29.120,18281,18564,117465
2007,18,105735,139821,2638895,2652795,14204,10.186,13453,9.647,366079,123440,242639,4.653,13.800,394527,118295,276232,4.459,14.872,-28448,-1.072,27.599,8571,8754,56705
2007,19,58272,75314,1295861,1297230,6767,8.999,6530,8.684,161660,49340,112320,3.803,12.462,164563,50775,113788,3.914,12.686,-2903,-0.224,24.924,4145,4209,23239
2007,20,55667,70546,1178149,1170130,7152,10.170,6714,9.547,171101,62181,108920,5.314,14.622,155384,50811,104573,4.342,13.279,15717,1.343,26.558,4264,4340,24644
2007,21,65874,86253,1540865,1545524,8712,10.130,8203,9.539,219217,76607,142610,4.957,14.184,228635,66078,162557,4.275,14.793,-9418,-0.609,28.368,5261,5340,33214
2007,22,74803,95891,1638565,1614917,11861,12.589,8519,9.042,284734,92265,192469,5.713,17.631,236990,71925,165065,4.454,14.675,47744,2.956,29.350,5239,5320,33368
2007,23,30701,37362,501323,503767,3986,10.712,3680,9.890,66996,23797,43199,4.724,13.299,72038,26542,45496,5.269,14.300,-5042,-1.001,26.598,2447,2463,13793
2007,24,101865,127385,2232716,2236085,14130,11.127,13342,10.506,329307,108821,220486,4.867,14.727,336983,107976,229007,4.829,15.070,-7676,-0.343,29.454,8356,8476,48046
2007,25,127903,159402,3067725,3066170,15642,9.808,15818,9.918,413189,128260,284929,4.183,13.476,409056,130265,278791,4.248,13.341,4133,0.135,26.682,9841,10008,54894
2007,26,164699,210810,3670055,3725734,21040,9.931,23156,10.929,485751,166101,319650,4.458,13.038,596046,190501,405545,5.113,15.998,-110295,-2.960,26.075,14953,15310,98434
2007,27,105902,133243,2510427,2490203,14024,10.522,14100,10.579,368402,114931,253471,4.615,14.794,328750,108293,220457,4.349,13.202,39652,1.592,26.403,8458,8552,46810
2007,28,44089,57100,938818,942369,6458,11.424,5322,9.414,130999,41860,89139,4.442,13.901,137765,40806,96959,4.330,14.619,-6766,-0.718,27.802,3528,3597,19813
2007,29,109213,140538,2433130,2439752,15313,10.909,14983,10.674,336183,115543,220640,4.736,13.779,348119,110429,237690,4.526,14.269,-11936,-0.489,27.559,9903,10101,52641
2007,30,28268,32925,353978,348425,4100,12.638,3132,9.654,58309,20096,38213,5.768,16.735,46905,15267,31638,4.382,13.462,11404,3.273,26.924,2083,2106,8854
2007,31,37854,47443,792848,789187,4563,9.650,4249,8.986,104148,32849,71299,4.162,13.197,97664,30021,67643,3.804,12.375,6484,0.822,24.751,2694,2710,14299
2007,32,43592,54740,1186071,1176886,8669,16.089,6950,12.899,222368,83314,139054,7.079,18.895,204301,72232,132069,6.138,17.359,18067,1.535,34.719,4643,4690,31184
2007,33,29421,35788,572009,572982,3644,10.184,3629,10.142,75772,23472,52300,4.096,13.224,78116,22958,55158,4.007,13.633,-2344,-0.409,26.448,2406,2422,12245
2007,34,183418,218198,3648820,3668149,24663,11.293,25063,11.476,532458,175693,356765,4.790,14.516,572944,202725,370219,5.527,15.619,-40486,-1.104,29.031,16493,16616,84373
2007,35,33958,42404,631477,631930,4887,11.630,4120,9.805,99352,34012,65340,5.382,15.722,99431,31347,68084,4.961,15.734,-79,-0.013,31.444,2673,2716,15245
2007,36,387488,459740,7482694,7497672,51852,11.308,49459,10.786,1061860,358424,703436,4.780,14.163,1088791,387273,701518,5.165,14.522,-26931,-0.359,28.325,33521,33842,183137
2007,37,159532,206867,3557574,3546660,24787,12.095,20935,10.215,549012,193614,355398,5.459,15.480,527528,174373,353155,4.917,14.874,21484,0.606,29.748,13028,13302,77716
2007,38,15798,19389,290718,286270,1878,9.755,1604,8.332,44383,15427,28956,5.389,15.504,35272,9919,25353,3.465,12.321,9111,3.183,24.642,975,1001,5622
2007,39,183749,247462,4756461,4782620,23519,9.480,24801,9.996,631686,225426,406260,4.713,13.208,684389,226792,457597,4.742,14.310,-52703,-1.102,26.416,15030,15359,96332
2007,40,65755,83158,1298390,1288406,9320,11.290,8108,9.822,212417,69839,142578,5.421,16.487,192071,62021,130050,4.814,14.908,20346,1.579,29.815,5293,5372,31855
2007,41,82658,101435,1476162,1468734,12203,12.159,10049,10.013,217021,72693,144328,4.949,14.776,201637,64068,137569,4.362,13.729,15384,1.047,27.457,6597,6699,33275
2007,42,216068,279833,5181461,5186803,26337,9.410,26435,9.445,686588,229504,457084,4.425,13.237,695714,234155,461559,4.514,13.413,-9126,-0.176,26.474,15675,16003,92712
2007,44,23289,27202,442968,442271,2773,10.185,2822,10.365,61771,22468,39303,5.080,13.967,60780,21545,39235,4.871,13.743,991,0.224,27.485,1899,1917,11289
2007,45,76483,98940,1661495,1656685,11635,11.871,9775,9.973,254881,90039,164842,5.435,15.385,246727,82053,164674,4.953,14.893,8154,0.492,29.786,6406,6554,40161
2007,46,19423,23188,330950,329692,2382,10.345,2059,8.942,44529,14901,29628,4.520,13.506,42095,13019,29076,3.949,12.768,2434,0.738,25.536,1337,1348,6802
2007,47,94919,127315,2468735,2458221,13994,11.059,12443,9.833,380680,124644,256036,5.070,15.486,361725,119898,241827,4.877,14.715,18955,0.771,29.430,7668,7822,48390
2007,48,353549,475015,8987219,8852265,59693,12.694,50166,10.668,1622664,568886,1053778,6.426,18.330,1353491,483338,870153,5.460,15.290,269173,3.041,30.580,30847,31577,209294
2007,49,51491,62173,1093999,1066961,9683,15.946,6781,11.167,201590,63012,138578,5.906,18.894,147576,52834,94742,4.952,13.831,54014,5.062,27.663,4405,4430,25640
2007,50,17168,19971,267523,264845,1942,9.734,1901,9.529,38576,10304,28272,3.891,14.566,32415,10678,21737,4.032,12.239,6161,2.326,24.479,1175,1185,4902
2007,51,139557,181960,3186220,3190059,21010,11.621,18671,10.327,492635,170422,322213,5.342,15.443,500716,157623,343093,4.941,15.696,-8081,-0.253,30.886,11419,11579,62571
2007,53,132990,163335,2492058,2454686,20947,12.962,17474,10.813,400764,125961,274803,5.131,16.326,324153,108965,215188,4.439,13.205,76611,3.121,26.411,11275,11387,56066
2007,54,29195,37655,579924,584699,3517,9.328,3617,9.593,80094,26815,53279,4.586,13.698,89088,28858,60230,4.936,15.237,-8994,-1.538,27.397,2314,2354,14934
2007,55,104138,132483,2481588,2482234,12538,9.463,12558,9.478,308086,100048,208038,4.031,12.412,309470,97246,212224,3.918,12.467,-1384,-0.056,24.823,7817,7949,43321
2007,56,15760,18353,215065,210961,2244,12.391,1758,9.707,37929,11856,26073,5.620,17.979,29720,9743,19977,4.618,14.088,8209,3.891,28.176,1165,1189,5326
2008,01,73361,97178,1712629,1714457,9031,9.263,9676,9.924,235214,75903,159311,4.427,13.719,238744,79775,158969,4.653,13.925,-3530,-0.206,27.439,6432,6623,38789
2008,02,13687,17031,247285,245787,1819,10.640,1950,11.406,35452,10130,25322,4.121,14.424,32535,8511,24024,3.463,13.237,2917,1.187,26.474,1201,1214,5013
2008,04,96288,125777,2313457,2350769,15908,12.631,16238,12.893,353049,132543,220506,5.638,15.018,427129,131175,295954,5.580,18.170,-74080,-3.151,30.037,10883,11103,71291
2008,05,47458,61266,1013666,1020337,5761,9.371,6181,10.054,127264,42423,84841,4.158,12.473,140533,40704,99829,3.989,13.773,-13269,-1.300,24.945,4188,4268,23106
2008,06,626717,786178,13578934,13622950,88332,11.204,92794,11.770,2005168,662973,1342195,4.867,14.719,2100576,683883,1416693,5.020,15.419,-95408,-0.700,29.438,62294,63456,386341
2008,08,111802,137645,2092246,2077649,16848,12.253,16569,12.050,335720,113523,222197,5.464,16.159,307535,108496,199039,5.222,14.802,28185,1.357,29.604,10865,11018,58302
2008,09,68124,84643,1536055,1532574,7593,8.947,8037,9.470,217264,69145,148119,4.512,14.176,211654,60083,151571,3.920,13.810,5610,0.366,27.621,5226,5295,27378
2008,10,17858,22508,384342,384926,2292,10.127,2539,11.219,57305,19236,38069,4.997,14.887,58115,16731,41384,4.347,15.098,-810,-0.210,29.775,1588,1601,7419
2008,11,15387,19488,443676,439360,2003,10.302,1912,9.834,60930,19388,41542,4.413,13.868,52429,15843,36586,3.606,11.933,8501,1.935,23.866,948,974,5013
2008,12,360828,450772,7044506,7123595,56538,12.388,67786,14.852,1067949,407756,660193,5.724,14.992,1228543,434205,794338,6.095,17.246,-160594,-2.254,29.983,47038,47580,241538
2008,13,158341,205406,3618292,3623168,24035,11.665,25309,12.283,555052,207903,347149,5.738,15.320,566092,200777,365315,5.541,15.624,-11040,-0.305,30.639,16892,17145,98851
2008,15,23980,30435,517119,516883,2666,8.725,2907,9.514,66892,21527,45365,4.165,12.941,66795,19754,47041,3.822,12.923,97,0.019,25.845,1878,1931,11184
2008,16,34424,41170,535888,540904,4768,11.523,5181,12.522,74005,27306,46699,5.048,13.682,84723,25619,59104,4.736,15.663,-10718,-1.981,27.363,3631,3678,16935
2008,17,226813,287542,5398170,5375642,28634,9.939,29761,10.330,743985,224649,519336,4.179,13.840,701345,222835,478510,4.145,13.047,42640,0.793,26.093,19305,19595,109575
2008,18,104248,138295,2602879,2620688,12342,8.877,13822,9.941,328180,100906,227274,3.850,12.523,364825,116025,248800,4.427,13.921,-36645,-1.398,25.045,8919,9145,60159
2008,19,57609,74734,1307544,1300984,6071,8.094,6616,8.821,160822,42854,117968,3.294,12.362,147766,44328,103438,3.407,11.358,13056,1.004,22.716,4266,4351,23074
2008,20,55065,70013,1188835,1183043,6154,8.758,6655,9.471,156075,43478,112597,3.675,13.193,144516,43748,100768,3.698,12.216,11559,0.977,24.431,4312,4417,24028
2008,21,64839,85526,1537576,1538885,7524,8.760,8262,9.619,202357,63916,138441,4.153,13.150,205540,66157,139383,4.299,13.356,-3183,-0.207,26.299,5505,5608,35894
2008,22,74850,96319,1640906,1638814,9321,9.701,8851,9.212,237364,72623,164741,4.431,14.484,233121,66482,166639,4.057,14.225,4243,0.259,28.450,5782,5873,34276
2008,23,30090,36797,506252,503998,3449,9.303,4001,10.792,65395,20690,44705,4.105,12.975,61138,20856,40282,4.138,12.131,4257,0.845,24.261,2631,2679,12304
2008,24,100147,125836,2223526,2225918,12233,9.664,13725,10.843,306724,94928,211796,4.265,13.780,310682,103859,206823,4.666,13.957,-3958,-0.178,27.559,8816,8968,44881
2008,25,125888,157813,3072683,3068872,13910,8.772,15442,9.738,395092,119449,275643,3.892,12.874,388502,119615,268887,3.898,12.659,6590,0.215,25.319,9995,10148,55769
2008,26,160767,206820,3613958,3639376,18868,9.038,22774,10.908,496151,166100,330051,4.564,13.633,547776,186888,360888,5.135,15.051,-51625,-1.419,27.266,15094,15379,105026
2008,27,104071,131634,2488073,2501197,12388,9.356,13929,10.520,313160,102206,210954,4.086,12.520,340304,97353,242951,3.892,13.606,-27144,-1.085,25.041,8943,9153,52033
2008,28,43621,56898,942570,939931,5356,9.398,5536,9.714,131120,41964,89156,4.465,13.950,126177,41640,84537,4.430,13.424,4943,0.526,26.848,3803,3893,20866
2008,29,107570,139352,2442983,2437341,13503,9.652,14601,10.437,330139,111661,218478,4.581,13.545,318868,100179,218689,4.110,13.083,11271,0.462,26.165,9809,9943,47742
2008,30,28133,32892,358508,356238,3442,10.461,3464,10.528,51562,16186,35376,4.544,14.474,46876,15408,31468,4.325,13.159,4686,1.315,26.317,2389,2420,9860
2008,31,37643,47383,795190,794838,4190,8.839,4228,8.919,100453,28218,72235,3.550,12.638,100451,27345,73106,3.440,12.638,2,0.000,25.276,2757,2785,13990
2008,32,43240,54757,1152458,1168998,7638,13.959,7559,13.815,178547,71080,107467,6.080,15.274,211554,61323,150231,5.246,18.097,-33007,-2.824,30.547,5317,5425,33945
2008,33,28932,35369,591013,581100,3220,9.052,3626,10.193,92981,27096,65885,4.663,16.001,74335,21434,52901,3.689,12.792,18646,3.209,25.584,2453,2489,11510
2008,34,180133,215213,3602830,3622506,21611,9.974,24517,11.316,502362,169853,332509,4.689,13.868,541893,183910,357983,5.077,14.959,-39531,-1.091,27.736,16925,17114,94449
2008,35,33725,42207,639487,639320,4355,10.298,4524,10.697,96750,35515,61235,5.555,15.133,96445,31542,64903,4.934,15.086,305,0.048,30.171,2894,2956,16730
2008,36,387780,461088,7551484,7513305,48854,10.612,47380,10.292,1034225,341122,693103,4.540,13.765,957295,308953,648342,4.112,12.741,76930,1.024,25.483,32949,33290,172511
2008,37,158598,206905,3549730,3550400,21583,10.435,21420,10.357,500619,170364,330255,4.798,14.100,502892,160973,341919,4.534,14.164,-2273,-0.064,28.201,14301,14561,81500
2008,38,15860,19490,306056,298245,1682,8.656,1567,8.064,49291,20927,28364,7.017,16.527,33097,9393,23704,3.149,11.097,16194,5.430,22.195,1005,1022,6602
2008,39,179499,242749,4709672,4732654,19955,8.143,24545,10.017,601000,200164,400836,4.229,12.699,647222,217985,429237,4.606,13.676,-46222,-0.977,25.398,15254,15612,108161
2008,40,65932,83882,1325351,1312751,8652,10.362,7887,9.446,199076,68152,130924,5.192,15.165,174190,53102,121088,4.045,13.269,24886,1.896,26.538,5333,5463,28772
2008,41,82125,101192,1478710,1478405,10755,10.618,10961,10.821,199875,62694,137181,4.241,13.520,199344,61249,138095,4.143,13.484,531,0.036,26.967,7391,7504,35137
2008,42,214110,279115,5210067,5195141,24176,8.652,24804,8.877,661940,201173,460767,3.872,12.742,636071,197235,438836,3.797,12.244,25869,0.498,24.487,15798,16122,88066
2008,44,22792,26699,430695,436583,2433,9.030,2923,10.848,49271,15755,33516,3.609,11.286,61353,18098,43255,4.145,14.053,-12082,-2.767,22.571,1921,1941,9221
2008,45,75617,98537,1661442,1661145,9824,9.951,10200,10.332,232641,72682,159959,4.375,14.005,230759,71743,159016,4.319,13.892,1882,0.113,27.783,6893,7003,37855
2008,46,19330,23202,337205,333943,2148,9.265,2111,9.106,45402,13816,31586,4.137,13.596,38779,14274,24505,4.274,11.612,6623,1.983,23.225,1461,1475,7120
2008,47,94193,127804,2483745,2478059,12995,10.188,12483,9.787,356319,122986,233333,4.963,14.379,344904,92911,251993,3.749,13.918,11415,0.461,27.837,8346,8452,47903
2008,48,356007,479678,9153094,9063990,54093,11.335,49172,10.304,1510010,524064,985946,5.782,16.659,1333605,421726,911879,4.653,14.713,176405,1.946,29.426,31642,32586,211108
2008,49,51595,62615,1108755,1101205,8292,13.292,7831,12.553,184882,58417,126465,5.305,16.789,169859,58711,111148,5.332,15.425,15023,1.364,30.850,5376,5433,29739
2008,50,16888,19710,267943,267521,1701,8.579,1936,9.764,31154,11204,19950,4.188,11.645,30670,10304,20366,3.852,11.465,484,0.181,22.929,1249,1258,6332
2008,51,138278,180509,3169150,3176449,18175,10.031,19534,10.781,445545,138149,307396,4.349,14.027,460871,152247,308624,4.793,14.509,-15326,-0.482,28.053,12332,12540,63537
2008,53,132993,163842,2513407,2502670,18643,11.399,18044,11.033,358209,111116,247093,4.440,14.313,337181,107112,230069,4.280,13.473,21028,0.840,26.946,12148,12366,62496
2008,54,28501,37133,584729,582827,2983,7.979,3491,9.337,76718,21871,54847,3.753,13.163,73054,21385,51669,3.669,12.534,3664,0.629,25.069,2373,2389,11416
2008,55,102441,131212,2487647,2484603,10897,8.267,12105,9.183,287554,86290,201264,3.473,11.573,280975,84372,196603,3.396,11.309,6579,0.265,22.617,8050,8215,47105
2008,56,15841,18473,220786,217273,2038,11.073,1902,10.334,38644,12172,26472,5.602,17.786,31899,10463,21436,4.816,14.682,6745,3.104,29.363,1227,1241,5855
2009,01,71181,94893,1612482,1664992,7694,8.002,10210,10.619,172179,64449,107730,3.871,10.341,277689,72121,205568,4.332,16.678,-105510,-6.337,20.682,6882,7074,37751
2009,02,13566,17012,251124,249350,1803,10.576,1874,10.993,39365,12320,27045,4.941,15.787,35975,11298,24677,4.531,14.428,3390,1.360,28.855,1082,1118,5028
2009,04,91334,120715,2127763,2222422,13108,10.616,18619,15.080,285202,116683,168519,5.250,12.833,474078,160415,313663,7.218,21.332,-188876,-8.499,25.666,12252,12477,98783
2009,05,46640,60525,969980,992890,5419,8.883,6384,10.464,111411,44352,67059,4.467,11.221,157693,46964,110729,4.730,15.882,-46282,-4.661,22.442,4327,4422,26831
2009,06,610155,768798,12759005,13203759,78681,10.102,98786,12.684,1558520,586589,971931,4.443,11.804,2449768,729728,1720040,5.527,18.554,-891248,-6.750,23.607,65059,66499,409083
2009,08,108762,134576,2002820,2050014,14705,10.783,18293,13.414,265549,101344,164205,4.944,12.954,362183,108742,253441,5.304,17.667,-96634,-4.714,25.907,11634,11847,60417
2009,09,66265,82628,1461259,1500293,6393,7.632,8664,10.343,151685,49782,101903,3.318,10.110,228667,63372,165295,4.224,15.241,-76982,-5.131,20.221,5368,5451,33037
2009,10,17394,22036,368919,377431,2008,9.000,2559,11.469,45026,20956,24070,5.552,11.930,62291,17041,45250,4.515,16.504,-17265,-4.574,23.859,1556,1593,8044
2009,11,15323,19665,451933,448546,2021,10.306,1911,9.745,62227,19628,42599,4.376,13.873,56055,13802,42253,3.077,12.497,6172,1.376,24.994,1020,1034,6333
2009,12,346396,436354,6573540,6817900,52451,11.797,68953,15.509,861131,372140,488991,5.458,12.630,1347693,402428,945265,5.903,19.767,-486562,-7.137,25.261,45305,46101,222312
2009,13,151884,198915,3402557,3518094,20664,10.204,27857,13.756,433884,184270,249614,5.238,12.333,665943,204054,461889,5.800,18.929,-232059,-6.596,24.666,18266,18690,111893
2009,15,23559,30082,487127,502551,2562,8.454,3009,9.929,49925,19652,30273,3.910,9.934,81347,21523,59824,4.283,16.187,-31422,-6.253,19.869,1964,2017,13086
2009,16,32536,39310,499487,518124,3733,9.261,5734,14.225,57568,23624,33944,4.560,11.111,94525,28111,66414,5.426,18.244,-36957,-7.133,22.222,3760,3804,17584
2009,17,221513,281680,5072722,5241363,25091,8.802,31880,11.183,534616,194382,340234,3.709,10.200,870519,236153,634366,4.506,16.609,-335903,-6.409,20.400,20006,20378,125166
2009,18,101309,135122,2441810,2523792,10496,7.667,14037,10.254,260309,86409,173900,3.424,10.314,424635,111325,313310,4.411,16.825,-164326,-6.511,20.628,9005,9268,58111
2009,19,56820,74026,1277099,1292246,5372,7.211,6311,8.472,139987,44561,95426,3.448,10.833,170098,39765,130333,3.077,13.163,-30111,-2.330,21.666,4223,4284,24706
2009,20,54161,69175,1154665,1172841,5515,7.912,6566,9.420,126400,40282,86118,3.435,10.777,163070,41037,122033,3.499,13.904,-36670,-3.127,21.555,4322,4449,23353
2009,21,63440,84291,1471120,1507219,6849,8.053,8372,9.843,166529,60814,105715,4.035,11.049,238387,60909,177478,4.041,15.816,-71858,-4.768,22.098,5463,5618,34188
2009,22,74546,96282,1632568,1641365,8526,8.834,8991,9.316,211947,70297,141650,4.283,12.913,228664,66946,161718,4.079,13.931,-16717,-1.018,25.826,5957,6060,39410
2009,23,28958,35713,487612,497223,2904,7.998,4096,11.281,51284,18010,33274,3.622,10.314,70676,19773,50903,3.977,14.214,-19392,-3.900,20.628,2597,2620,12419
2009,24,97130,123243,2144043,2187342,11177,8.958,14239,11.412,255017,96885,158132,4.429,11.659,341624,98804,242820,4.517,15.618,-86607,-3.959,23.318,8852,8992,49106
2009,25,122743,154624,2968620,3021590,12453,7.960,16099,10.290,320648,109982,210666,3.640,10.612,428300,117353,310947,3.884,14.175,-107652,-3.563,21.224,9846,10073,61457
2009,26,155282,200198,3375461,3500387,16509,8.098,23830,11.689,393670,138331,255339,3.952,11.246,643559,175059,468500,5.001,18.385,-249889,-7.139,22.493,14836,15103,95525
2009,27,101541,129244,2379304,2436990,11051,8.457,13905,10.641,265878,89469,176409,3.671,10.910,381445,87120,294325,3.575,15.652,-115567,-4.742,21.820,8628,8814,48834
2009,28,42673,56068,902166,924772,4682,8.272,5750,10.159,105311,43949,61362,4.752,11.388,150660,42739,107921,4.622,16.292,-45349,-4.904,22.776,3910,4041,25943
2009,29,105111,136881,2333515,2387480,12295,8.887,15221,11.002,261314,91275,170039,3.823,10.945,369312,112276,257036,4.703,15.469,-107998,-4.524,21.890,10108,10302,59171
2009,30,27139,31837,339552,349212,2837,8.749,4018,12.391,38492,12020,26472,3.442,11.023,57977,15799,42178,4.524,16.602,-19485,-5.580,22.045,2542,2582,9720
2009,31,37374,47170,782565,789463,3737,7.893,4085,8.628,87289,29829,57460,3.778,11.057,101165,28605,72560,3.623,12.814,-13876,-1.758,22.114,2631,2686,16409
2009,32,41678,53293,1041411,1098794,6651,12.286,8334,15.395,136939,56356,80583,5.129,12.463,252869,63566,189303,5.785,23.013,-115930,-10.551,24.925,5641,5791,37664
2009,33,28013,34419,565218,579313,2799,8.009,3856,11.034,57712,17575,40137,3.034,9.962,86134,22469,63665,3.879,14.868,-28422,-4.906,19.924,2460,2507,12659
2009,34,173655,208951,3426937,3519453,19290,9.079,26334,12.394,397471,145227,252244,4.126,11.294,583250,168941,414309,4.800,16.572,-185779,-5.279,22.587,17531,17796,92532
2009,35,32868,41454,614831,627910,3691,8.806,4611,11.001,76037,25555,50482,4.070,12.110,102008,28067,73941,4.470,16.246,-25971,-4.136,24.219,3054,3095,15814
2009,36,384364,458152,7309282,7439249,46070,10.005,50706,11.012,830857,299273,531584,4.023,11.169,1091116,317997,773119,4.275,14.667,-260259,-3.498,22.337,34299,34695,186862
2009,37,152468,201237,3331165,3444598,18178,8.891,24595,12.030,369584,146143,223441,4.243,10.729,597070,168702,428368,4.898,17.334,-227486,-6.604,21.459,16125,16441,89295
2009,38,15868,19493,294724,296364,1540,7.892,1582,8.107,32981,9195,23786,3.103,11.129,36263,8888,27375,2.999,12.236,-3282,-1.107,22.257,1007,1020,5601
2009,39,174007,237002,4461965,4591234,17818,7.416,24363,10.140,481675,180845,300830,3.939,10.491,740504,204214,536290,4.448,16.129,-258829,-5.637,20.982,15095,15571,102826
2009,40,65679,83761,1283595,1305571,7584,9.029,8047,9.581,157976,53988,103988,4.135,12.100,201852,66360,135492,5.083,15.461,-43876,-3.361,24.200,5454,5556,37646
2009,41,78700,97864,1371020,1423726,8898,8.926,12547,12.586,160574,57505,103069,4.039,11.278,264720,70699,194021,4.966,18.593,-104146,-7.315,22.557,8252,8375,41315
2009,42,211111,276243,5034201,5125598,21655,7.786,25438,9.146,528285,179611,348674,3.504,10.307,712442,207740,504702,4.053,13.900,-184157,-3.593,20.614,15632,16040,110176
2009,44,21819,25653,409347,419718,2047,7.809,3166,12.078,43062,13208,29854,3.147,10.260,63801,18461,45340,4.398,15.201,-20739,-4.941,20.520,2011,2040,10446
2009,45,72808,95783,1545166,1601565,8710,8.953,11710,12.037,174727,72889,101838,4.551,10.910,287934,80173,207761,5.006,17.978,-113207,-7.069,21.820,7689,7971,44070
2009,46,19203,23101,330650,333963,1932,8.330,2119,9.136,37451,11934,25517,3.573,11.214,44164,12139,32025,3.635,13.224,-6713,-2.010,22.428,1407,1417,7869
2009,47,91538,125163,2320274,2405319,10792,8.521,13761,10.866,256344,93015,163329,3.867,10.657,426731,109662,317069,4.559,17.741,-170387,-7.084,21.315,8864,9109,56692
2009,48,354437,480195,8884145,9034023,49791,10.356,50950,10.597,1204483,454351,750132,5.029,13.333,1508657,429823,1078834,4.758,16.700,-304174,-3.367,26.665,32869,33786,216917
2009,49,49411,60587,1050964,1080080,6961,11.276,9249,14.983,142197,49765,92432,4.608,13.165,201444,63657,137787,5.894,18.651,-59247,-5.485,26.331,6198,6268,37322
2009,50,16390,19281,261382,265043,1531,7.838,2035,10.418,28128,11044,17084,4.167,10.613,35806,10639,25167,4.014,13.510,-7678,-2.897,21.225,1256,1273,6240
2009,51,134799,178232,3057517,3116875,16964,9.441,19876,11.061,373513,149037,224476,4.782,11.984,493886,139326,354560,4.470,15.846,-120373,-3.862,23.967,12783,13013,72771
2009,53,127837,159216,2377429,2448165,15454,9.549,20685,12.782,303470,97429,206041,3.980,12.396,443654,115774,327880,4.729,18.122,-140184,-5.726,24.792,13630,13852,68185
2009,54,27872,36737,576207,581664,2764,7.470,3293,8.900,67512,21973,45539,3.778,11.607,78724,20430,58294,3.512,13.534,-11212,-1.928,23.213,2230,2265,12325
2009,55,99917,128810,2356575,2424673,9732,7.474,12526,9.620,213712,69238,144474,2.856,8.814,349512,98165,251347,4.049,14.415,-135800,-5.601,17.628,8108,8265,54560
2009,56,15725,18379,212481,216250,1786,9.675,1949,10.558,28317,8659,19658,4.004,13.095,35812,9800,26012,4.532,16.560,-7495,-3.466,26.189,1325,1349,6371
2010,01,69402,93148,1574739,1592925,7501,7.983,9136,9.723,178559,62027,116532,3.894,11.210,214572,58799,155773,3.691,13.470,-36013,-2.261,22.419,6040,6178,31328
2010,02,13611,17141,253210,252380,1751,10.253,1625,9.515,33329,8675,24654,3.437,13.206,31612,8054,23558,3.191,12.526,1717,0.680,25.051,952,970,3865
2010,04,88480,117872,2059056,2090604,13168,11.038,16028,13.435,288855,114723,174132,5.488,13.817,351624,107408,244216,5.138,16.819,-62769,-3.002,27.634,10031,10312,52836
2010,05,46134,60194,964833,968110,5187,8.592,5539,9.175,116274,40265,76009,4.159,12.010,122394,35983,86411,3.717,12.643,-6120,-0.632,24.021,3678,3786,21632
2010,06,598827,757813,12380078,12569659,77810,10.192,89072,11.667,1549756,549624,1000132,4.373,12.329,1926156,597125,1329031,4.751,15.324,-376400,-2.995,24.659,56615,57970,314327
2010,08,106794,132673,1962794,1983283,14923,11.167,16857,12.614,266714,99275,167439,5.006,13.448,307173,89901,217272,4.533,15.488,-40459,-2.040,26.896,10346,10537,49507
2010,09,65102,81510,1432385,1447057,6633,8.082,7751,9.444,155410,52258,103152,3.611,10.740,183800,50013,133787,3.456,12.702,-28390,-1.962,21.479,4773,4875,25983
2010,10,17184,21747,361823,365546,1990,9.087,2293,10.471,41367,12276,29091,3.358,11.316,48561,14695,33866,4.020,13.285,-7194,-1.968,22.633,1355,1379,6118
2010,11,15405,19903,462210,462467,2026,10.239,1795,9.071,56982,19955,37027,4.315,12.321,57173,15232,41941,3.294,12.363,-191,-0.041,24.643,971,982,6034
2010,12,343490,433171,6474504,6527521,54563,12.549,57838,13.302,955863,355196,600667,5.442,14.644,1059693,361098,698595,5.532,16.234,-103830,-1.591,29.287,37252,37924,183242
2010,13,148688,195308,3318067,3358639,19924,10.106,23589,11.966,403572,143855,259717,4.283,12.016,484653,154945,329708,4.613,14.430,-81081,-2.414,24.032,14909,15227,77911
2010,15,23109,29633,478023,482523,2399,8.034,2852,9.551,56421,21144,35277,4.382,11.693,65508,18906,46602,3.918,13.576,-9087,-1.883,23.386,1750,1797,9255
2010,16,31813,38605,489181,494330,3971,10.193,4681,12.015,61980,20703,41277,4.188,12.538,72239,19874,52365,4.020,14.614,-10259,-2.075,25.076,3055,3120,12565
2010,17,218702,278998,4952434,5022415,25715,9.172,28461,10.151,547530,197759,349771,3.938,10.902,689220,198613,490607,3.955,13.723,-141690,-2.821,21.803,17300,17621,101226
2010,18,99564,133424,2403508,2422767,10312,7.679,12033,8.961,274430,87265,187165,3.602,11.327,313210,87531,225679,3.613,12.928,-38780,-1.601,22.654,7614,7804,45206
2010,19,56391,73817,1247126,1262146,5475,7.406,5686,7.692,122442,37329,85113,2.958,9.701,151730,42153,109577,3.340,12.022,-29288,-2.320,19.402,3562,3636,24480
2010,20,53452,68633,1128110,1142061,5398,7.833,5957,8.644,119759,38908,80851,3.407,10.486,147876,36886,110990,3.230,12.948,-28117,-2.462,20.972,3856,3935,21004
2010,21,62497,83522,1440994,1456183,6730,8.021,7502,8.941,166016,56862,109154,3.905,11.401,195638,52647,142991,3.615,13.435,-29622,-2.034,22.802,4818,4963,28594
2010,22,74062,96167,1594645,1614264,8200,8.520,8345,8.671,186254,67662,118592,4.192,11.538,226201,56647,169554,3.509,14.013,-39947,-2.475,23.076,5432,5579,34015
2010,23,28754,35590,480414,484328,3184,8.929,3321,9.313,51058,18269,32789,3.772,10.542,58990,16689,42301,3.446,12.180,-7932,-1.638,21.084,2042,2077,8909
2010,24,95784,121871,2078671,2111081,11337,9.250,12730,10.386,245585,81844,163741,3.877,11.633,309092,101245,207847,4.796,14.641,-63507,-3.008,23.266,7629,7921,43958
2010,25,121222,153646,2936505,2952967,13380,8.680,14387,9.333,324570,105157,219413,3.561,10.991,356061,97654,258407,3.307,12.058,-31491,-1.066,21.983,8738,8948,47458
2010,26,151654,196100,3289132,3333252,16163,8.159,20182,10.187,393860,121233,272627,3.637,11.816,483312,148877,334435,4.466,14.500,-89452,-2.684,23.632,12656,12958,76311
2010,27,100396,128282,2356253,2367719,11086,8.610,12042,9.352,263690,84552,179138,3.571,11.137,285845,83788,202057,3.539,12.073,-22155,-0.936,22.274,7245,7387,40244
2010,28,42106,55598,881047,891658,4512,8.081,4986,8.930,95519,32032,63487,3.592,10.713,116585,32802,83783,3.679,13.075,-21066,-2.363,21.425,3313,3400,18501
2010,29,103732,135606,2279380,2306606,13123,9.649,13909,10.227,256605,92250,164355,3.999,11.125,311180,81847,229333,3.548,13.491,-54575,-2.366,22.250,8834,9073,43193
2010,30,26778,31501,336713,338127,2959,9.343,3299,10.416,43383,16748,26635,4.953,12.830,46326,14134,32192,4.180,13.701,-2943,-0.870,25.661,2079,2106,9477
2010,31,37351,47285,770697,777360,3774,7.990,3671,7.772,79936,24442,55494,3.144,10.283,92784,23865,68919,3.070,11.936,-12848,-1.653,20.566,2242,2299,11850
2010,32,40626,52355,995422,1019616,6537,12.373,7494,14.184,138729,59869,78860,5.872,13.606,186486,54163,132323,5.312,18.290,-47757,-4.684,27.212,4934,5035,32225
2010,33,27718,34165,563000,564087,2948,8.596,3208,9.354,67133,19979,47154,3.542,11.901,69600,18332,51268,3.250,12.339,-2467,-0.437,23.802,2021,2069,10837
2010,34,170362,205544,3369847,3400569,19578,9.445,23056,11.123,395646,138856,256790,4.083,11.635,457090,151639,305451,4.459,13.442,-61444,-1.807,23.269,14754,14945,79950
2010,35,31998,40566,596015,604042,3502,8.539,4391,10.707,68402,21997,46405,3.642,11.324,84569,23429,61140,3.879,14.001,-16167,-2.676,22.648,2825,2874,13480
2010,36,385321,459985,7259944,7286680,48302,10.520,46598,10.149,873472,320467,553005,4.398,11.987,925702,289480,636222,3.973,12.704,-52230,-0.717,23.974,31644,32089,161055
2010,37,150070,199092,3226031,3275466,19351,9.667,21531,10.756,385583,146141,239442,4.462,11.772,482942,147375,335567,4.499,14.744,-97359,-2.972,23.544,13263,13623,70571
2010,38,16066,19744,296137,295380,1621,8.263,1367,6.968,34374,9881,24493,3.345,11.637,32706,9306,23400,3.151,11.073,1668,0.565,22.145,839,850,3583
2010,39,170322,233100,4350598,4405718,17446,7.422,21370,9.091,462034,144638,317396,3.283,10.487,571794,147764,424030,3.354,12.978,-109760,-2.491,20.974,12578,13041,77496
2010,40,64937,83099,1236806,1259919,7022,8.417,7683,9.209,139194,54360,84834,4.315,11.048,185009,52878,132131,4.197,14.684,-45815,-3.636,22.096,5004,5073,26544
2010,41,77464,96974,1325576,1340323,9617,9.872,10499,10.778,152924,53597,99327,3.999,11.409,181608,52828,128780,3.941,13.550,-28684,-2.140,22.819,6616,6754,28571
2010,42,208198,273887,4968954,5002524,21244,7.722,23658,8.600,542396,181918,360478,3.637,10.842,609806,171981,437825,3.438,12.190,-67410,-1.348,21.685,14345,14721,79934
2010,44,21430,25374,396361,403683,2301,9.018,2583,10.123,42602,16550,26052,4.100,10.553,57095,15497,41598,3.839,14.144,-14493,-3.590,21.107,1649,1654,7585
2010,45,71288,94365,1504924,1528571,8573,9.017,10005,10.523,177320,68968,108352,4.512,11.600,224030,62298,161732,4.076,14.656,-46710,-3.056,23.201,6434,6610,33981
2010,46,19200,23213,329629,330171,1968,8.499,1856,8.015,37326,13690,23636,4.146,11.305,38530,9946,28584,3.012,11.670,-1204,-0.365,22.610,1205,1214,5804
2010,47,89822,123452,2269638,2295073,10444,8.402,12151,9.775,266677,87414,179263,3.809,11.620,316532,92124,224408,4.014,13.792,-49855,-2.172,23.239,7681,7913,48217
2010,48,354098,481817,8775663,8831864,49132,10.214,47573,9.890,1197683,466967,730716,5.287,13.561,1304655,367594,937061,4.162,14.772,-106972,-1.211,27.122,30130,30926,187680
2010,49,48744,59938,1012316,1031379,7298,12.108,7966,13.217,129373,51201,78172,4.964,12.544,166677,47741,118936,4.629,16.161,-37304,-3.617,25.087,5081,5216,28619
2010,50,16224,19129,260616,261111,1513,7.876,1675,8.719,26746,9501,17245,3.639,10.243,27760,7186,20574,2.752,10.632,-1014,-0.388,20.486,1042,1050,4376
2010,51,133104,176609,3009893,3035131,16460,9.277,18106,10.204,371398,128359,243039,4.229,12.237,421383,137793,283590,4.540,13.884,-49985,-1.647,24.473,10836,11180,63342
2010,53,126137,157682,2295574,2322719,16081,10.148,17635,11.129,278326,105564,172762,4.545,11.983,332535,89687,242848,3.861,14.317,-54209,-2.334,23.966,11343,11580,49704
2010,54,27232,36250,564272,570355,2522,6.910,3016,8.264,64035,21138,42897,3.706,11.227,75997,19126,56871,3.353,13.325,-11962,-2.097,22.454,1937,2005,9840
2010,55,98329,127412,2324629,2340746,9525,7.435,10937,8.537,234052,77759,156293,3.322,9.999,266444,72047,194397,3.078,11.383,-32392,-1.384,19.998,6884,7082,35326
2010,56,15313,17988,201743,206655,1530,8.414,1923,10.575,23526,7771,15755,3.760,11.384,33274,8214,25060,3.975,16.101,-9748,-4.717,22.768,1235,1253,4956
2011,01,68323,91963,1591965,1583131,7537,8.144,8715,9.416,209787,54034,155753,3.413,13.251,189426,58511,130915,3.696,11.965,20361,1.286,23.931,5494,5775,27932
2011,02,13617,17324,254093,253599,1775,10.301,1591,9.233,31797,10075,21722,3.973,12.538,30607,7451,23156,2.938,12.069,1190,0.469,24.138,962,985,3387
2011,04,87587,117243,2112955,2085542,13569,11.543,14194,12.074,323022,107371,215651,5.148,15.489,268799,98654,170145,4.730,12.889,54223,2.600,25.777,9012,9275,49540
2011,05,45703,59862,978025,971389,5275,8.789,5592,9.317,123883,39640,84243,4.081,12.753,111120,32380,78740,3.333,11.439,12763,1.314,22.879,3655,3815,18737
2011,06,599612,760301,12588492,12486086,82834,10.912,80389,10.590,1735477,546769,1188708,4.379,13.899,1534225,532248,1001977,4.263,12.287,201252,1.612,24.575,51379,52737,276908
2011,08,106491,132692,1987334,1976584,15305,11.535,15286,11.521,282399,90207,192192,4.564,14.287,260441,87265,173176,4.415,13.176,21958,1.111,26.353,9469,9624,45857
2011,09,64243,80644,1435247,1433912,6528,8.051,7410,9.139,161092,48966,112126,3.415,11.234,158031,52298,105733,3.647,11.021,3061,0.213,22.042,4584,4657,23048
2011,10,17057,21617,360633,361602,2034,9.380,2170,10.007,43220,12442,30778,3.441,11.952,45144,14228,30916,3.935,12.484,-1924,-0.532,23.905,1297,1321,6105
2011,11,15565,20084,472996,467357,1956,9.782,1778,8.892,60033,16659,43374,3.565,12.845,48464,12780,35684,2.735,10.370,11569,2.475,20.740,879,889,5479
2011,12,346162,436491,6605710,6546797,57552,13.235,54246,12.475,1050929,381367,669562,5.825,16.053,931656,351608,580048,5.371,14.231,119273,1.822,28.461,35166,35839,174541
2011,13,147497,194362,3330112,3324186,20689,10.619,21637,11.105,448501,150908,297593,4.540,13.492,435074,154225,280849,4.639,13.088,13427,0.404,26.176,13735,14136,75049
2011,15,22792,29377,482505,480054,2398,8.128,2651,8.985,56726,19864,36862,4.138,11.817,52037,18105,33932,3.771,10.840,4689,0.977,21.680,1664,1709,9272
2011,16,30995,37803,481963,485430,3806,9.964,4596,12.032,59974,19584,40390,4.034,12.355,66424,21555,44869,4.440,13.684,-6450,-1.329,24.710,2872,2962,14002
2011,17,218264,278916,5027801,4991246,27105,9.716,27207,9.753,621377,187315,434062,3.753,12.449,547197,178669,368528,3.580,10.963,74180,1.486,21.926,16864,17380,88768
2011,18,98487,132716,2436035,2419455,10987,8.257,11691,8.786,291649,80248,211401,3.317,12.054,257366,78247,179119,3.234,10.637,34283,1.417,21.275,7369,7701,40725
2011,19,55943,73561,1256434,1251263,5545,7.525,5798,7.868,134939,39374,95565,3.147,10.784,124338,36235,88103,2.896,9.937,10601,0.847,19.874,3657,3730,18976
2011,20,52626,68154,1122455,1125388,5709,8.348,6184,9.042,132481,45885,86596,4.077,11.772,137938,43760,94178,3.888,12.257,-5457,-0.485,23.544,3993,4063,20177
2011,21,61679,82995,1446222,1443895,6775,8.138,7290,8.756,172984,51132,121852,3.541,11.980,167231,52758,114473,3.654,11.582,5753,0.398,23.164,4866,5032,29274
2011,22,73725,96376,1610861,1602683,8477,8.806,8260,8.580,209445,68732,140713,4.289,13.068,192874,52713,140161,3.289,12.034,16571,1.034,24.069,5384,5517,28067
2011,23,28327,35206,478670,479512,3135,8.856,3521,9.947,53543,17552,35991,3.660,11.166,55210,18918,36292,3.945,11.514,-1667,-0.348,22.332,2103,2198,10802
2011,24,94977,121472,2111797,2096641,11533,9.479,11937,9.811,273804,86220,187584,4.112,13.059,243596,78324,165272,3.736,11.618,30208,1.441,23.237,7434,7553,38066
2011,25,121076,153859,2975049,2956462,13532,8.801,13324,8.666,335152,91250,243902,3.086,11.336,298154,84382,213772,2.854,10.085,36998,1.251,20.170,7979,8113,42319
2011,26,150849,196141,3385941,3335180,17998,9.177,17947,9.151,478887,133516,345371,4.003,14.359,376592,122036,254556,3.659,11.292,102295,3.067,22.583,11387,11688,65008
2011,27,99995,128287,2395023,2375814,11557,9.009,11555,9.007,273561,75091,198470,3.161,11.514,235198,70801,164397,2.980,9.900,38363,1.615,19.799,7212,7414,38082
2011,28,41727,55425,892984,887084,4630,8.341,4804,8.654,108086,34086,74000,3.842,12.184,96449,28708,67741,3.236,10.873,11637,1.312,21.745,3154,3284,16841
2011,29,101476,133904,2276985,2278152,12356,9.187,13529,10.059,252433,77177,175256,3.388,11.081,254183,76466,177717,3.356,11.157,-1750,-0.077,22.161,9063,9260,41406
2011,30,26460,31223,334609,335692,3029,9.658,3305,10.539,40999,12504,28495,3.725,12.213,42960,13999,28961,4.170,12.797,-1961,-0.584,24.427,2056,2105,8602
2011,31,37118,47230,760485,758402,3924,8.304,3976,8.414,85576,25141,60435,3.315,11.284,80750,24200,56550,3.191,10.647,4826,0.636,21.295,2465,2514,12291
2011,32,40470,52301,996485,997744,6544,12.504,6613,12.636,134746,44873,89873,4.497,13.505,137056,47736,89320,4.784,13.737,-2310,-0.232,27.010,4419,4512,30752
2011,33,27352,33837,554766,559471,2826,8.311,3157,9.285,56947,16301,40646,2.914,10.179,65768,18450,47318,3.298,11.755,-8821,-1.577,20.357,2014,2043,9582
2011,34,169157,204290,3378611,3374677,20343,9.927,21602,10.542,420702,125660,295042,3.724,12.466,412551,140953,271598,4.177,12.225,8151,0.242,24.450,13926,14112,67128
2011,35,31665,40400,594283,594732,3795,9.376,3945,9.747,70956,22391,48565,3.765,11.931,71633,19575,52058,3.291,12.045,-677,-0.114,23.862,2578,2651,11789
2011,36,387558,462784,7353682,7308183,49874,10.810,47076,10.203,943421,303141,640280,4.148,12.909,852395,298600,553795,4.086,11.664,91026,1.246,23.327,31297,31687,149267
2011,37,148619,197832,3274011,3249137,19044,9.596,20314,10.235,427639,136746,290893,4.209,13.162,377163,123996,253167,3.816,11.608,50476,1.554,23.216,12834,13225,66496
2011,38,16341,20183,309739,303918,1937,9.703,1497,7.499,42831,12752,30079,4.196,14.093,31542,7895,23647,2.598,10.378,11289,3.714,20.757,943,959,4659
2011,39,168736,231356,4430024,4393314,18287,7.875,20032,8.626,545834,144289,401545,3.284,12.424,472838,148819,324019,3.387,10.763,72996,1.662,21.525,11929,12465,73829
2011,40,64626,83105,1262341,1249742,7468,8.987,7452,8.968,164554,48124,116430,3.851,13.167,139436,42896,96540,3.432,11.157,25118,2.010,22.314,4968,5125,23720
2011,41,77061,96622,1342098,1334336,9530,9.846,9864,10.191,167650,47271,120379,3.543,12.564,152221,50366,101855,3.775,11.408,15429,1.156,22.816,6254,6452,27355
2011,42,207438,274034,5064599,5020009,22266,8.128,22108,8.070,613537,183893,429644,3.663,12.222,523740,159303,364437,3.173,10.433,89797,1.789,20.866,13422,13790,71674
2011,44,21195,25222,403172,399665,2286,9.036,2440,9.645,49264,15578,33686,3.898,12.326,41909,15491,26418,3.876,10.486,7355,1.840,20.972,1522,1549,6843
2011,45,70161,93423,1532278,1518606,8466,9.017,9400,10.012,206442,64549,141893,4.251,13.594,178561,55307,123254,3.642,11.758,27881,1.836,23.516,6109,6290,32845
2011,46,19092,23195,325646,327317,1907,8.219,1921,8.279,34796,10136,24660,3.097,10.631,38211,10783,27428,3.294,11.674,-3415,-1.043,21.261,1242,1283,7064
2011,47,88785,122297,2301366,2285898,10598,8.624,11772,9.580,289895,78621,211274,3.439,12.682,258683,87707,170976,3.837,11.316,31212,1.365,22.633,7443,7691,43180
2011,48,356056,486002,8960005,8874350,50981,10.535,46792,9.670,1314720,435660,879060,4.909,14.815,1143342,349549,793793,3.939,12.884,171378,1.931,25.767,30135,31005,182263
2011,49,48798,60132,1021647,1017471,7322,12.197,7121,11.862,138200,46492,91708,4.569,13.583,129800,42378,87422,4.165,12.757,8400,0.826,25.514,4447,4554,24595
2011,50,16054,18920,255682,258065,1557,8.184,1765,9.278,27322,7354,19968,2.850,10.587,32509,8061,24448,3.124,12.597,-5187,-2.010,21.175,1126,1147,4730
2011,51,132245,176545,3037251,3024855,17392,9.850,17451,9.883,397927,127083,270844,4.201,13.155,373160,114295,258865,3.779,12.336,24767,0.819,24.673,10747,11060,54044
2011,53,124480,156226,2289685,2278795,16055,10.230,17492,11.145,307274,92264,215010,4.049,13.484,284566,88905,195661,3.901,12.488,22708,0.996,24.975,11169,11508,49623
2011,54,26748,35938,571208,567957,2743,7.600,3051,8.453,68749,17608,51141,3.100,12.105,61910,17324,44586,3.050,10.900,6839,1.204,21.801,1980,2043,11289
2011,55,97056,126286,2357635,2341274,9543,7.523,10667,8.409,255245,63613,191632,2.717,10.902,222076,63370,158706,2.707,9.485,33169,1.417,18.971,6703,6935,35215
2011,56,15412,18168,206120,204090,1884,10.421,1706,9.436,30785,8623,22162,4.225,15.084,26522,8120,18402,3.979,12.995,4263,2.089,25.991,1094,1104,4573
2012,01,67990,91821,1586718,1589402,7795,8.484,7909,8.608,202157,56359,145798,3.546,12.719,208329,58629,149700,3.689,13.107,-6172,-0.388,25.438,4992,5131,30573
2012,02,13725,17431,257599,256208,1740,10.010,1642,9.447,37357,10578,26779,4.129,14.581,34481,7896,26585,3.082,13.458,2876,1.123,26.916,887,899,3461
2012,04,87797,117242,2138437,2126124,12965,11.058,12962,11.056,319527,101937,217590,4.795,15.029,296914,103641,193273,4.875,13.965,22613,1.064,27.930,7793,8018,43211
2012,05,45652,59802,976440,977162,5066,8.468,5116,8.551,117026,30858,86168,3.158,11.976,118639,34299,84340,3.510,12.141,-1613,-0.165,23.952,3304,3382,18771
2012,06,608167,768037,12860694,12725368,85040,11.129,77181,10.101,1872454,554404,1318050,4.357,14.714,1602034,549862,1052172,4.321,12.589,270420,2.125,25.179,47168,48295,270249
2012,08,107496,133531,2040365,2013719,15119,11.359,14249,10.706,297142,96181,200961,4.776,14.756,244913,87047,157866,4.323,12.162,52229,2.594,24.324,8453,8644,42626
2012,09,64490,80856,1461997,1449015,7056,8.739,6828,8.457,182647,50731,131916,3.501,12.605,156355,48159,108196,3.324,10.790,26292,1.814,21.581,4069,4139,22287
2012,10,16935,21585,366437,363435,2118,9.803,2158,9.988,48736,15893,32843,4.373,13.410,43111,14354,28757,3.950,11.862,5625,1.548,23.724,1214,1252,6331
2012,11,15710,20076,480958,476355,1846,9.195,1845,9.190,65770,17437,48333,3.661,13.807,56379,18633,37746,3.912,11.836,9391,1.971,23.671,856,869,10044
2012,12,354898,445801,6837295,6722858,57987,13.145,48631,11.024,1116000,404762,711238,6.021,16.600,888173,352411,535762,5.242,13.211,227827,3.389,26.422,30485,31313,210094
2012,13,148067,194820,3380024,3355396,21132,10.860,20662,10.618,476461,162880,313581,4.854,14.200,425968,155951,270017,4.648,12.695,50493,1.505,25.390,12327,12570,68750
2012,15,22683,29151,489433,485916,2311,7.897,2535,8.663,58523,17000,41523,3.499,12.044,51018,16466,34552,3.389,10.499,7505,1.545,20.999,1447,1477,7789
2012,16,31085,37877,494657,488289,3963,10.474,3880,10.255,71135,23356,47779,4.783,14.568,58165,21998,36167,4.505,11.912,12970,2.656,23.824,2379,2417,10473
2012,17,219304,279220,5103779,5065106,26770,9.593,26428,9.471,667665,195972,471693,3.869,13.182,589786,203472,386314,4.017,11.644,77879,1.538,23.288,15565,16101,86995
2012,18,98563,132823,2506936,2471486,11292,8.505,11170,8.414,335897,94726,241171,3.833,13.591,265112,82604,182508,3.342,10.727,70785,2.864,21.454,6654,6880,40911
2012,19,56163,73807,1282619,1270386,5731,7.779,5470,7.424,148683,36654,112029,2.885,11.704,124215,39331,84884,3.096,9.778,24468,1.926,19.555,3332,3405,18272
2012,20,52567,68055,1145349,1133731,5682,8.344,5762,8.462,145921,44790,101131,3.951,12.871,122397,36972,85425,3.261,10.796,23524,2.075,21.592,3454,3595,19259
2012,21,61614,83093,1480060,1463349,7019,8.453,6901,8.311,197766,57189,140577,3.908,13.515,164226,50415,113811,3.445,11.223,33540,2.292,22.445,4245,4389,23052
2012,22,74028,96848,1634896,1621364,8596,8.898,8110,8.395,222258,64240,158018,3.962,13.708,195856,57223,138633,3.529,12.080,26402,1.628,24.159,4933,5121,30254
2012,23,28232,35110,484198,481403,3196,9.091,3287,9.350,56857,16971,39886,3.525,11.811,51581,16642,34939,3.457,10.715,5276,1.096,21.429,1937,2012,9175
2012,24,95819,122218,2150271,2132122,11520,9.455,10769,8.838,287023,85668,201355,4.018,13.462,249817,79594,170223,3.733,11.717,37206,1.745,23.434,6235,6383,34231
2012,25,122519,154939,3038674,3007486,14098,9.131,13006,8.424,362332,92496,269836,3.076,12.048,299450,99469,199981,3.307,9.957,62882,2.091,19.914,7485,7705,46527
2012,26,151563,196221,3471978,3427531,17191,8.764,17080,8.707,475066,121489,353577,3.545,13.860,388623,137967,250656,4.025,11.338,86443,2.522,22.677,10252,10562,73370
2012,27,100426,128594,2459924,2427323,11328,8.821,10993,8.560,307514,71717,235797,2.955,12.669,240673,77078,163595,3.175,9.915,66841,2.754,19.830,6461,6658,42591
2012,28,41361,55086,898932,895799,4369,7.909,4682,8.475,102473,30374,72099,3.391,11.439,96053,26319,69734,2.938,10.723,6420,0.717,21.445,2991,3062,14998
2012,29,101326,133544,2312061,2294903,12684,9.486,13028,9.743,288593,84803,203790,3.695,12.575,255054,79282,175772,3.455,11.114,33539,1.461,22.228,8226,8591,39259
2012,30,26754,31556,342329,338583,3262,10.393,2923,9.313,45869,14542,31327,4.295,13.547,38344,12090,26254,3.571,11.325,7525,2.222,22.650,1752,1780,6740
2012,31,37431,47527,776198,768304,3912,8.258,3607,7.614,94089,26117,67972,3.399,12.246,78620,21550,57070,2.805,10.233,15469,2.013,20.466,2204,2248,11888
2012,32,40924,52727,1018209,1007394,6506,12.372,6223,11.834,145462,48153,97309,4.780,14.439,123384,46601,76783,4.626,12.248,22078,2.192,24.496,3955,4108,28238
2012,33,27444,33985,548446,551743,3082,9.089,2930,8.641,62459,19124,43335,3.466,11.320,68617,28075,40542,5.088,12.436,-6158,-1.116,22.641,1780,1829,10589
2012,34,170978,205889,3438342,3410901,21615,10.540,19985,9.745,460639,138060,322579,4.048,13.505,406092,135417,270675,3.970,11.906,54547,1.599,23.811,12640,12851,66256
2012,35,31647,40379,595924,595256,3764,9.321,3770,9.336,76205,24945,51260,4.191,12.802,74630,21312,53318,3.580,12.537,1575,0.265,25.075,2318,2424,10989
2012,36,393621,469078,7516007,7433610,50853,10.915,44500,9.551,975290,290373,684917,3.906,13.120,809687,268720,540967,3.615,10.892,165603,2.228,21.784,30149,30601,147018
2012,37,149229,198646,3339118,3303474,19402,9.788,18555,9.361,444880,128108,316772,3.878,13.467,373499,120601,252898,3.651,11.306,71381,2.161,22.613,11185,11443,62880
2012,38,17019,20979,333242,321625,2298,11.166,1499,7.284,55878,16445,39433,5.113,17.374,32130,9810,22320,3.050,9.990,23748,7.384,19.980,979,995,5714
2012,39,168812,231225,4527676,4478570,18900,8.172,18980,8.207,592851,154415,438436,3.448,13.238,492364,161118,331246,3.598,10.994,100487,2.244,21.988,10967,11385,75294
2012,40,65155,83753,1305851,1284567,7798,9.347,7140,8.559,191727,68363,123364,5.322,14.925,149967,47197,102770,3.674,11.675,41760,3.251,23.349,4481,4610,24465
2012,41,77594,96901,1368717,1355134,9650,9.974,9352,9.666,178423,54038,124385,3.988,13.166,151396,48293,103103,3.564,11.172,27027,1.994,22.344,5485,5573,25121
2012,42,208341,274485,5153607,5110066,22274,8.122,21798,7.948,631833,171117,460716,3.349,12.364,542983,169957,373026,3.326,10.626,88850,1.739,21.252,12747,13149,76824
2012,44,21231,25210,404784,404145,2335,9.260,2347,9.308,47106,13571,33535,3.358,11.656,46168,13258,32910,3.281,11.424,938,0.232,22.847,1402,1419,6773
2012,45,70245,93402,1556835,1541961,8330,8.921,8276,8.863,205079,57982,147097,3.760,13.300,175267,53292,121975,3.456,11.367,29812,1.933,22.733,5021,5160,24929
2012,46,19225,23432,335300,330488,2081,8.927,1837,7.881,42712,12794,29918,3.871,12.924,32942,9543,23399,2.888,9.968,9770,2.956,19.935,1206,1223,5250
2012,47,88468,122096,2357944,2330853,10659,8.723,10851,8.880,310271,87646,222625,3.760,13.311,256226,82889,173337,3.556,10.993,54045,2.319,21.986,6664,6838,39968
2012,48,362844,493745,9333012,9152403,53200,10.861,45376,9.264,1455666,465549,990117,5.087,15.905,1089762,357685,732077,3.908,11.907,365904,3.998,23.814,27512,28563,181898
2012,49,49765,61289,1058415,1040081,7640,12.585,6481,10.675,156879,48269,108610,4.641,15.083,119791,36712,83079,3.530,11.517,37088,3.566,23.035,4082,4174,22848
2012,50,16075,18975,266163,260868,1672,8.825,1615,8.524,36502,8634,27868,3.310,13.993,26339,8664,17675,3.321,10.097,10163,3.896,20.193,1030,1055,4986
2012,51,132856,176831,3100452,3069670,16648,9.423,16336,9.246,438678,121574,317104,3.960,14.291,376373,108373,268000,3.530,12.261,62305,2.030,24.522,9488,9763,49395
2012,53,124749,156224,2322205,2305491,16122,10.320,16112,10.314,310926,92109,218817,3.995,13.486,277186,85760,191426,3.720,12.023,33740,1.463,24.046,9685,9881,46733
2012,54,26554,35732,584292,577613,2668,7.446,2871,8.012,74236,19318,54918,3.344,12.852,60854,18314,42540,3.171,10.535,13382,2.317,21.071,1736,1791,8738
2012,55,96813,126124,2389996,2374569,10003,7.927,10142,8.037,265149,68414,196735,2.881,11.166,234326,67812,166514,2.856,9.868,30823,1.298,19.736,6183,6363,35061
2012,56,15571,18350,212326,209924,1861,10.193,1676,9.180,32358,9852,22506,4.693,15.414,27570,10487,17083,4.996,13.133,4788,2.281,26.267,1078,1110,6261
2013,01,67641,91529,1599230,1592128,7518,8.202,7784,8.492,195095,54555,140540,3.427,12.254,181094,62029,119065,3.896,11.374,14001,0.879,22.749,4874,4961,29585
2013,02,13799,17551,265056,261307,1747,9.988,1626,9.296,34631,9741,24890,3.728,13.253,27306,7333,19973,2.806,10.450,7325,2.803,20.900,940,958,3381
2013,04,88532,118345,2180563,2159434,13028,11.062,11889,10.095,307524,101953,205571,4.721,14.241,265296,89129,176167,4.127,12.285,42228,1.956,24.571,7378,7471,43493
2013,05,45511,59856,978658,977916,5217,8.719,5173,8.646,116846,36538,80308,3.736,11.948,114834,41181,73653,4.211,11.743,2012,0.206,23.485,3370,3481,19459
2013,06,614026,774962,13284839,13071093,84582,10.965,77406,10.035,1976069,655001,1321068,5.011,15.118,1548194,553965,994229,4.238,11.844,427875,3.273,23.689,48593,49488,280551
2013,08,109053,135316,2100757,2071734,15531,11.555,13713,10.203,306288,96172,210116,4.642,14.784,247903,87295,160608,4.214,11.966,58385,2.818,23.932,8403,8492,43920
2013,09,64256,80789,1465871,1463999,6933,8.579,6973,8.629,159562,46262,113300,3.160,10.899,155920,46142,109778,3.152,10.650,3642,0.249,21.301,4246,4304,22389
2013,10,16971,21674,375260,370788,2095,9.691,1982,9.168,52562,18681,33881,5.038,14.176,44223,16789,27434,4.528,11.927,8339,2.249,23.854,1150,1163,5977
2013,11,15920,20471,487584,484116,2177,10.741,1770,8.733,57619,19530,38089,4.034,11.902,51247,16504,34743,3.409,10.586,6372,1.316,21.171,883,892,6470
2013,12,361078,452887,7068672,6971761,55901,12.442,48729,10.846,1061609,385467,676142,5.529,15.227,864691,302177,562514,4.334,12.403,196918,2.825,24.806,31594,32046,164197
2013,13,149128,196170,3444825,3414093,20514,10.494,19127,9.785,467872,141041,326831,4.131,13.704,406012,152367,253645,4.463,11.892,61860,1.812,23.784,11820,12000,67832
2013,15,22737,29247,502356,496015,2495,8.547,2386,8.173,60678,19383,41295,3.908,12.233,47929,18785,29144,3.787,9.663,12749,2.570,19.326,1408,1455,10415
2013,16,31304,38142,515471,505379,3982,10.478,3706,9.752,73537,22923,50614,4.536,14.551,53716,19136,34580,3.786,10.629,19821,3.922,21.258,2406,2423,11584
2013,17,219160,279427,5167473,5135850,26358,9.438,26076,9.337,637463,197663,439800,3.849,12.412,575347,191691,383656,3.732,11.203,62116,1.209,22.405,16009,16303,98810
2013,18,97989,132290,2545897,2527383,10342,7.803,10850,8.186,302235,82449,219786,3.262,11.958,265365,78907,186458,3.122,10.500,36870,1.459,20.999,6783,6885,41387
2013,19,55625,73591,1297734,1289935,5396,7.322,5597,7.595,136278,39082,97196,3.030,10.565,120551,31734,88817,2.460,9.346,15727,1.219,18.691,3444,3489,16767
2013,20,52198,67743,1160276,1151911,5458,8.040,5746,8.464,141830,40705,101125,3.534,12.313,125586,39575,86011,3.436,10.902,16244,1.410,21.805,3560,3593,19932
2013,21,61733,83477,1504348,1492825,7341,8.817,6910,8.299,192681,62970,129711,4.218,12.907,169294,51234,118060,3.432,11.341,23387,1.567,22.681,4325,4391,25177
2013,22,74047,97015,1683564,1658855,8168,8.427,8000,8.253,243138,73455,169683,4.428,14.657,192889,65510,127379,3.949,11.628,50249,3.029,23.256,5040,5112,35101
2013,23,28113,35079,485354,485420,3063,8.729,3081,8.781,54920,16563,38357,3.412,11.314,54776,19013,35763,3.917,11.284,144,0.030,22.568,1803,1836,9757
2013,24,95959,122910,2186888,2170373,11598,9.464,10877,8.876,285795,95957,189838,4.421,13.168,253199,83356,169843,3.841,11.666,32596,1.502,23.332,6467,6627,45122
2013,25,122966,155674,3086775,3063548,13754,8.858,12957,8.345,347613,100064,247549,3.266,11.347,300519,95154,205365,3.106,9.810,47094,1.537,19.619,7714,7862,42261
2013,26,151342,195858,3520181,3488006,16480,8.408,16784,8.563,436213,126823,309390,3.636,12.506,371946,117712,254234,3.375,10.664,64267,1.843,21.327,10398,10521,61572
2013,27,100448,129126,2513027,2493140,11160,8.662,10576,8.209,301955,78547,223408,3.151,12.111,262763,67405,195358,2.704,10.539,39192,1.572,21.079,6427,6486,35521
2013,28,41106,54866,898225,896690,4265,7.763,4411,8.029,97398,29666,67732,3.308,10.862,94026,26456,67570,2.950,10.486,3372,0.376,20.972,2908,2956,16445
2013,29,103264,135827,2348452,2332874,13868,10.278,12070,8.946,278926,88058,190868,3.775,11.956,247115,77869,169246,3.338,10.593,31811,1.364,21.185,7684,7850,38185
2013,30,26958,31831,353398,347698,3227,10.182,2949,9.305,49197,17959,31238,5.165,14.149,38094,12661,25433,3.641,10.956,11103,3.193,21.912,1885,1912,7847
2013,31,37404,47659,779981,778391,3859,8.110,3712,7.801,88285,25045,63240,3.218,11.342,85497,26608,58889,3.418,10.984,2788,0.358,21.968,2293,2319,12913
2013,32,41444,53342,1053384,1035090,6558,12.375,5864,11.065,163191,60553,102638,5.850,15.766,127123,47644,79479,4.603,12.281,36068,3.485,24.563,3864,3952,25908
2013,33,27365,34057,551939,550138,2901,8.528,2818,8.284,63648,19928,43720,3.622,11.569,59705,18813,40892,3.420,10.853,3943,0.717,21.705,1792,1808,8705
2013,34,171254,206706,3476220,3457155,20865,10.114,20030,9.710,461535,138076,323459,3.994,13.350,423761,140270,283491,4.057,12.258,37774,1.093,24.515,13117,13317,73805
2013,35,31497,40272,593780,594925,3620,8.981,3695,9.167,79723,28681,51042,4.821,13.401,81988,28018,53970,4.710,13.781,-2265,-0.381,26.801,2355,2384,12545
2013,36,396517,471833,7643984,7585040,49289,10.478,46403,9.865,980453,312693,667760,4.122,12.926,861686,291851,569835,3.848,11.360,118767,1.566,22.721,31016,31487,162932
2013,37,149340,199481,3394451,3365813,18927,9.509,18032,9.060,441867,145999,295868,4.338,13.128,384001,127087,256914,3.776,11.409,57866,1.719,22.818,11341,11507,60930
2013,38,17385,21540,344251,338620,2276,10.707,1709,8.040,52387,18467,33920,5.454,15.471,41441,14960,26481,4.418,12.238,10946,3.233,24.476,1137,1140,7272
2013,39,167597,230504,4565029,4547293,18093,7.839,18729,8.114,547516,153263,394253,3.370,12.040,511838,167584,344254,3.685,11.256,35678,0.785,22.512,11189,11448,68179
2013,40,65522,84287,1331578,1318430,7672,9.133,7113,8.467,176881,58663,118218,4.449,13.416,150404,51936,98468,3.939,11.408,26477,2.008,22.816,4534,4650,27842
2013,41,78374,97993,1399791,1384359,9810,10.068,8692,8.921,183048,56010,127038,4.046,13.223,153151,54014,99137,3.902,11.063,29897,2.160,22.126,5394,5478,24946
2013,42,207679,275191,5166294,5163709,22367,8.137,21724,7.903,590069,182360,407709,3.532,11.427,585169,174454,410715,3.378,11.332,4900,0.095,22.665,13157,13340,88731
2013,44,21084,25150,409144,406941,2178,8.651,2233,8.869,45627,13252,32375,3.256,11.212,40949,12910,28039,3.172,10.063,4678,1.150,20.125,1404,1420,7194
2013,45,70457,93636,1582880,1569661,8337,8.917,8065,8.626,194814,58802,136012,3.746,12.411,167992,50735,117257,3.232,10.702,26822,1.709,21.405,5076,5189,26227
2013,46,19285,23543,340274,337648,1922,8.185,1802,7.674,40610,11458,29152,3.393,12.027,35378,12597,22781,3.731,10.478,5232,1.550,20.956,1166,1176,5640
2013,47,88526,122435,2403840,2380850,10873,8.895,10485,8.577,314831,93167,221664,3.913,13.223,267971,81009,186962,3.403,11.255,46860,1.968,22.511,6548,6708,39000
2013,48,368941,501996,9637511,9495589,52967,10.640,44575,8.954,1449707,461920,987787,4.865,15.267,1165380,391817,773563,4.126,12.273,284327,2.994,24.546,27942,28521,184001
2013,49,50831,62608,1094801,1075973,7481,12.078,6143,9.918,159605,56390,103215,5.241,14.834,123040,42640,80400,3.963,11.435,36565,3.398,22.870,3778,3826,22232
2013,50,15952,18885,258989,262401,1454,7.684,1531,8.090,28842,8192,20650,3.122,10.992,35231,16495,18736,6.286,13.426,-6389,-2.435,21.983,973,974,13067
2013,51,133234,177794,3119812,3107053,16970,9.572,15960,9.002,409245,133614,275631,4.300,13.171,385083,121104,263979,3.898,12.394,24162,0.778,24.788,9303,9475,50582
2013,53,126044,157739,2412388,2377144,16710,10.646,15142,9.647,350233,122956,227277,5.172,14.733,280056,95155,184901,4.003,11.781,70177,2.952,23.562,9435,9576,44096
2013,54,26049,35263,577471,579918,2543,7.167,2978,8.393,65802,18405,47397,3.174,11.347,70513,25326,45187,4.367,12.159,-4711,-0.812,22.694,1823,1845,9875
2013,55,96174,125655,2412869,2401217,9628,7.649,10063,7.995,257564,67743,189821,2.821,10.726,234051,67997,166054,2.832,9.747,23513,0.979,19.494,6078,6183,34168
2013,56,15516,18354,213087,212581,1757,9.576,1743,9.500,28750,10448,18302,4.915,13.524,27779,8967,18812,4.218,13.067,971,0.457,26.135,1125,1137,5163
2014,01,67545,91964,1603842,1600049,7404,8.069,6992,7.620,190215,59773,130442,3.736,11.888,183165,52822,130343,3.301,11.447,7050,0.441,22.895,4533,4655,26457
2014,02,13829,17717,266063,264832,1758,9.969,1595,9.044,37253,13114,24139,4.952,14.067,34478,8850,25628,3.342,13.019,2775,1.048,26.038,955,962,3936
2014,04,89439,120282,2234548,2208534,13364,11.200,11451,9.596,340438,114105,226333,5.167,15.415,287796,86715,201081,3.926,13.031,52642,2.384,26.062,7244,7373,43640
2014,05,45401,59871,987102,983150,4850,8.102,4838,8.082,113686,35555,78131,3.616,11.563,105969,38736,67233,3.940,10.779,7717,0.785,21.557,3239,3296,16382
2014,06,625156,789665,13644868,13459830,88251,11.280,73702,9.420,1991239,651740,1339499,4.842,14.794,1624024,569075,1054949,4.228,12.066,367215,2.728,24.131,47581,48497,271848
2014,08,111076,138202,2182521,2141315,16093,11.767,13221,9.667,327916,109622,218294,5.119,15.314,245068,81777,163291,3.819,11.445,82848,3.869,22.889,8461,8535,41474
2014,09,64072,81008,1482320,1474458,6876,8.498,6679,8.255,168223,51123,117100,3.467,11.409,152968,50104,102864,3.398,10.375,15255,1.035,20.749,4190,4231,20215
2014,10,17115,21826,386063,380777,2090,9.609,1938,8.910,52197,15224,36973,3.998,13.708,41477,15430,26047,4.052,10.893,10720,2.815,21.785,1124,1146,5626
2014,11,16062,20752,493435,490126,1997,9.689,1715,8.321,59918,20220,39698,4.125,12.225,53211,14552,38659,2.969,10.857,6707,1.368,21.713,931,945,5936
2014,12,367081,461310,7279934,7163174,57086,12.488,48712,10.656,1122764,401618,721146,5.607,15.674,890874,333793,557081,4.660,12.437,231890,3.237,24.874,32065,32602,172692
2014,13,150393,198917,3524555,3484661,21195,10.728,18478,9.353,476712,148473,328239,4.261,13.680,395068,146094,248974,4.192,11.337,81644,2.343,22.675,11808,12021,84863
2014,15,22725,29476,519158,510753,2487,8.469,2264,7.710,62813,22776,40037,4.459,12.298,46465,15027,31438,2.942,9.097,16348,3.201,18.195,1507,1524,8182
2014,16,31996,39041,532969,523632,4219,10.932,3321,8.605,77380,23037,54343,4.399,14.778,58731,22527,36204,4.302,11.216,18649,3.561,22.432,2166,2207,9269
2014,17,219129,280657,5306086,5238029,26247,9.372,25074,8.953,673400,230981,442419,4.410,12.856,539479,182346,357133,3.481,10.299,133921,2.557,20.599,15740,16004,85002
2014,18,97386,132289,2607915,2576711,10615,8.024,10616,8.025,309403,86966,222437,3.375,12.008,247361,74806,172555,2.903,9.600,62042,2.408,19.200,6666,6784,40103
2014,19,55539,73678,1308781,1303353,5272,7.159,5191,7.049,124384,36907,87477,2.832,9.543,113504,32547,80957,2.497,8.709,10880,0.835,17.417,3330,3426,17459
2014,20,52371,68165,1175670,1167509,5725,8.424,5312,7.817,144631,47382,97249,4.058,12.388,128398,41725,86673,3.574,10.998,16233,1.390,21.995,3367,3444,18407
2014,21,62234,84567,1533970,1519645,7791,9.271,6729,8.007,198638,66982,131656,4.408,13.071,168581,47607,120974,3.133,11.093,30057,1.978,22.187,4296,4396,24223
2014,22,74102,97561,1706189,1697720,8216,8.445,7679,7.893,214041,68787,145254,4.052,12.608,196313,68619,127694,4.042,11.563,17728,1.044,23.127,4898,4994,32463
2014,23,28202,35308,493194,489380,3158,8.973,2933,8.333,56211,20955,35256,4.282,11.486,48691,14257,34434,2.913,9.950,7520,1.537,19.899,1758,1786,7338
2014,24,96143,123926,2209850,2198417,11770,9.536,10776,8.731,260516,79031,181485,3.595,11.850,238304,71369,166935,3.246,10.840,22212,1.010,21.680,6598,6669,33489
2014,25,123691,156935,3095479,3084158,13605,8.704,12357,7.905,338729,106673,232056,3.459,10.983,318551,85931,232620,2.786,10.329,20178,0.654,20.657,7744,7956,42688
2014,26,151282,196403,3596244,3556103,16545,8.436,16006,8.161,441567,123615,317952,3.476,12.417,359899,115425,244474,3.246,10.121,81668,2.297,20.241,10288,10518,62820
2014,27,100991,130634,2561204,2538223,11540,8.884,10071,7.753,284959,80402,204557,3.168,11.227,238540,66509,172031,2.620,9.398,46419,1.829,18.796,6324,6463,39296
2014,28,41058,55077,908010,902985,4406,8.014,4210,7.657,99311,31150,68161,3.450,10.998,89252,26210,63042,2.903,9.884,10059,1.114,19.768,2818,2872,14571
2014,29,105579,138867,2400457,2375113,14995,10.907,12212,8.883,280843,85299,195544,3.591,11.824,229212,68648,160564,2.890,9.651,51631,2.174,19.301,8090,8201,38113
2014,30,27095,32082,362508,357933,3126,9.782,2878,9.006,48892,14647,34245,4.092,13.660,39481,15004,24477,4.192,11.030,9411,2.629,22.061,1847,1862,7569
2014,31,37846,48282,793756,786278,3951,8.235,3341,6.964,86197,24807,61390,3.155,10.963,70978,22605,48373,2.875,9.027,15219,1.936,18.054,2093,2152,10590
2014,32,42452,54731,1087306,1071545,6974,12.905,5596,10.355,151172,50994,100178,4.759,14.108,119355,45999,73356,4.293,11.139,31817,2.969,22.277,3660,3698,21805
2014,33,27293,34285,564749,558213,2915,8.530,2694,7.883,64894,25033,39861,4.484,11.625,51071,16337,34734,2.927,9.149,13823,2.476,18.298,1719,1759,8226
2014,34,171181,207514,3517013,3501197,20766,10.026,19981,9.647,440487,147974,292513,4.226,12.581,407653,128376,279277,3.667,11.643,32834,0.938,23.286,13277,13453,69773
2014,35,31321,40249,615790,604820,3497,8.685,3526,8.757,87770,39853,47917,6.589,14.512,66701,21285,45416,3.519,11.028,21069,3.484,22.056,2309,2345,11797
2014,36,399031,476058,7829922,7740865,49916,10.532,45732,9.649,1022464,355777,666687,4.596,13.209,844735,281582,563153,3.638,10.913,177729,2.296,21.825,31910,32243,163712
2014,37,149743,200697,3454780,3425054,18811,9.401,17618,8.805,419290,129290,290000,3.775,12.242,360841,124665,236176,3.640,10.535,58449,1.707,21.071,11169,11412,58724
2014,38,17762,22136,360175,352121,2290,10.484,1702,7.792,53945,18637,35308,5.293,15.320,37554,11316,26238,3.214,10.665,16391,4.655,21.330,1175,1183,5630
2014,39,166879,231284,4628344,4598356,18064,7.822,17345,7.511,527843,159917,367926,3.478,11.479,467979,128570,339409,2.796,10.177,59864,1.302,20.354,10695,11009,64978
2014,40,65867,85095,1355447,1343306,7642,9.023,6849,8.086,179192,56192,123000,4.183,13.340,154149,58089,96060,4.324,11.475,25043,1.864,22.951,4607,4672,27805
2014,41,79400,99482,1438240,1419170,9920,10.046,8448,8.555,186222,57375,128847,4.043,13.122,148247,48513,99734,3.418,10.446,37975,2.676,20.892,5454,5530,23897
2014,42,207230,275651,5242164,5204473,22046,8.004,21609,7.845,583458,180863,402595,3.475,11.211,510622,156718,353904,3.011,9.811,72836,1.399,19.622,13174,13500,77091
2014,44,20988,25190,420976,414993,2213,8.793,2170,8.622,50984,17468,33516,4.209,12.286,38885,12219,26666,2.944,9.370,12099,2.915,18.740,1371,1381,6841
2014,45,70742,94411,1616291,1593466,8651,9.201,7882,8.383,202649,63089,139560,3.959,12.718,156723,47689,109034,2.993,9.835,45926,2.882,19.671,5077,5175,25718
2014,46,19333,23641,347112,343690,1894,8.028,1797,7.617,38647,11264,27383,3.277,11.245,31628,9046,22582,2.632,9.202,7019,2.042,18.405,1192,1212,5484
2014,47,88478,123390,2455983,2430617,10911,8.876,9994,8.130,298104,92754,205350,3.816,12.265,246966,76885,170081,3.163,10.161,51138,2.104,20.321,6447,6569,36562
2014,48,375758,513031,9937698,9790418,55194,10.874,44248,8.718,1458185,497418,960767,5.081,14.894,1162802,398934,763868,4.075,11.877,295383,3.017,23.754,28174,28902,183285
2014,49,52071,64096,1144349,1122815,7615,12.019,6136,9.685,166376,55442,110934,4.938,14.818,122494,38569,83925,3.435,10.910,43882,3.908,21.819,3911,3971,22073
2014,50,15938,18904,261545,260287,1524,8.065,1510,7.991,27671,7495,20176,2.880,10.631,25211,8094,17117,3.110,9.686,2460,0.945,19.372,966,1000,5485
2014,51,133653,179284,3141417,3129490,16816,9.418,15344,8.594,389240,130524,258716,4.171,12.438,363575,109839,253736,3.510,11.618,25665,0.820,23.235,9560,9715,45799
2014,53,127852,160228,2482427,2447505,16618,10.452,14162,8.907,324303,95791,228512,3.914,13.250,253096,80526,172570,3.290,10.341,71207,2.909,20.682,9161,9307,41963
2014,54,25512,34869,574099,575651,2421,6.903,2829,8.066,64086,21086,43000,3.663,11.133,66765,20401,46364,3.544,11.598,-2679,-0.465,22.266,1783,1811,9255
2014,55,96213,126276,2442238,2416983,9778,7.762,9187,7.292,258549,72221,186328,2.988,10.697,208292,59089,149203,2.445,8.618,50257,2.079,17.236,5834,5961,31015
2014,56,15570,18485,218554,215817,1726,9.371,1592,8.644,30789,8999,21790,4.170,14.266,25069,7976,17093,3.696,11.616,5720,2.650,23.232,1057,1060,3651
2015,01,67451,92473,1638842,1620844,7768,8.423,7266,7.879,199296,64386,134910,3.972,12.296,164000,51736,112264,3.192,10.118,35296,2.178,20.236,4657,4813,27497
2015,02,13927,17918,265868,265891,1780,9.991,1575,8.841,36050,10600,25450,3.987,13.558,36492,11553,24939,4.345,13.724,-442,-0.166,27.116,955,967,4186
2015,04,90715,121967,2305949,2270172,13330,11.006,11636,9.607,330705,111864,218841,4.928,14.567,259390,89046,170344,3.922,11.426,71315,3.141,22.852,7154,7346,42027
2015,05,45344,60172,1001859,994666,5136,8.556,4844,8.070,120356,38811,81545,3.902,12.100,106547,33927,72620,3.411,10.712,13809,1.388,21.424,3128,3193,17654
2015,06,635400,803273,14093341,13869142,89511,11.239,75849,9.523,2020001,675502,1344499,4.871,14.565,1569945,553999,1015946,3.994,11.320,450056,3.245,22.639,49649,50566,303808
2015,08,113246,140963,2260078,2217581,16699,11.965,13914,9.969,333602,110763,222839,4.995,15.044,248049,90016,158033,4.059,11.186,85553,3.858,22.371,8776,8876,45694
2015,09,63849,81094,1500631,1493041,6899,8.512,6811,8.403,175786,57905,117881,3.878,11.774,161383,48662,112721,3.259,10.809,14403,0.965,21.618,4201,4260,24615
2015,10,17311,22057,393142,389885,2243,10.218,2031,9.252,54324,17851,36473,4.579,13.933,47566,16652,30914,4.271,12.200,6758,1.733,24.400,1162,1182,6458
2015,11,16288,20946,506377,499895,2206,10.582,2007,9.628,73686,26884,46802,5.378,14.740,59833,18669,41164,3.735,11.969,13853,2.771,23.938,993,1006,7528
2015,12,375180,471653,7622000,7464352,59231,12.697,48899,10.482,1158813,404762,754051,5.423,15.525,841228,330367,510861,4.426,11.270,317585,4.255,22.540,31820,32459,182144
2015,13,152509,201952,3677062,3607513,21680,10.816,18647,9.303,538048,179466,358582,4.975,14.915,398889,140124,258765,3.884,11.057,139159,3.857,22.114,11592,11888,72753
2015,15,22752,29573,522970,520999,2474,8.380,2370,8.028,55238,17403,37835,3.340,10.602,51727,16965,34762,3.256,9.928,3511,0.674,19.857,1498,1517,9489
2015,16,32522,39786,548700,541092,4205,10.668,3468,8.798,72399,22438,49961,4.147,13.380,57594,21628,35966,3.997,10.644,14805,2.736,21.288,2238,2270,10376
2015,17,220584,282498,5369393,5318569,26779,9.510,24941,8.858,710011,203346,506665,3.823,13.350,607857,221621,386236,4.167,11.429,102154,1.921,22.858,15269,15672,85708
2015,18,97699,133800,2671133,2638862,11540,8.674,10024,7.534,329471,98865,230606,3.747,12.485,264114,73742,190372,2.794,10.009,65357,2.477,20.017,6282,6472,38507
2015,19,55775,74184,1330843,1319980,5711,7.723,5242,7.089,144224,42809,101415,3.243,10.926,121463,35630,85833,2.699,9.202,22761,1.724,18.404,3263,3336,16549
2015,20,52369,68482,1189553,1181642,5780,8.461,5450,7.978,151275,50219,101056,4.250,12.802,136038,37530,98508,3.176,11.513,15237,1.289,23.025,3499,3611,19410
2015,21,62225,85211,1580146,1557746,7353,8.663,6679,7.869,197656,58012,139644,3.724,12.689,152986,46199,106787,2.966,9.821,44670,2.868,19.642,4318,4389,23764
2015,22,73993,98066,1720311,1712829,8406,8.594,7896,8.073,226170,75209,150961,4.391,13.204,213582,55125,158457,3.218,12.470,12588,0.735,24.939,5085,5184,29771
2015,23,28385,35604,500179,496619,3189,8.995,2885,8.138,57902,17344,40558,3.492,11.659,50548,17966,32582,3.618,10.178,7354,1.481,20.357,1796,1827,7925
2015,24,96328,124366,2237352,2223628,11409,9.190,10958,8.827,273605,91899,181706,4.133,12.304,245487,79033,166454,3.554,11.040,28118,1.265,22.080,6685,6800,36859
2015,25,124281,157861,3178315,3136865,13817,8.778,12891,8.190,375264,115958,259306,3.697,11.963,291557,91712,199845,2.924,9.295,83707,2.668,18.589,7876,8025,46485
2015,26,152002,198353,3724465,3666127,18048,9.144,16089,8.152,482349,148844,333505,4.060,13.157,364627,109747,254880,2.994,9.946,117722,3.211,19.892,10314,10582,61104
2015,27,101602,131952,2582781,2560518,11734,8.937,10427,7.941,299371,89628,209743,3.500,11.692,255789,72283,183506,2.823,9.990,43582,1.702,19.979,6474,6673,36333
2015,28,40877,55044,925890,917005,4280,7.773,4317,7.840,113821,42508,71313,4.636,12.412,95206,26631,68575,2.904,10.382,18615,2.030,20.765,2870,2926,16420
2015,29,107726,141549,2449111,2424299,15458,11.025,12774,9.111,308079,106520,201559,4.394,12.708,258492,81460,177032,3.360,10.663,49587,2.045,21.325,8277,8486,42553
2015,30,27468,32543,371430,367001,3207,9.922,2762,8.546,48496,15661,32835,4.267,13.214,39106,12332,26774,3.360,10.656,9390,2.559,21.311,1865,1906,7799
2015,31,38137,48889,811396,802700,4146,8.531,3563,7.332,92806,29705,63101,3.701,11.562,75831,22636,53195,2.820,9.447,16975,2.115,18.894,2226,2264,11770
2015,32,43567,56312,1125382,1106289,7175,12.917,5642,10.157,165351,66814,98537,6.039,14.946,126128,40433,85695,3.655,11.401,39223,3.545,22.802,3740,3813,23612
2015,33,27286,34424,577440,571022,2851,8.299,2713,7.897,65505,18727,46778,3.280,11.472,52819,15186,37633,2.659,9.250,12686,2.222,18.500,1732,1760,8510
2015,34,170536,207257,3554774,3531668,20212,9.747,20451,9.862,475585,165367,310218,4.682,13.466,427443,148695,278748,4.210,12.103,48142,1.363,24.206,13537,13736,85069
2015,35,31195,40419,627070,620945,3694,9.159,3523,8.735,78149,28110,50039,4.527,12.585,65886,19848,46038,3.196,10.611,12263,1.975,21.221,2230,2251,10747
2015,36,400937,478250,7983856,7906120,49406,10.354,47200,9.892,1041676,353962,687714,4.477,13.176,886978,298188,588790,3.772,11.219,154698,1.957,22.438,32404,32883,165996
2015,37,151553,203152,3564280,3508730,19415,9.615,16942,8.391,463420,151175,312245,4.309,13.208,353227,119119,234108,3.395,10.067,110193,3.141,20.134,10431,10602,61206
2015,38,17991,22543,365611,362911,2224,9.954,1825,8.168,46654,17653,29001,4.864,12.856,41368,10737,30631,2.959,11.399,5286,1.457,22.798,1267,1289,6791
2015,39,166740,232782,4696593,4663683,19296,8.316,17788,7.666,563005,172312,390693,3.695,12.072,497099,146923,350176,3.150,10.659,65906,1.413,21.318,10653,10955,73927
2015,40,65928,85674,1368496,1361634,7820,9.158,7243,8.483,172726,59268,113458,4.353,12.685,160312,54174,106138,3.979,11.774,12414,0.912,23.547,4824,4914,25682
2015,41,80984,101704,1495320,1467075,10402,10.341,8170,8.122,204433,64684,139749,4.409,13.935,147899,49809,98090,3.395,10.081,56534,3.854,20.162,5272,5329,26256
2015,42,207035,276421,5294649,5270905,22583,8.181,21841,7.912,609320,208554,400766,3.957,11.560,560644,179246,381398,3.401,10.637,48676,0.923,21.273,13158,13527,77278
2015,44,21180,25397,425397,422880,2319,9.169,2110,8.342,46390,13711,32679,3.242,10.970,41073,12532,28541,2.963,9.713,5317,1.257,19.425,1287,1308,7639
2015,45,71669,95813,1664993,1641778,9185,9.658,7759,8.159,213583,72764,140819,4.432,13.009,168152,56227,111925,3.425,10.242,45431,2.767,20.484,4997,5093,28310
2015,46,19562,24006,352519,349680,2089,8.767,1733,7.273,36661,11188,25473,3.199,10.484,31080,9897,21183,2.830,8.888,5581,1.596,17.776,1171,1196,6035
2015,47,88749,124678,2506715,2479051,11395,9.187,10101,8.144,312243,103279,208964,4.166,12.595,256991,80901,176090,3.263,10.367,55252,2.229,20.733,6368,6521,47444
2015,48,382238,522232,10257812,10103915,55596,10.740,46398,8.963,1506988,521380,985608,5.160,14.915,1200232,398689,801543,3.946,11.879,306756,3.036,23.758,29410,30263,191075
2015,49,53270,65810,1202460,1176586,7950,12.239,6240,9.607,181901,60060,121841,5.105,15.460,129851,40904,88947,3.477,11.036,52050,4.424,22.073,4052,4146,24246
2015,50,15999,19036,266906,264221,1505,7.934,1373,7.238,29011,8416,20595,3.185,10.980,23485,6918,16567,2.618,8.888,5526,2.091,17.777,933,944,4633
2015,51,134649,180802,3207974,3179787,17152,9.526,15644,8.689,408946,142433,266513,4.479,12.861,353173,113396,239777,3.566,11.107,55773,1.754,22.214,9413,9602,49477
2015,53,130211,163464,2561013,2520344,17567,10.854,14326,8.852,348835,115221,233614,4.572,13.841,267069,79005,188064,3.135,10.597,81766,3.244,21.193,9397,9542,44962
2015,54,25271,34766,566149,570711,2645,7.596,2758,7.920,60121,18088,42033,3.169,10.534,68512,18684,49828,3.274,12.005,-8391,-1.470,21.069,1767,1799,9381
2015,55,96675,127380,2495285,2468910,10196,8.040,9081,7.160,276969,79010,197959,3.200,11.218,222886,62099,160787,2.515,9.028,54083,2.191,18.055,5825,5930,33502
2015,56,15806,18750,219384,218824,1836,9.860,1576,8.464,28589,9502,19087,4.342,13.065,27551,7638,19913,3.490,12.590,1038,0.474,25.181,1042,1046,3858
2016,01,68122,93842,1680130,1659148,7846,8.423,6459,6.934,200773,67256,133517,4.054,12.101,157634,45576,112058,2.747,9.501,43139,2.600,19.002,4348,4464,24911
2016,02,14043,18137,264228,265159,1846,10.239,1629,9.036,34285,11954,22331,4.508,12.930,36192,10753,25439,4.055,13.649,-1907,-0.719,25.860,1009,1031,6445
2016,04,92508,124890,2400540,2353987,13818,11.194,10910,8.839,369285,130677,238608,5.551,15.688,277178,98207,178971,4.172,11.775,92107,3.913,23.550,6990,7198,57434
2016,05,45678,60952,1021131,1011435,5488,9.062,4706,7.771,124006,41895,82111,4.142,12.260,104495,31198,73297,3.085,10.331,19511,1.929,20.663,3176,3221,17753
2016,06,647243,820085,14382041,14226721,92230,11.363,75427,9.293,2040210,656021,1384189,4.611,14.341,1722144,647441,1074703,4.551,12.105,318066,2.236,24.210,51199,52196,318872
2016,08,115882,145026,2322251,2291243,17578,12.293,13511,9.449,324073,119934,204139,5.234,14.144,262807,85356,177451,3.725,11.470,61266,2.674,22.940,8790,8943,48342
2016,09,64552,82720,1544633,1522567,7865,9.602,6243,7.622,189153,66040,123113,4.337,12.423,143483,41965,101518,2.756,9.424,45670,3.000,18.848,4188,4235,20803
2016,10,17721,22673,400806,396859,2369,10.593,1750,7.825,54308,16835,37473,4.242,13.684,46374,12126,34248,3.055,11.685,7934,1.999,23.371,1134,1153,6412
2016,11,16559,21621,518535,512769,2291,10.763,1622,7.620,64481,20237,44244,3.947,12.575,52896,12442,40454,2.426,10.316,11585,2.259,20.632,986,1008,5803
2016,12,384636,486101,7892905,7764783,61185,12.777,46749,9.762,1138416,411474,726942,5.299,14.661,882837,315187,567650,4.059,11.370,255579,3.292,22.740,32199,32674,175169
2016,13,155497,206562,3806529,3747274,22252,10.894,17650,8.641,509564,175148,334416,4.674,13.598,391091,129319,261772,3.451,10.437,118473,3.162,20.873,11578,11845,71683
2016,15,22992,30016,528545,525837,2630,8.826,2193,7.360,59066,19235,39831,3.658,11.233,53273,13508,39765,2.569,10.131,5793,1.102,20.262,1425,1470,8232
2016,16,33231,40741,565610,556825,4425,10.993,3451,8.573,76504,23520,52984,4.224,13.739,58993,18047,40946,3.241,10.595,17511,3.145,21.189,2289,2345,10251
2016,17,222291,285723,5431728,5404238,27179,9.566,23971,8.437,659608,214954,444654,3.978,12.205,607384,160980,446404,2.979,11.239,52224,0.966,22.478,15861,16218,87766
2016,18,98257,135943,2728531,2700420,11530,8.548,9418,6.982,321434,99799,221635,3.696,11.903,265262,68549,196713,2.538,9.823,56172,2.080,19.646,6275,6458,38312
2016,19,56004,75059,1348770,1339485,5865,7.859,4997,6.696,137174,40393,96781,3.016,10.241,118681,31501,87180,2.352,8.860,18493,1.381,17.720,3295,3373,18129
2016,20,52610,69363,1191895,1190394,6090,8.836,5215,7.566,132847,46609,86238,3.915,11.160,129970,44177,85793,3.711,10.918,2877,0.242,21.836,3487,3619,22603
2016,21,62287,85802,1610696,1595436,7086,8.288,6486,7.586,192105,58939,133166,3.694,12.041,161618,47321,114297,2.966,10.130,30487,1.911,20.260,4380,4568,25212
2016,22,73943,98863,1702636,1711258,8618,8.752,7819,7.941,199037,72341,126696,4.227,11.631,216892,57238,159654,3.345,12.674,-17855,-1.043,23.262,5283,5406,32395
2016,23,29077,36459,511307,506031,3486,9.674,2634,7.310,57532,19532,38000,3.860,11.369,47042,15386,31656,3.041,9.296,10490,2.073,18.593,1741,1781,9159
2016,24,97434,126475,2289179,2264021,11923,9.507,9809,7.821,273363,86223,187140,3.808,12.074,223492,68525,154967,3.027,9.871,49871,2.203,19.743,6404,6533,36666
2016,25,126499,161366,3242059,3208603,15208,9.528,11705,7.333,370580,106335,264245,3.314,11.550,306312,83648,222664,2.607,9.547,64268,2.003,19.093,7906,8047,46656
2016,26,153492,201091,3812256,3769297,17758,8.892,15000,7.511,462979,138049,324930,3.662,12.283,376551,112148,264403,2.975,9.990,86428,2.293,19.980,10176,10462,71136
2016,27,102476,134099,2633934,2607264,12097,9.094,9930,7.465,322346,102596,219750,3.935,12.363,268038,82480,185558,3.163,10.280,54308,2.083,20.561,6644,6778,45563
2016,28,40908,55391,943651,934972,4469,8.093,4127,7.474,111860,35615,76245,3.809,11.964,95049,26501,68548,2.834,10.166,16811,1.798,20.332,2743,2817,14315
2016,29,109995,145111,2494409,2471568,15879,11.076,12378,8.634,299893,98416,201477,3.982,12.134,254162,85047,169115,3.441,10.283,45731,1.850,20.567,8469,8597,42199
2016,30,27676,32984,375435,373237,3206,9.786,2760,8.425,44591,16144,28447,4.325,11.947,40550,11928,28622,3.196,10.864,4041,1.083,21.729,1901,1908,8186
2016,31,38614,49629,826519,818965,4169,8.464,3427,6.957,89498,27659,61839,3.377,10.928,74688,21943,52745,2.679,9.120,14810,1.808,18.240,2215,2279,12270
2016,32,44695,57988,1162804,1146494,7232,12.654,5561,9.730,159093,58096,100997,5.067,13.876,127146,45026,82120,3.927,11.090,31947,2.786,22.180,3769,3862,28710
2016,33,27627,35008,594926,586298,3035,8.743,2449,7.055,66622,18972,47650,3.236,11.363,49453,13695,35758,2.336,8.435,17169,2.928,16.870,1707,1732,8289
2016,34,171829,209916,3635328,3597293,21323,10.222,18681,8.956,477964,151097,326867,4.200,13.287,400539,132106,268433,3.672,11.134,77425,2.152,22.269,13159,13297,74561
2016,35,31072,40526,630384,628831,3555,8.784,3447,8.517,74962,26456,48506,4.207,11.921,72076,21808,50268,3.468,11.462,2886,0.459,22.924,2252,2327,12448
2016,36,405407,484966,8152463,8067742,51703,10.736,44969,9.337,1027102,326389,700713,4.046,12.731,858446,307043,551403,3.806,10.640,168656,2.090,21.281,32967,33376,196740
2016,37,154670,208021,3679741,3622084,20674,10.056,15806,7.688,480890,156938,323952,4.333,13.277,367321,111902,255419,3.089,10.141,113569,3.135,20.282,10482,10689,68947
2016,38,17793,22541,347909,357056,1925,8.540,1927,8.548,34526,12699,21827,3.557,9.670,52837,10656,42181,2.984,14.798,-18311,-5.128,19.339,1353,1377,6727
2016,39,166860,236265,4785014,4740848,19753,8.422,16281,6.942,555046,168975,386071,3.564,11.708,467169,129390,337779,2.729,9.854,87877,1.854,19.708,10716,11063,71284
2016,40,65645,86201,1359968,1364093,7963,9.266,7434,8.651,164578,58238,106340,4.269,12.065,173491,45139,128352,3.309,12.718,-8913,-0.653,24.130,5085,5176,26878
2016,41,82746,104083,1550112,1524269,10712,10.411,8337,8.102,197749,61261,136488,4.019,12.973,146916,47710,99206,3.130,9.638,50833,3.335,19.277,5571,5670,27566
2016,42,208411,279970,5369530,5333004,23683,8.513,20145,7.241,607811,192998,414813,3.619,11.397,534032,151962,382070,2.849,10.014,73779,1.383,20.027,13050,13386,80256
2016,44,21520,25982,432413,428894,2581,10.046,2000,7.785,49902,16803,33099,3.918,11.635,43185,11741,31444,2.738,10.069,6717,1.566,20.138,1337,1352,6934
2016,45,73028,98176,1722564,1694536,9535,9.830,7175,7.397,225911,76896,149015,4.538,13.332,170001,46841,123160,2.764,10.032,55910,3.299,20.065,4824,4958,28095
2016,46,19748,24398,358232,355448,2108,8.709,1722,7.114,36196,10976,25220,3.088,10.183,30834,7635,23199,2.148,8.675,5362,1.509,17.349,1214,1229,5064
2016,47,89676,127003,2588290,2546929,11474,9.118,9151,7.272,322519,103694,218825,4.071,12.663,239456,67785,171671,2.661,9.402,83063,3.261,18.804,6166,6319,36004
2016,48,388122,533971,10453320,10356617,58002,10.983,46259,8.760,1453852,518702,935150,5.008,14.038,1260388,363283,897105,3.508,12.170,193464,1.868,24.340,31074,32024,206270
2016,49,54481,67624,1248706,1226224,8027,12.031,6221,9.324,172806,54673,118133,4.459,14.093,127986,42416,85570,3.459,10.437,44820,3.655,20.875,4111,4200,25949
2016,50,16008,19119,266338,266646,1505,7.888,1424,7.464,26339,7163,19176,2.686,9.878,27093,6995,20098,2.623,10.161,-754,-0.283,19.756,929,941,4050
2016,51,135964,183683,3278663,3244994,17601,9.658,14738,8.087,411766,133827,277939,4.124,12.689,344990,95655,249335,2.948,10.631,66776,2.058,21.263,9491,9731,50855
2016,53,132567,166909,2619746,2575292,17893,10.832,14433,8.738,351949,114267,237682,4.437,13.666,263656,87150,176506,3.384,10.238,88293,3.428,20.476,9682,9797,49165
2016,54,24969,34629,559267,562596,2500,7.205,2638,7.603,61568,18878,42690,3.356,10.944,68381,18205,50176,3.236,12.155,-6813,-1.211,21.887,1796,1857,11510
2016,55,97736,129974,2525442,2510429,11414,8.870,8823,6.857,278230,91050,187180,3.627,11.083,247836,65980,181856,2.628,9.872,30394,1.211,19.745,5823,5949,33751
2016,56,15622,18680,208107,213728,1804,9.640,1871,9.998,23969,9461,14508,4.427,11.215,35194,9915,25279,4.639,16.467,-11225,-5.252,22.429,1329,1340,6669
2017,01,68261,93963,1701443,1688926,7587,8.080,7464,7.949,223217,56827,166390,3.365,13.217,197508,62023,135485,3.672,11.694,25709,1.522,23.389,4649,4781,29459
2017,02,13979,18080,260376,261879,1736,9.588,1787,9.870,34066,8529,25537,3.257,13.008,36976,12082,24894,4.614,14.120,-2910,-1.111,26.017,1063,1080,5113
2017,04,94024,126912,2453512,2424901,13833,10.987,11810,9.380,359181,116255,242926,4.794,14.812,301892,111475,190417,4.597,12.450,57289,2.363,24.899,7287,7448,46507
2017,05,45782,61363,1028971,1020753,5295,8.659,4868,7.961,135803,41479,94324,4.064,13.304,119183,36683,82500,3.594,11.676,16620,1.628,23.352,3125,3218,18929
2017,06,655478,829976,14710263,14532767,90314,10.947,80399,9.745,2177065,679712,1497353,4.677,14.980,1822724,629688,1193036,4.333,12.542,354341,2.438,25.084,52930,54168,340347
2017,08,118120,147640,2375870,2349299,17066,11.663,14433,9.864,346507,121944,224563,5.191,14.749,293168,107409,185759,4.572,12.479,53339,2.270,24.958,9065,9209,52115
2017,09,63692,81796,1539659,1536225,6366,7.740,7269,8.838,187502,62117,125385,4.043,12.205,180115,73026,107089,4.754,11.725,7387,0.481,23.449,4388,4486,33722
2017,10,17819,22744,401225,400605,2255,9.928,2194,9.659,56238,17963,38275,4.484,14.038,54681,17991,36690,4.491,13.650,1557,0.389,27.299,1332,1350,6394
2017,11,16701,21830,528199,523570,2016,9.280,1804,8.304,62723,18639,44084,3.560,11.980,53818,17576,36242,3.357,10.279,8905,1.701,20.558,1036,1048,7064
2017,12,391015,492857,8030268,7929306,58607,11.974,51838,10.591,1188686,388014,800672,4.893,14.991,987992,382484,605508,4.824,12.460,200694,2.531,24.920,33803,34338,191493
2017,13,157777,209609,3887108,3843109,21854,10.503,18795,9.033,556722,185806,370916,4.835,14.486,466410,158659,307751,4.128,12.136,90312,2.350,24.273,12026,12290,72769
2017,15,23010,30108,542667,535524,2512,8.356,2418,8.044,72185,28074,44111,5.242,13.479,58131,16155,41976,3.017,10.855,14054,2.624,21.710,1551,1575,8421
2017,16,33783,41384,580569,572537,4378,10.663,3727,9.077,81839,27709,54130,4.840,14.294,66001,22928,43073,4.005,11.528,15838,2.766,23.056,2327,2361,10930
2017,17,222145,286036,5433575,5427274,25792,9.022,25482,8.913,669815,211004,458811,3.888,12.342,657353,228437,428916,4.209,12.112,12462,0.230,24.224,16004,16477,115036
2017,18,98614,136481,2781936,2753859,10792,7.923,10256,7.529,355739,95436,260303,3.466,12.918,299777,90324,209453,3.280,10.886,55962,2.032,21.771,6225,6376,44328
2017,19,55907,75012,1354536,1350721,5644,7.522,5679,7.569,152333,39206,113127,2.903,11.278,146156,41031,105125,3.038,10.821,6177,0.457,21.641,3429,3499,19099
2017,20,52253,69032,1203226,1195523,5596,8.088,5912,8.545,152580,47990,104590,4.014,12.763,137153,45528,91625,3.808,11.472,15427,1.290,22.944,3760,3883,22494
2017,21,61841,85338,1627701,1616262,6887,8.049,7339,8.577,209972,64220,145752,3.973,12.991,188192,65870,122322,4.075,11.644,21780,1.348,23.287,4779,4841,32415
2017,22,73685,98449,1687950,1693860,7887,7.994,8301,8.414,213723,62616,151107,3.697,12.618,225369,64583,160786,3.813,13.305,-11646,-0.688,25.235,5103,5208,31087
2017,23,29114,36469,514948,512519,3051,8.367,3042,8.342,60052,16208,43844,3.162,11.717,55392,18237,37155,3.558,10.808,4660,0.909,21.616,1915,1956,9407
2017,24,97539,126527,2335224,2311225,11186,8.842,11140,8.806,315731,89311,226420,3.864,13.661,268752,91579,177173,3.962,11.628,46979,2.033,23.256,6824,6945,40080
2017,25,127216,162485,3307429,3274621,14306,8.835,13197,8.150,405973,117691,288282,3.594,12.398,339338,109939,229399,3.357,10.363,66635,2.035,20.725,8276,8491,56368
2017,26,153230,200760,3861386,3834574,16258,8.091,16597,8.260,479230,129387,349843,3.374,12.498,426945,144373,282572,3.765,11.134,52285,1.364,22.268,10453,10808,69073
2017,27,102774,134610,2665655,2646874,11525,8.578,11012,8.196,328817,103941,224876,3.927,12.423,291849,89422,202427,3.378,11.026,36968,1.397,22.052,6853,7016,42347
2017,28,40793,55341,938913,939304,4400,7.948,4433,8.008,107277,32282,74995,3.437,11.421,107327,33688,73639,3.586,11.426,-50,-0.005,22.842,2813,2886,15275
2017,29,110080,144972,2528447,2506698,14569,10.056,14386,9.930,326353,103143,223210,4.115,13.019,283363,97161,186202,3.876,11.304,42990,1.715,22.608,9185,9424,47214
2017,30,27752,33071,377255,376034,2971,8.996,2880,8.721,48986,14272,34714,3.795,13.027,46062,14704,31358,3.910,12.249,2924,0.778,24.499,1853,1891,8817
2017,31,38852,49933,832369,828552,4132,8.302,3808,7.651,99851,29056,70795,3.507,12.051,91884,32638,59246,3.939,11.090,7967,0.962,22.179,2368,2423,16690
2017,32,45321,58781,1194005,1177007,6864,11.756,6077,10.408,170464,53971,116493,4.585,14.483,137588,50886,86702,4.323,11.690,32876,2.793,23.379,3968,4036,25068
2017,33,27474,34886,604760,599261,2656,7.600,2777,7.946,69937,20525,49412,3.425,11.671,59316,17555,41761,2.929,9.898,10621,1.772,19.796,1736,1766,9435
2017,34,171587,210142,3678057,3648839,20490,9.756,20242,9.638,513581,171147,342434,4.690,14.075,454458,148357,306101,4.066,12.455,59123,1.620,24.910,13510,13704,75069
2017,35,30969,40350,627639,628068,3387,8.376,3563,8.811,76474,24507,51967,3.902,12.176,76894,23889,53005,3.804,12.243,-420,-0.067,24.352,2218,2274,11273
2017,36,405894,486076,8259264,8205959,48749,10.040,47649,9.814,1089904,335716,754188,4.091,13.282,982247,351923,630324,4.289,11.970,107657,1.312,23.940,33523,33963,193223
2017,37,157143,211615,3765872,3721405,20778,9.903,17190,8.193,492201,155759,336442,4.185,13.226,403291,133210,270081,3.580,10.837,88910,2.389,21.674,10883,11170,65328
2017,38,17566,22310,341445,344458,1830,8.161,2059,9.182,41673,13022,28651,3.780,12.098,47578,14704,32874,4.269,13.812,-5905,-1.714,24.196,1327,1347,6923
2017,39,165629,233624,4820745,4797974,17880,7.610,20524,8.736,603304,175330,427974,3.654,12.574,559648,193487,366161,4.033,11.664,43656,0.910,23.329,11102,11487,92883
2017,40,65417,85839,1362211,1358701,7520,8.744,7855,9.133,177066,58525,118541,4.307,13.032,170208,56320,113888,4.145,12.527,6858,0.505,25.055,4902,5016,30165
2017,41,83834,105625,1596610,1572886,10626,10.134,9084,8.663,220668,64076,156592,4.074,14.030,173349,55593,117756,3.534,11.021,47319,3.008,22.042,6021,6119,28649
2017,42,207609,279313,5436208,5399579,21830,7.806,22486,8.041,658416,188103,470313,3.484,12.194,584571,188442,396129,3.490,10.826,73845,1.368,21.652,13748,14029,76754
2017,44,21556,25973,438144,434976,2088,8.039,2091,8.050,52096,14570,37526,3.350,11.977,45976,14788,31188,3.400,10.570,6120,1.407,21.140,1316,1338,8619
2017,45,74005,99605,1756496,1736731,9210,9.315,7754,7.842,232287,70156,162131,4.040,13.375,192834,63373,129461,3.649,11.103,39453,2.272,22.207,4879,4994,34262
2017,46,19763,24405,360151,358845,1923,7.881,1916,7.852,41489,12077,29412,3.366,11.562,39419,11872,27547,3.308,10.985,2070,0.577,21.970,1196,1211,6378
2017,47,90389,128047,2652190,2629296,11226,8.804,10162,7.969,348079,104582,243497,3.978,13.238,301816,101507,200309,3.861,11.479,46263,1.760,22.958,6331,6519,44571
2017,48,393060,540677,10614330,10522676,57830,10.764,51014,9.495,1587341,540392,1046949,5.135,15.085,1405689,456690,948999,4.340,13.359,181652,1.726,26.717,32358,33434,229766
2017,49,55765,69072,1282546,1260533,8037,11.760,6578,9.625,182757,56982,125775,4.520,14.498,139620,48207,91413,3.824,11.076,43137,3.422,22.153,4167,4249,26956
2017,50,15954,19039,258701,259492,1462,7.665,1533,8.037,28836,8366,20470,3.224,11.113,30175,8775,21400,3.382,11.629,-1339,-0.516,22.225,1023,1033,5734
2017,51,136800,184527,3311526,3291964,16585,9.009,15731,8.545,420904,120699,300205,3.666,12.786,379886,126111,253775,3.831,11.540,41018,1.246,23.080,9745,9970,55967
2017,53,134482,169270,2695731,2656498,17758,10.566,15365,9.142,378002,103724,274278,3.905,14.229,298385,95405,202980,3.591,11.232,79617,2.997,22.465,9947,10082,52136
2017,54,24533,34133,548614,553244,2449,7.123,2942,8.557,60273,16812,43461,3.039,10.894,70152,19376,50776,3.502,12.680,-9879,-1.786,21.789,1763,1798,8888
2017,55,97429,129891,2556052,2537560,9967,7.671,10044,7.730,302921,86777,216144,3.420,11.937,266195,80550,185645,3.174,10.490,36726,1.447,20.980,6240,6383,38710
2017,56,15595,18603,199923,203734,1816,9.742,1891,10.145,25954,9309,16645,4.569,12.739,33550,11734,21816,5.759,16.468,-7596,-3.728,25.478,1183,1212,5005
2018,01,68202,93595,1723407,1714030,6794,7.245,7144,7.619,202908,54011,148897,3.151,11.838,185565,50222,135343,2.930,10.826,17343,1.012,21.652,4664,4855,28070
2018,02,14067,18075,261336,261662,1620,8.963,1618,8.952,31187,6950,24237,2.656,11.919,31846,8717,23129,3.331,12.171,-659,-0.252,23.838,978,988,3645
2018,04,95528,128122,2540649,2497590,13199,10.351,11973,9.390,360116,114435,245681,4.582,14.419,272390,91955,180435,3.682,10.906,87726,3.512,21.812,7697,7940,45900
2018,05,45886,61449,1038863,1033808,4941,8.048,4838,7.880,120173,34339,85834,3.322,11.624,109394,32830,76564,3.176,10.582,10779,1.043,21.163,3276,3390,19334
2018,06,664629,837478,15025597,14880003,87251,10.466,79592,9.547,1969825,607030,1362795,4.080,13.238,1678842,555214,1123628,3.731,11.283,290983,1.956,22.565,54506,55943,334208
2018,08,120307,149536,2424951,2401029,16477,11.089,14570,9.806,321891,102612,219279,4.274,13.406,273927,93139,180788,3.879,11.409,47964,1.998,22.817,9536,9725,54101
2018,09,63264,81111,1525772,1532852,6502,7.983,7167,8.800,169701,52810,116891,3.445,11.071,183804,65436,118368,4.269,11.991,-14103,-0.920,22.142,4515,4620,31008
2018,10,18069,23009,416183,409416,2277,9.956,2000,8.745,59269,17428,41841,4.257,14.476,46308,14629,31679,3.573,11.311,12961,3.166,22.621,1290,1314,7378
2018,11,16919,21924,536755,532281,1996,9.125,1896,8.668,62537,20227,42310,3.800,11.749,53361,18345,35016,3.446,10.025,9176,1.724,20.050,1065,1078,7466
2018,12,397716,498391,8241906,8123931,57210,11.544,51615,10.415,1135885,396473,739412,4.880,13.982,897391,323899,573492,3.987,11.046,238494,2.936,22.093,34740,35557,179520
2018,13,159838,211119,3973289,3936799,20942,9.956,19399,9.222,531062,159661,371401,4.056,13.490,457215,147759,309456,3.753,11.614,73847,1.876,23.228,12654,13022,76308
2018,15,23144,30244,550743,547359,2453,8.130,2312,7.662,61152,19304,41848,3.527,11.172,53806,16361,37445,2.989,9.830,7346,1.342,19.660,1544,1590,10747
2018,16,34986,42709,598930,589764,4775,11.357,3444,8.192,83264,27237,56027,4.618,14.118,64459,19220,45239,3.259,10.930,18805,3.189,21.859,2322,2387,11818
2018,17,221916,284933,5458356,5448090,23898,8.372,24962,8.744,635032,182326,452706,3.347,11.656,613969,184182,429787,3.381,11.269,21063,0.387,22.539,16087,16499,91034
2018,18,98986,136514,2814555,2799900,10488,7.684,10440,7.649,330688,86146,244542,3.077,11.811,301882,99215,202667,3.544,10.782,28806,1.029,21.564,6538,6856,54726
2018,19,56306,75381,1365108,1360006,5627,7.484,5248,6.980,138581,36629,101952,2.693,10.190,128217,34890,93327,2.565,9.428,10364,0.762,18.855,3379,3564,19282
2018,20,52000,68551,1202618,1203393,5105,7.425,5504,8.006,133742,36399,97343,3.025,11.114,135666,39056,96610,3.245,11.274,-1924,-0.160,22.227,3689,3799,20844
2018,21,60806,84146,1643993,1635866,6211,7.360,6686,7.923,188757,55809,132948,3.412,11.539,172009,52015,119994,3.180,10.515,16748,1.024,21.030,4401,4551,29699
2018,22,73684,97992,1692491,1692056,7758,7.899,8192,8.341,199037,54909,144128,3.245,11.763,198560,59807,138753,3.535,11.735,477,0.028,23.470,5254,5511,34798
2018,23,29282,36474,516652,515838,2822,7.738,2812,7.711,54772,13670,41102,2.650,10.618,53202,15878,37324,3.078,10.314,1570,0.304,20.627,1857,1907,9241
2018,24,97847,126566,2362171,2348710,10798,8.533,10742,8.489,280254,79739,200515,3.395,11.932,253073,79635,173438,3.391,10.775,27181,1.157,21.550,6844,6999,41189
2018,25,127717,162546,3348477,3323377,13415,8.255,13329,8.202,397974,118761,279213,3.574,11.975,345748,111636,234112,3.359,10.404,52226,1.571,20.807,8568,8739,51344
2018,26,153566,200902,3922741,3887189,15998,7.968,15756,7.847,478417,121285,357132,3.120,12.308,403905,130315,273590,3.352,10.391,74512,1.917,20.781,10448,10782,72271
2018,27,102329,133801,2699439,2682556,10382,7.737,11136,8.299,309524,77440,232084,2.887,11.538,276344,96476,179868,3.596,10.302,33180,1.237,20.603,7124,7380,51638
2018,28,40745,55278,944405,944024,4149,7.501,4222,7.633,103230,29904,73326,3.168,10.935,103096,30021,73075,3.180,10.921,134,0.014,21.842,2779,2886,16731
2018,29,104245,138836,2532417,2528939,13201,9.504,13322,9.591,297056,90629,206427,3.584,11.746,289556,93058,196498,3.680,11.450,7500,0.297,22.899,9072,9302,46312
2018,30,28044,33339,369964,373683,3144,9.469,2874,8.656,43403,14273,29130,3.820,11.615,51924,14055,37869,3.761,13.895,-8521,-2.280,23.230,1905,1930,8386
2018,31,38793,49719,846806,839776,3745,7.516,3957,7.942,97094,26917,70177,3.205,11.562,82850,25943,56907,3.089,9.866,14244,1.696,19.731,2513,2588,13749
2018,32,46491,59934,1220889,1207883,7117,11.992,5948,10.022,163445,57797,105648,4.785,13.532,137897,46100,91797,3.817,11.416,25548,2.115,22.833,3936,4054,24251
2018,33,27587,34994,614544,609624,2747,7.863,2634,7.539,70973,23688,47285,3.886,11.642,61228,17767,43461,2.914,10.044,9745,1.599,20.087,1823,1843,10278
2018,34,171563,209617,3730121,3710985,19072,9.087,19580,9.330,470855,143273,327582,3.861,12.688,433318,137481,295837,3.705,11.677,37537,1.012,23.353,13490,13646,68961
2018,35,30903,40085,630750,629338,3259,8.104,3515,8.741,71994,22874,49120,3.635,11.440,68993,22048,46945,3.503,10.963,3001,0.477,21.926,2229,2281,11251
2018,36,406253,485401,8367223,8317734,46901,9.657,47458,9.771,1037003,311881,725122,3.750,12.467,939593,330430,609163,3.973,11.296,97410,1.171,22.593,34090,34662,194524
2018,37,159466,213518,3858849,3824342,19830,9.329,17917,8.429,485644,151027,334617,3.949,12.699,417620,146107,271513,3.820,10.920,68024,1.779,21.840,11471,11860,73154
2018,38,17476,22170,345699,343625,1705,7.667,1839,8.270,42259,12061,30198,3.510,12.298,38349,12135,26214,3.531,11.160,3910,1.138,22.320,1204,1261,6703
2018,39,165064,232415,4885818,4854259,16602,7.125,17765,7.625,575769,151388,424381,3.119,11.861,514234,157646,356588,3.248,10.593,61535,1.268,21.187,10912,11394,79960
2018,40,65455,85619,1386313,1375142,7248,8.456,7446,8.687,180181,51973,128208,3.779,13.103,158382,52321,106061,3.805,11.518,21799,1.585,23.035,4899,5036,28055
2018,41,85266,106908,1627488,1612757,10355,9.746,9042,8.510,198175,54710,143465,3.392,12.288,169772,56321,113451,3.492,10.527,28403,1.761,21.054,6175,6292,32729
2018,42,207518,279469,5491599,5467228,21472,7.686,21236,7.602,602638,165820,436818,3.033,11.023,553636,167611,386025,3.066,10.126,49002,0.896,20.253,13451,13816,79260
2018,44,21516,25830,444496,441084,2117,8.182,2205,8.522,54211,14792,39419,3.354,12.290,46825,16859,29966,3.822,10.616,7386,1.675,21.232,1391,1431,7937
2018,45,75211,100627,1805364,1786351,9118,9.106,8118,8.108,240339,70066,170273,3.922,13.454,202493,69234,133259,3.876,11.336,37846,2.119,22.671,5153,5344,29807
2018,46,19832,24452,360661,360732,1966,8.050,1909,7.816,35864,10145,25719,2.812,9.942,35902,11256,24646,3.120,9.953,-38,-0.011,19.884,1287,1319,6877
2018,47,90996,128486,2674582,2660409,10472,8.165,10020,7.812,305624,86271,219353,3.243,11.488,277779,83354,194425,3.133,10.441,27845,1.047,20.882,6440,6733,43559
2018,48,398917,545863,10811900,10716886,55407,10.200,50061,9.216,1475107,472728,1002379,4.411,13.764,1286189,427898,858291,3.993,12.002,188918,1.763,24.003,32960,34119,230798
2018,49,57422,70556,1336713,1310382,8068,11.557,6573,9.416,185968,55285,130683,4.219,14.192,133689,50380,83309,3.845,10.202,52279,3.990,20.405,4229,4329,30580
2018,50,15866,18915,261668,260186,1330,7.010,1446,7.621,26701,7957,18744,3.058,10.262,23952,7996,15956,3.073,9.206,2749,1.057,18.411,979,992,5165
2018,51,137254,184465,3385994,3350305,15885,8.611,15911,8.625,418553,116593,301960,3.480,12.493,348057,109503,238554,3.268,10.389,70496,2.104,20.778,9959,10225,55927
2018,53,136907,171463,2779040,2739014,17555,10.304,15355,9.013,366627,111123,255504,4.057,13.385,286924,94088,192836,3.435,10.475,79703,2.910,20.951,10364,10629,54785
2018,54,24112,33666,556480,552686,2228,6.572,2695,7.950,65686,18325,47361,3.316,11.885,58207,18483,39724,3.344,10.532,7479,1.353,21.063,1773,1825,10504
2018,55,97532,129607,2605418,2586971,9385,7.235,9598,7.399,285500,77465,208035,2.994,11.036,249478,78075,171403,3.018,9.644,36022,1.392,19.287,6196,6410,35875
2018,56,15795,18705,205213,203505,1903,10.203,1797,9.634,27587,9164,18423,4.503,13.556,24104,9503,14601,4.670,11.844,3483,1.712,23.689,1196,1232,5300
2019,01,68647,94439,1761274,1742556,7506,7.983,6681,7.105,202529,58199,144330,3.340,11.623,166236,49486,116750,2.840,9.540,36293,2.083,19.080,4761,4900,27736
2019,02,14123,18102,263295,262004,1631,9.030,1551,8.587,31205,8945,22260,3.414,11.910,28514,8085,20429,3.086,10.883,2691,1.027,21.766,1046,1064,3941
2019,04,97037,129882,2617189,2580311,13385,10.375,11648,9.029,353579,113560,240019,4.401,13.703,279421,97180,182241,3.766,10.829,74158,2.874,21.658,8031,8181,54279
2019,05,46115,61901,1056049,1047411,5266,8.537,4834,7.837,122076,39658,82418,3.786,11.655,105551,34557,70994,3.299,10.077,16525,1.578,20.155,3409,3576,22769
2019,06,675682,848960,15320201,15177982,91061,10.799,79580,9.438,1992607,636726,1355881,4.195,13.128,1710516,575888,1134628,3.794,11.270,282091,1.859,22.539,57715,58803,329152
2019,08,121893,151535,2448627,2421487,17004,11.296,15000,9.965,326436,107006,219430,4.419,13.481,271364,95617,175747,3.949,11.207,55072,2.274,22.413,10668,10797,58725
2019,09,63142,81278,1549713,1538157,6530,8.042,6376,7.852,166049,47460,118589,3.086,10.795,142843,44964,97879,2.923,9.287,23206,1.509,18.573,4575,4642,26530
2019,10,18477,23445,438376,427380,2326,10.012,1900,8.178,63574,17462,46112,4.086,14.875,41969,16261,25708,3.805,9.820,21605,5.055,19.640,1332,1349,6865
2019,11,17031,22109,529314,533561,1972,8.956,1791,8.134,55341,19167,36174,3.592,10.372,64371,18937,45434,3.549,12.064,-9030,-1.692,20.744,1162,1181,9625
2019,12,405312,507660,8410473,8343485,60086,11.945,50828,10.104,1062813,378067,684746,4.531,12.738,933806,333459,600347,3.997,11.192,129007,1.546,22.384,37469,37987,193567
2019,13,162141,214439,4073476,4028237,21954,10.317,18685,8.780,536427,169908,366519,4.218,13.317,446044,145567,300477,3.614,11.073,90383,2.244,22.146,13264,13481,71708
2019,15,23306,30433,555491,553277,2502,8.246,2318,7.640,55477,19227,36250,3.475,10.027,51059,17133,33926,3.097,9.228,4418,0.799,18.457,1660,1687,10682
2019,16,36267,44065,616614,607467,4993,11.506,3649,8.409,76909,27915,48994,4.595,12.661,58663,18838,39825,3.101,9.657,18246,3.004,19.314,2598,2641,10964
2019,17,221797,285279,5493282,5478807,24562,8.614,24252,8.506,600439,174296,426143,3.181,10.959,573464,176422,397042,3.220,10.467,26975,0.492,20.934,17152,17530,97347
2019,18,99032,137379,2839093,2829535,10463,7.639,9626,7.028,283856,75701,208155,2.675,10.032,263454,71426,192028,2.524,9.311,20402,0.721,18.622,6846,7057,40942
2019,19,56156,75363,1384186,1373619,5352,7.100,5392,7.153,142647,34104,108543,2.483,10.385,121626,36252,85374,2.639,8.854,21021,1.530,17.709,3789,3887,21951
2019,20,51793,68463,1209808,1211052,5330,7.780,5418,7.909,133748,39331,94417,3.248,11.044,136802,39943,96859,3.298,11.296,-3054,-0.252,22.088,3838,3973,22142
2019,21,61088,84605,1675335,1660175,6690,7.930,6201,7.351,190281,56463,133818,3.401,11.462,160137,49506,110631,2.982,9.646,30144,1.816,19.292,4282,4415,26153
2019,22,73888,98352,1719717,1706286,7980,8.128,7630,7.772,202191,67132,135059,3.934,11.850,175540,54944,120596,3.220,10.288,26651,1.562,20.576,5561,5665,35055
2019,23,29446,36739,522568,519593,3078,8.409,2804,7.661,56072,14167,41905,2.727,10.792,49989,15635,34354,3.009,9.621,6083,1.171,19.242,1994,2018,8796
2019,24,98271,127081,2384356,2373874,10713,8.447,10211,8.051,257944,76110,181834,3.206,10.866,236648,74770,161878,3.150,9.969,21296,0.897,19.938,7143,7290,40963
2019,25,128811,164095,3394703,3361159,14060,8.609,12523,7.667,367917,99166,268751,2.950,10.946,301286,97810,203476,2.910,8.964,66631,1.982,17.928,8877,9036,49262
2019,26,153240,200945,3928348,3920713,15728,7.830,15593,7.762,419695,108457,311238,2.766,10.705,406110,106680,299430,2.721,10.358,13585,0.346,20.716,11301,11500,65316
2019,27,102250,133991,2697570,2697849,10525,7.860,10350,7.729,273474,78910,194564,2.925,10.137,273767,79062,194705,2.931,10.148,-293,-0.011,20.273,7260,7466,44392
2019,28,40717,55379,959291,951872,4115,7.436,4032,7.286,102756,30443,72313,3.198,10.795,88183,25640,62543,2.694,9.264,14573,1.531,18.528,2954,3022,15630
2019,29,104491,139251,2555824,2543772,13131,9.464,12131,8.743,276438,82504,193934,3.243,10.867,253861,81869,171992,3.218,9.980,22577,0.888,19.959,8618,8757,42821
2019,30,28324,33662,375336,373378,3183,9.501,2863,8.546,42212,13754,28458,3.684,11.305,38407,12254,26153,3.282,10.286,3805,1.019,20.573,2075,2104,8844
2019,31,38813,49846,854480,851448,3784,7.600,3669,7.369,91972,28695,63277,3.370,10.802,85997,26090,59907,3.064,10.100,5975,0.702,20.200,2569,2601,13051
2019,32,47359,60931,1261661,1241518,7023,11.621,6025,9.970,170236,51216,119020,4.125,13.712,129826,46229,83597,3.724,10.457,40410,3.255,20.914,4412,4493,30011
2019,33,27784,35237,622062,618263,2798,7.968,2554,7.273,61578,16843,44735,2.724,9.960,54735,16157,38578,2.613,8.853,6843,1.107,17.706,1868,1878,9010
2019,34,172466,211008,3801003,3766280,20193,9.601,18830,8.953,459932,138046,321886,3.665,12.212,392302,131732,260570,3.498,10.416,67630,1.796,20.832,13904,14098,76349
2019,35,31041,40299,636162,633467,3445,8.572,3229,8.034,73088,23754,49334,3.750,11.538,68391,19357,49034,3.056,10.796,4697,0.741,21.593,2359,2402,12678
2019,36,407611,487930,8516548,8434238,47478,9.755,44995,9.245,1037934,316373,721561,3.751,12.306,875733,290812,584921,3.448,10.383,162201,1.923,20.766,34795,35327,190100
2019,37,161601,216374,3948160,3903163,19657,9.145,16811,7.821,482930,142177,340753,3.643,12.373,396558,135655,260903,3.476,10.160,86372,2.213,20.320,11953,12214,69564
2019,38,17567,22347,352751,349368,1768,7.943,1592,7.152,36785,10932,25853,3.129,10.529,30126,8223,21903,2.354,8.623,6659,1.906,17.246,1146,1177,5550
2019,39,165071,231953,4923203,4904801,16956,7.302,17456,7.518,527081,144899,382182,2.954,10.746,490625,164824,325801,3.360,10.003,36456,0.743,20.006,11357,11651,80465
2019,40,65773,86012,1406235,1397029,7577,8.829,7197,8.386,170088,53027,117061,3.796,12.175,152735,45064,107671,3.226,10.933,17353,1.242,21.866,5108,5294,28681
2019,41,85778,107613,1646942,1637280,10090,9.407,9377,8.743,191727,54896,136831,3.353,11.710,172860,53119,119741,3.244,10.558,18867,1.152,21.116,6790,6883,32504
2019,42,208643,279884,5559809,5547983,21379,7.644,20971,7.498,581856,158331,423525,2.854,10.488,563730,171919,391811,3.099,10.161,18126,0.327,20.322,13837,14299,88470
2019,44,21652,25987,440615,443273,2270,8.762,2109,8.141,42363,13890,28473,3.134,9.557,48355,15114,33241,3.410,10.909,-5992,-1.352,19.114,1458,1479,8431
2019,45,76266,102151,1860599,1832191,9400,9.270,7897,7.788,240716,75345,165371,4.112,13.138,183833,55773,128060,3.044,10.034,56883,3.105,20.067,5620,5750,34357
2019,46,19880,24533,360397,360561,1942,7.929,1862,7.602,33514,10268,23246,2.848,9.295,34177,10409,23768,2.887,9.479,-663,-0.184,18.590,1367,1392,6212
2019,47,91626,130011,2725664,2706268,11319,8.757,9813,7.592,314258,99165,215093,3.664,11.612,275084,86514,188570,3.197,10.165,39174,1.448,20.329,6828,6972,41751
2019,48,406841,555556,11099556,10955060,57706,10.478,48100,8.733,1474829,476567,998262,4.350,13.463,1194380,396633,797747,3.621,10.903,280449,2.560,21.805,34383,35362,224765
2019,49,58991,72169,1372928,1354514,8293,11.619,6704,9.393,172064,53508,118556,3.950,12.703,135770,45053,90717,3.326,10.024,36294,2.679,20.047,4817,4888,28910
2019,50,15750,18803,260921,261494,1373,7.280,1485,7.874,23521,6976,16545,2.668,8.995,24873,8354,16519,3.195,9.512,-1352,-0.517,17.990,1091,1102,5263
2019,51,138598,186483,3459559,3425703,16528,8.910,14555,7.847,406820,116390,290430,3.398,11.876,340123,107946,232177,3.151,9.929,66697,1.947,19.857,10374,10538,60899
2019,53,138304,173190,2831590,2805302,17420,10.108,15711,9.117,346157,106723,239434,3.804,12.339,294218,99869,194349,3.560,10.488,51939,1.851,20.976,11379,11583,57259
2019,54,24015,33637,554712,555896,2419,7.189,2442,7.257,58601,18806,39795,3.383,10.542,61202,20904,40298,3.760,11.010,-2601,-0.468,21.083,1703,1729,11532
2019,55,97470,130167,2612848,2608915,9627,7.411,9083,6.993,275760,88336,187424,3.386,10.570,268330,75149,193181,2.880,10.285,7430,0.285,20.570,6444,6593,42777
2019,56,15924,18860,207005,206100,1872,9.969,1710,9.106,23641,7711,15930,3.741,11.471,21842,6964,14878,3.379,10.598,1799,0.873,21.196,1245,1258,4770
2020,01,67983,93760,1777163,1769389,6869,7.300,7536,8.009,199671,51813,147858,2.928,11.285,183587,53440,130147,3.020,10.376,16084,0.909,20.751,5398,5575,31757
2020,02,14055,18012,264521,263850,1606,8.896,1690,9.361,30932,8019,22913,3.039,11.723,29896,8845,21051,3.352,11.331,1036,0.393,22.661,1230,1261,5980
2020,04,97850,130757,2653106,2639261,13497,10.357,12615,9.680,334120,108622,225498,4.116,12.660,307008,95243,211765,3.609,11.632,27112,1.027,23.265,9026,9268,54075
2020,05,45794,61736,1058782,1058357,5029,8.135,5191,8.397,116919,37271,79648,3.522,11.047,115743,34696,81047,3.278,10.936,1176,0.111,21.872,3823,3908,22031
2020,06,687058,860831,15403334,15329187,96875,11.332,84907,9.932,2015160,730207,1284953,4.764,13.146,1864633,624867,1239766,4.076,12.164,150527,0.982,24.328,65159,66789,384586
2020,08,121775,151634,2441345,2429520,16620,10.965,16507,10.890,329459,112474,216985,4.629,13.561,306156,103854,202302,4.275,12.602,23303,0.959,25.203,11864,12091,63256
2020,09,62338,80542,1555871,1550352,6581,8.134,7314,9.040,195004,75666,119338,4.881,12.578,184579,59955,124624,3.867,11.906,10425,0.672,23.811,5171,5289,30099
2020,10,19440,24446,429543,434021,3136,13.098,2131,8.900,57202,23985,33217,5.526,13.180,65367,19311,46056,4.449,15.061,-8165,-1.881,26.359,1525,1542,8409
2020,11,16973,22106,543855,536324,1992,9.011,1995,9.024,68618,24573,44045,4.582,12.794,54321,17649,36672,3.291,10.128,14297,2.666,20.257,1295,1325,9105
2020,12,407796,511777,8590199,8509141,60511,11.872,56357,11.057,1163240,436751,726489,5.133,13.670,1000487,373047,627440,4.384,11.758,162753,1.913,23.516,41799,42562,207927
2020,13,163066,215614,4118858,4097539,21915,10.192,20726,9.639,528212,190545,337667,4.650,12.891,486060,156010,330050,3.807,11.862,42152,1.029,23.724,14901,15308,81140
2020,15,22913,30037,549644,552505,2267,7.498,2663,8.808,49358,13809,35549,2.499,8.934,55148,17683,37465,3.201,9.981,-5790,-1.048,17.867,2033,2074,10713
2020,16,36898,44841,635902,626285,4977,11.196,4202,9.453,80337,28397,51940,4.534,12.828,61309,20251,41058,3.234,9.789,19028,3.038,19.579,3155,3210,13554
2020,17,219331,282473,5506270,5505705,24118,8.496,26907,9.479,612147,186982,425165,3.396,11.118,612141,202924,409217,3.686,11.118,6,0.000,22.237,19041,19539,107297
2020,18,98218,136320,2826659,2834123,10493,7.667,11561,8.448,296888,88859,208029,3.135,10.475,311773,100863,210910,3.559,11.001,-14885,-0.525,20.951,7689,7932,49571
2020,19,55671,74960,1389485,1385870,5471,7.280,5859,7.796,136045,39156,96889,2.825,9.817,128967,36446,92521,2.630,9.306,7078,0.511,18.612,4136,4243,20193
2020,20,51049,67716,1206261,1207967,5079,7.460,5809,8.532,135170,38736,96434,3.207,11.190,139076,44537,94539,3.687,11.513,-3906,-0.323,22.380,4147,4259,26123
2020,21,60238,83909,1669034,1672681,6230,7.395,6907,8.198,178264,55013,123251,3.289,10.657,186734,59786,126948,3.574,11.164,-8470,-0.506,21.315,4874,5045,32168
2020,22,72951,97528,1704810,1711873,7517,7.675,8335,8.511,186685,54590,132095,3.189,10.905,201115,57803,143312,3.377,11.748,-14430,-0.843,21.811,5969,6126,33701
2020,23,29402,36700,521521,521958,3012,8.205,3033,8.262,51786,14893,36893,2.853,9.921,52319,14980,37339,2.870,10.024,-533,-0.102,19.843,2216,2251,9906
2020,24,97548,126396,2410385,2396847,10780,8.506,11454,9.038,279564,81252,198312,3.390,11.664,251984,80273,171711,3.349,10.513,27580,1.151,21.026,8226,8468,48414
2020,25,128472,163744,3394797,3396449,13861,8.456,14203,8.665,355766,109515,246251,3.224,10.475,356675,110753,245922,3.261,10.501,-909,-0.027,20.949,10282,10550,61528
2020,26,151245,198903,3953576,3944382,15835,7.922,17816,8.913,440663,139956,300707,3.548,11.172,420605,130176,290429,3.300,10.663,20058,0.509,21.327,12690,13008,79038
2020,27,101544,133271,2705144,2701713,10616,7.944,11332,8.480,277335,75695,201640,2.802,10.265,268592,82782,185810,3.064,9.942,8743,0.324,19.883,8047,8311,45099
2020,28,40078,54697,952166,955623,3940,7.159,4620,8.394,96165,27522,68643,2.880,10.063,102932,31128,71804,3.257,10.771,-6767,-0.708,20.126,3333,3383,17367
2020,29,102912,137559,2565232,2559752,12231,8.868,12957,9.394,278959,99237,179722,3.877,10.898,269750,88672,181078,3.464,10.538,9209,0.360,21.076,9396,9676,48077
2020,30,28512,33933,376751,375687,3433,10.159,3152,9.328,44051,14801,29250,3.940,11.725,41738,15547,26191,4.138,11.110,2313,0.616,22.220,2324,2363,10538
2020,31,38604,49561,864442,859589,3802,7.650,4084,8.217,93899,26458,67441,3.078,10.924,84391,28188,56203,3.279,9.818,9508,1.106,19.635,2876,2963,15152
2020,32,48102,61893,1276581,1268702,7136,11.620,6174,10.053,162191,56554,105637,4.458,12.784,147475,55112,92363,4.344,11.624,14716,1.160,23.248,4513,4603,28043
2020,33,27638,35032,621223,621696,2640,7.514,2847,8.103,58242,15247,42995,2.452,9.368,58975,18640,40335,2.998,9.486,-733,-0.118,18.736,2130,2177,11292
2020,34,170791,209801,3806096,3802944,19494,9.265,20683,9.831,451928,156661,295267,4.119,11.884,444340,148098,296242,3.894,11.684,7588,0.200,23.368,15469,15826,84652
2020,35,30641,39939,650376,648476,3340,8.326,3697,9.215,74916,24445,50471,3.770,11.553,70906,23759,47147,3.664,10.934,4010,0.618,21.869,2711,2836,14919
2020,36,399761,479781,8529118,8531663,45320,9.367,53462,11.049,977194,294469,682725,3.451,11.454,980950,332851,648099,3.901,11.498,-3756,-0.044,22.907,40606,41270,203988
2020,37,162412,217191,3963672,3954965,19829,9.147,18991,8.761,450307,146768,303539,3.711,11.386,431706,144139,287567,3.645,10.916,18601,0.470,21.831,13506,13887,76812
2020,38,17441,22212,355296,354085,1700,7.631,1831,8.219,38316,11597,26719,3.275,10.821,36314,10891,25423,3.076,10.256,2002,0.565,20.511,1324,1356,6714
2020,39,163096,228971,4928005,4925806,16396,7.115,19367,8.404,538686,166128,372558,3.373,10.936,536517,166837,369680,3.387,10.892,2169,0.044,21.784,12769,13281,87383
2020,40,64980,85232,1401874,1403971,7451,8.703,8220,9.601,165250,55881,109369,3.980,11.770,168822,50108,118714,3.569,12.025,-3572,-0.254,23.540,6051,6245,31007
2020,41,85659,107494,1663530,1655418,9929,9.232,10043,9.338,192048,63178,128870,3.816,11.601,175513,57488,118025,3.473,10.602,16535,0.999,21.205,7447,7617,36351
2020,42,207340,278618,5541292,5533407,20802,7.449,22058,7.899,582811,184088,398723,3.327,10.533,567123,166721,400402,3.013,10.249,15688,0.284,20.498,15645,16184,94933
2020,44,21574,25924,445487,442880,2134,8.223,2190,8.439,48016,14572,33444,3.290,10.842,42722,13935,28787,3.146,9.646,5294,1.195,19.293,1657,1669,8483
2020,45,76428,102372,1858360,1859598,9117,8.916,8889,8.693,215295,69629,145666,3.744,11.578,219123,73145,145978,3.933,11.783,-3828,-0.206,23.155,6305,6548,35069
2020,46,19848,24550,364934,364469,2056,8.378,2035,8.293,40594,13945,26649,3.826,11.138,39730,15841,23889,4.346,10.901,864,0.237,21.802,1485,1572,8693
2020,47,91560,129909,2758978,2743033,10895,8.384,10982,8.451,334348,108700,225648,3.963,12.189,301905,99246,202659,3.618,11.006,32443,1.183,22.012,7670,7950,49614
2020,48,409358,558554,11206366,11157402,56572,10.156,53502,9.605,1470907,526783,944124,4.721,13.183,1374025,431829,942196,3.870,12.315,96882,0.868,24.630,38937,40374,250036
2020,49,59950,73266,1404722,1389452,8552,11.761,7445,10.239,186255,56134,130121,4.040,13.405,156200,52076,104124,3.748,11.242,30055,2.163,22.484,5427,5518,35074
2020,50,15518,18550,257704,259172,1349,7.224,1598,8.557,24027,6424,17603,2.479,9.271,26919,8679,18240,3.349,10.387,-2892,-1.116,18.541,1194,1203,5611
2020,51,138048,185637,3497454,3478682,15782,8.483,16609,8.927,425201,140707,284494,4.045,12.223,386934,123319,263615,3.545,11.123,38267,1.100,22.246,11596,11902,64186
2020,53,137073,172342,2880808,2856164,16849,9.753,17688,10.238,357654,118481,239173,4.148,12.522,306175,102176,203999,3.577,10.720,51479,1.802,21.440,13169,13384,62105
2020,54,23308,32963,543293,549102,2175,6.532,2845,8.544,51002,16649,34353,3.032,9.288,62775,18069,44706,3.291,11.432,-11773,-2.144,18.577,2000,2072,10809
2020,55,96737,129309,2602985,2607645,9334,7.195,10178,7.845,263865,71376,192489,2.737,10.119,272189,81154,191035,3.112,10.438,-8324,-0.319,20.238,7048,7290,43475
2020,56,16064,18970,206680,206290,2060,10.891,1948,10.299,25109,9613,15496,4.660,12.172,24234,9589,14645,4.648,11.748,875,0.424,23.495,1465,1509,6102
